Orthogroup	i_nil	i_purpurea	i_trifida	i_triloba	Total
OG0000000	306	0	0	0	306
OG0000001	123	4	1	0	128
OG0000002	120	1	0	0	121
OG0000003	117	0	0	0	117
OG0000004	32	8	36	33	109
OG0000005	25	26	36	16	103
OG0000006	100	1	0	0	101
OG0000007	2	97	0	0	99
OG0000008	2	92	0	1	95
OG0000009	1	88	0	0	89
OG0000010	0	87	0	0	87
OG0000011	78	3	0	2	83
OG0000012	24	59	0	0	83
OG0000013	0	82	0	0	82
OG0000014	32	26	0	23	81
OG0000015	78	3	0	0	81
OG0000016	78	0	0	0	78
OG0000017	2	70	1	1	74
OG0000018	1	72	0	0	73
OG0000019	2	68	0	2	72
OG0000020	70	1	0	0	71
OG0000021	2	69	0	0	71
OG0000022	0	70	0	0	70
OG0000023	67	0	0	2	69
OG0000024	25	16	14	11	66
OG0000025	14	22	17	13	66
OG0000026	65	0	0	0	65
OG0000027	17	45	1	1	64
OG0000028	64	0	0	0	64
OG0000029	56	8	0	0	64
OG0000030	40	24	0	0	64
OG0000031	55	2	3	4	64
OG0000032	61	2	0	0	63
OG0000033	60	1	1	1	63
OG0000034	30	20	5	8	63
OG0000035	61	1	0	0	62
OG0000036	61	0	0	0	61
OG0000037	60	1	0	0	61
OG0000038	31	28	0	2	61
OG0000039	14	10	15	22	61
OG0000040	2	50	1	8	61
OG0000041	3	57	0	0	60
OG0000042	55	4	0	0	59
OG0000043	2	57	0	0	59
OG0000044	1	56	0	2	59
OG0000045	5	53	0	0	58
OG0000046	1	5	44	8	58
OG0000047	20	10	15	12	57
OG0000048	1	56	0	0	57
OG0000049	1	50	1	5	57
OG0000050	0	57	0	0	57
OG0000051	0	57	0	0	57
OG0000052	55	1	0	0	56
OG0000053	55	1	0	0	56
OG0000054	8	14	17	17	56
OG0000055	2	52	0	2	56
OG0000056	3	52	0	1	56
OG0000057	0	51	1	4	56
OG0000058	1	50	1	3	55
OG0000059	3	49	1	1	54
OG0000060	0	51	2	1	54
OG0000061	2	50	1	0	53
OG0000062	1	51	0	1	53
OG0000063	1	51	1	0	53
OG0000064	0	51	0	2	53
OG0000065	0	51	0	1	52
OG0000066	50	1	0	0	51
OG0000067	51	0	0	0	51
OG0000068	39	6	3	3	51
OG0000069	1	50	0	0	51
OG0000070	1	50	0	0	51
OG0000071	0	51	0	0	51
OG0000072	0	51	0	0	51
OG0000073	0	51	0	0	51
OG0000074	0	51	0	0	51
OG0000075	49	1	0	0	50
OG0000076	1	49	0	0	50
OG0000077	23	25	1	1	50
OG0000078	0	50	0	0	50
OG0000079	1	48	0	0	49
OG0000080	0	48	0	0	48
OG0000081	47	0	0	0	47
OG0000082	46	0	0	0	46
OG0000083	3	43	0	0	46
OG0000084	1	45	0	0	46
OG0000085	0	46	0	0	46
OG0000086	0	0	8	38	46
OG0000087	41	4	0	0	45
OG0000088	44	1	0	0	45
OG0000089	5	40	0	0	45
OG0000090	44	0	0	0	44
OG0000091	44	0	0	0	44
OG0000092	43	0	0	0	43
OG0000093	8	8	15	12	43
OG0000094	2	41	0	0	43
OG0000095	13	12	10	8	43
OG0000096	0	43	0	0	43
OG0000097	17	14	4	7	42
OG0000098	1	40	0	1	42
OG0000099	1	41	0	0	42
OG0000100	11	9	10	11	41
OG0000101	9	24	6	2	41
OG0000102	0	41	0	0	41
OG0000103	0	4	16	21	41
OG0000104	26	13	1	0	40
OG0000105	8	17	12	3	40
OG0000106	1	37	1	1	40
OG0000107	1	39	0	0	40
OG0000108	0	40	0	0	40
OG0000109	0	38	1	1	40
OG0000110	0	40	0	0	40
OG0000111	39	0	0	0	39
OG0000112	37	2	0	0	39
OG0000113	39	0	0	0	39
OG0000114	13	11	12	3	39
OG0000115	15	12	5	7	39
OG0000116	0	38	0	1	39
OG0000117	0	39	0	0	39
OG0000118	37	1	0	0	38
OG0000119	14	21	1	2	38
OG0000120	37	1	0	0	38
OG0000121	1	10	16	11	38
OG0000122	0	38	0	0	38
OG0000123	0	36	1	1	38
OG0000124	37	0	0	0	37
OG0000125	14	20	2	1	37
OG0000126	14	10	7	6	37
OG0000127	1	33	1	2	37
OG0000128	0	37	0	0	37
OG0000129	0	33	2	2	37
OG0000130	0	37	0	0	37
OG0000131	0	37	0	0	37
OG0000132	35	1	0	0	36
OG0000133	31	5	0	0	36
OG0000134	36	0	0	0	36
OG0000135	18	2	10	6	36
OG0000136	33	3	0	0	36
OG0000137	36	0	0	0	36
OG0000138	4	5	18	9	36
OG0000139	1	32	0	3	36
OG0000140	1	35	0	0	36
OG0000141	0	36	0	0	36
OG0000142	0	33	2	1	36
OG0000143	0	36	0	0	36
OG0000144	0	35	1	0	36
OG0000145	0	36	0	0	36
OG0000146	0	34	1	1	36
OG0000147	12	14	4	5	35
OG0000148	11	16	7	1	35
OG0000149	31	4	0	0	35
OG0000150	22	12	0	1	35
OG0000151	11	9	7	8	35
OG0000152	15	5	10	5	35
OG0000153	0	35	0	0	35
OG0000154	0	35	0	0	35
OG0000155	1	8	14	11	34
OG0000156	6	28	0	0	34
OG0000157	1	2	17	14	34
OG0000158	5	26	1	2	34
OG0000159	0	28	1	5	34
OG0000160	0	0	24	10	34
OG0000161	30	3	0	0	33
OG0000162	32	1	0	0	33
OG0000163	32	1	0	0	33
OG0000164	1	0	14	18	33
OG0000165	32	1	0	0	33
OG0000166	7	7	12	7	33
OG0000167	8	24	1	0	33
OG0000168	0	31	1	1	33
OG0000169	0	33	0	0	33
OG0000170	32	0	0	0	32
OG0000171	29	3	0	0	32
OG0000172	2	8	12	10	32
OG0000173	1	30	1	0	32
OG0000174	18	12	1	1	32
OG0000175	7	7	11	7	32
OG0000176	0	32	0	0	32
OG0000177	0	32	0	0	32
OG0000178	0	9	17	6	32
OG0000179	0	32	0	0	32
OG0000180	0	12	11	9	32
OG0000181	0	32	0	0	32
OG0000182	0	32	0	0	32
OG0000183	0	32	0	0	32
OG0000184	0	8	8	16	32
OG0000185	16	13	2	0	31
OG0000186	4	27	0	0	31
OG0000187	6	5	8	12	31
OG0000188	1	2	19	9	31
OG0000189	6	4	14	7	31
OG0000190	8	19	4	0	31
OG0000191	10	9	7	5	31
OG0000192	10	6	9	6	31
OG0000193	13	14	2	2	31
OG0000194	1	30	0	0	31
OG0000195	5	23	1	2	31
OG0000196	0	31	0	0	31
OG0000197	0	29	2	0	31
OG0000198	0	21	8	2	31
OG0000199	0	31	0	0	31
OG0000200	0	31	0	0	31
OG0000201	0	31	0	0	31
OG0000202	30	0	0	0	30
OG0000203	30	0	0	0	30
OG0000204	15	8	5	2	30
OG0000205	10	17	3	0	30
OG0000206	7	18	4	1	30
OG0000207	4	8	9	9	30
OG0000208	2	27	1	0	30
OG0000209	10	8	6	6	30
OG0000210	1	25	2	2	30
OG0000211	1	25	1	3	30
OG0000212	1	26	1	2	30
OG0000213	0	30	0	0	30
OG0000214	0	30	0	0	30
OG0000215	0	30	0	0	30
OG0000216	0	0	29	1	30
OG0000217	12	12	1	4	29
OG0000218	11	10	5	3	29
OG0000219	24	5	0	0	29
OG0000220	13	2	7	7	29
OG0000221	1	28	0	0	29
OG0000222	2	24	1	2	29
OG0000223	3	25	1	0	29
OG0000224	3	8	9	9	29
OG0000225	1	28	0	0	29
OG0000226	2	27	0	0	29
OG0000227	11	8	5	5	29
OG0000228	2	25	1	1	29
OG0000229	0	29	0	0	29
OG0000230	0	28	0	1	29
OG0000231	0	27	0	2	29
OG0000232	0	29	0	0	29
OG0000233	0	29	0	0	29
OG0000234	0	29	0	0	29
OG0000235	0	29	0	0	29
OG0000236	0	29	0	0	29
OG0000237	27	1	0	0	28
OG0000238	27	1	0	0	28
OG0000239	28	0	0	0	28
OG0000240	6	19	2	1	28
OG0000241	12	11	3	2	28
OG0000242	2	1	7	18	28
OG0000243	19	7	0	2	28
OG0000244	1	24	1	2	28
OG0000245	1	1	11	15	28
OG0000246	2	1	13	12	28
OG0000247	1	23	2	2	28
OG0000248	7	7	7	7	28
OG0000249	2	24	1	1	28
OG0000250	2	25	1	0	28
OG0000251	1	25	1	1	28
OG0000252	0	28	0	0	28
OG0000253	0	28	0	0	28
OG0000254	0	28	0	0	28
OG0000255	0	28	0	0	28
OG0000256	0	25	1	2	28
OG0000257	0	3	22	3	28
OG0000258	0	0	2	26	28
OG0000259	20	6	1	0	27
OG0000260	5	19	1	2	27
OG0000261	27	0	0	0	27
OG0000262	8	7	9	3	27
OG0000263	1	26	0	0	27
OG0000264	12	13	1	1	27
OG0000265	3	2	8	14	27
OG0000266	18	9	0	0	27
OG0000267	2	25	0	0	27
OG0000268	1	1	9	16	27
OG0000269	1	1	11	14	27
OG0000270	0	27	0	0	27
OG0000271	0	27	0	0	27
OG0000272	0	25	1	1	27
OG0000273	0	25	1	1	27
OG0000274	0	25	1	1	27
OG0000275	0	26	0	1	27
OG0000276	16	7	2	1	26
OG0000277	15	11	0	0	26
OG0000278	25	1	0	0	26
OG0000279	24	2	0	0	26
OG0000280	5	4	9	8	26
OG0000281	25	1	0	0	26
OG0000282	11	5	5	5	26
OG0000283	25	1	0	0	26
OG0000284	4	3	7	12	26
OG0000285	1	1	21	3	26
OG0000286	10	13	3	0	26
OG0000287	1	25	0	0	26
OG0000288	6	18	0	2	26
OG0000289	3	3	16	4	26
OG0000290	10	16	0	0	26
OG0000291	6	5	2	13	26
OG0000292	1	25	0	0	26
OG0000293	5	3	11	7	26
OG0000294	1	25	0	0	26
OG0000295	4	2	7	13	26
OG0000296	0	26	0	0	26
OG0000297	0	26	0	0	26
OG0000298	0	16	6	4	26
OG0000299	0	26	0	0	26
OG0000300	0	25	0	1	26
OG0000301	0	25	0	1	26
OG0000302	0	25	1	0	26
OG0000303	0	25	0	1	26
OG0000304	0	26	0	0	26
OG0000305	0	26	0	0	26
OG0000306	0	0	1	25	26
OG0000307	20	5	0	0	25
OG0000308	25	0	0	0	25
OG0000309	8	7	6	4	25
OG0000310	23	2	0	0	25
OG0000311	24	1	0	0	25
OG0000312	6	3	4	12	25
OG0000313	11	6	3	5	25
OG0000314	12	5	8	0	25
OG0000315	18	4	2	1	25
OG0000316	9	6	2	8	25
OG0000317	2	23	0	0	25
OG0000318	1	1	7	16	25
OG0000319	2	1	11	11	25
OG0000320	0	25	0	0	25
OG0000321	0	24	0	1	25
OG0000322	0	3	0	22	25
OG0000323	0	25	0	0	25
OG0000324	0	25	0	0	25
OG0000325	0	25	0	0	25
OG0000326	0	25	0	0	25
OG0000327	0	9	12	4	25
OG0000328	21	3	0	0	24
OG0000329	24	0	0	0	24
OG0000330	11	10	2	1	24
OG0000331	1	22	0	1	24
OG0000332	8	6	8	2	24
OG0000333	23	0	0	1	24
OG0000334	4	20	0	0	24
OG0000335	3	4	4	13	24
OG0000336	2	4	8	10	24
OG0000337	1	1	8	14	24
OG0000338	1	22	0	1	24
OG0000339	0	24	0	0	24
OG0000340	0	22	1	1	24
OG0000341	0	24	0	0	24
OG0000342	0	19	0	5	24
OG0000343	0	23	1	0	24
OG0000344	22	1	0	0	23
OG0000345	23	0	0	0	23
OG0000346	11	12	0	0	23
OG0000347	22	1	0	0	23
OG0000348	5	1	10	7	23
OG0000349	19	1	3	0	23
OG0000350	3	16	2	2	23
OG0000351	21	2	0	0	23
OG0000352	1	21	0	1	23
OG0000353	1	22	0	0	23
OG0000354	12	6	2	3	23
OG0000355	7	7	3	6	23
OG0000356	3	4	11	5	23
OG0000357	13	3	5	2	23
OG0000358	12	2	4	5	23
OG0000359	1	1	1	20	23
OG0000360	1	0	0	22	23
OG0000361	2	1	6	14	23
OG0000362	0	23	0	0	23
OG0000363	0	23	0	0	23
OG0000364	0	21	1	1	23
OG0000365	0	23	0	0	23
OG0000366	0	23	0	0	23
OG0000367	0	0	7	16	23
OG0000368	0	0	0	23	23
OG0000369	20	2	0	0	22
OG0000370	22	0	0	0	22
OG0000371	6	7	4	5	22
OG0000372	1	4	5	12	22
OG0000373	16	6	0	0	22
OG0000374	15	7	0	0	22
OG0000375	11	1	1	9	22
OG0000376	20	2	0	0	22
OG0000377	5	2	6	9	22
OG0000378	22	0	0	0	22
OG0000379	2	3	2	15	22
OG0000380	20	0	2	0	22
OG0000381	6	10	3	3	22
OG0000382	12	7	1	2	22
OG0000383	1	3	17	1	22
OG0000384	6	2	10	4	22
OG0000385	4	16	1	1	22
OG0000386	5	1	10	6	22
OG0000387	1	1	14	6	22
OG0000388	6	0	5	11	22
OG0000389	2	1	9	10	22
OG0000390	2	3	6	11	22
OG0000391	1	6	10	5	22
OG0000392	5	3	6	8	22
OG0000393	1	20	1	0	22
OG0000394	0	22	0	0	22
OG0000395	0	22	0	0	22
OG0000396	0	22	0	0	22
OG0000397	0	22	0	0	22
OG0000398	0	22	0	0	22
OG0000399	0	0	11	11	22
OG0000400	18	1	1	1	21
OG0000401	15	6	0	0	21
OG0000402	6	5	5	5	21
OG0000403	20	1	0	0	21
OG0000404	2	9	3	7	21
OG0000405	11	6	1	3	21
OG0000406	7	4	5	5	21
OG0000407	1	0	11	9	21
OG0000408	8	2	6	5	21
OG0000409	12	5	0	4	21
OG0000410	14	7	0	0	21
OG0000411	7	8	4	2	21
OG0000412	15	6	0	0	21
OG0000413	6	5	7	3	21
OG0000414	3	17	1	0	21
OG0000415	5	4	6	6	21
OG0000416	7	7	4	3	21
OG0000417	1	15	3	2	21
OG0000418	19	2	0	0	21
OG0000419	6	6	4	5	21
OG0000420	1	0	9	11	21
OG0000421	2	1	12	6	21
OG0000422	1	18	2	0	21
OG0000423	4	2	6	9	21
OG0000424	2	0	11	8	21
OG0000425	1	0	11	9	21
OG0000426	8	7	2	4	21
OG0000427	3	0	18	0	21
OG0000428	2	1	12	6	21
OG0000429	1	20	0	0	21
OG0000430	0	21	0	0	21
OG0000431	0	21	0	0	21
OG0000432	0	12	3	6	21
OG0000433	0	21	0	0	21
OG0000434	0	21	0	0	21
OG0000435	0	21	0	0	21
OG0000436	0	15	1	5	21
OG0000437	0	0	5	16	21
OG0000438	7	11	0	2	20
OG0000439	1	18	1	0	20
OG0000440	19	1	0	0	20
OG0000441	1	18	1	0	20
OG0000442	9	10	0	1	20
OG0000443	10	5	3	2	20
OG0000444	5	4	6	5	20
OG0000445	8	4	3	5	20
OG0000446	1	1	18	0	20
OG0000447	14	6	0	0	20
OG0000448	16	2	1	1	20
OG0000449	2	17	1	0	20
OG0000450	16	4	0	0	20
OG0000451	7	3	4	6	20
OG0000452	1	1	2	16	20
OG0000453	8	11	1	0	20
OG0000454	9	5	2	4	20
OG0000455	3	2	8	7	20
OG0000456	6	3	5	6	20
OG0000457	9	6	2	3	20
OG0000458	2	6	5	7	20
OG0000459	3	3	12	2	20
OG0000460	9	2	5	4	20
OG0000461	9	6	2	3	20
OG0000462	1	19	0	0	20
OG0000463	7	4	4	5	20
OG0000464	5	2	8	5	20
OG0000465	10	4	2	4	20
OG0000466	1	11	4	4	20
OG0000467	1	19	0	0	20
OG0000468	2	1	7	10	20
OG0000469	3	4	8	5	20
OG0000470	11	4	3	2	20
OG0000471	1	19	0	0	20
OG0000472	2	1	11	6	20
OG0000473	3	3	9	5	20
OG0000474	7	4	5	4	20
OG0000475	2	2	8	8	20
OG0000476	9	6	2	3	20
OG0000477	0	20	0	0	20
OG0000478	0	20	0	0	20
OG0000479	0	20	0	0	20
OG0000480	0	20	0	0	20
OG0000481	0	20	0	0	20
OG0000482	0	20	0	0	20
OG0000483	0	20	0	0	20
OG0000484	0	20	0	0	20
OG0000485	0	19	1	0	20
OG0000486	0	20	0	0	20
OG0000487	0	0	20	0	20
OG0000488	0	0	12	8	20
OG0000489	14	5	0	0	19
OG0000490	14	5	0	0	19
OG0000491	11	8	0	0	19
OG0000492	13	6	0	0	19
OG0000493	10	7	1	1	19
OG0000494	4	4	9	2	19
OG0000495	1	1	15	2	19
OG0000496	1	5	8	5	19
OG0000497	1	1	3	14	19
OG0000498	5	5	5	4	19
OG0000499	3	3	5	8	19
OG0000500	16	3	0	0	19
OG0000501	6	7	1	5	19
OG0000502	14	2	2	1	19
OG0000503	5	14	0	0	19
OG0000504	1	1	15	2	19
OG0000505	19	0	0	0	19
OG0000506	5	5	5	4	19
OG0000507	2	1	3	13	19
OG0000508	3	15	1	0	19
OG0000509	15	4	0	0	19
OG0000510	1	1	9	8	19
OG0000511	6	6	4	3	19
OG0000512	3	16	0	0	19
OG0000513	4	15	0	0	19
OG0000514	13	5	1	0	19
OG0000515	16	1	0	2	19
OG0000516	10	4	2	3	19
OG0000517	4	1	6	8	19
OG0000518	8	5	3	3	19
OG0000519	9	4	1	5	19
OG0000520	1	18	0	0	19
OG0000521	11	4	2	2	19
OG0000522	2	17	0	0	19
OG0000523	1	0	10	8	19
OG0000524	1	1	5	12	19
OG0000525	1	2	9	7	19
OG0000526	2	2	6	9	19
OG0000527	2	5	6	6	19
OG0000528	2	4	3	10	19
OG0000529	3	5	7	4	19
OG0000530	5	2	6	6	19
OG0000531	2	1	7	9	19
OG0000532	1	15	1	2	19
OG0000533	0	19	0	0	19
OG0000534	0	19	0	0	19
OG0000535	0	19	0	0	19
OG0000536	0	19	0	0	19
OG0000537	0	15	1	3	19
OG0000538	0	1	8	10	19
OG0000539	0	3	14	2	19
OG0000540	0	0	1	18	19
OG0000541	0	0	10	9	19
OG0000542	0	0	4	15	19
OG0000543	3	15	0	0	18
OG0000544	16	2	0	0	18
OG0000545	4	4	6	4	18
OG0000546	6	7	4	1	18
OG0000547	8	5	2	3	18
OG0000548	3	1	8	6	18
OG0000549	3	1	2	12	18
OG0000550	6	6	1	5	18
OG0000551	3	1	7	7	18
OG0000552	1	1	7	9	18
OG0000553	1	1	6	10	18
OG0000554	7	10	0	1	18
OG0000555	10	3	5	0	18
OG0000556	5	12	1	0	18
OG0000557	3	1	1	13	18
OG0000558	17	1	0	0	18
OG0000559	4	2	6	6	18
OG0000560	2	1	5	10	18
OG0000561	4	12	2	0	18
OG0000562	3	3	6	6	18
OG0000563	2	2	4	10	18
OG0000564	3	3	0	12	18
OG0000565	16	0	2	0	18
OG0000566	2	13	1	2	18
OG0000567	1	1	8	8	18
OG0000568	9	4	3	2	18
OG0000569	2	1	8	7	18
OG0000570	16	0	1	1	18
OG0000571	1	1	7	9	18
OG0000572	18	0	0	0	18
OG0000573	1	1	7	9	18
OG0000574	2	1	7	8	18
OG0000575	3	0	10	5	18
OG0000576	1	1	7	9	18
OG0000577	4	3	8	3	18
OG0000578	2	15	0	1	18
OG0000579	3	15	0	0	18
OG0000580	4	4	6	4	18
OG0000581	6	3	4	5	18
OG0000582	2	16	0	0	18
OG0000583	7	5	4	2	18
OG0000584	3	2	10	3	18
OG0000585	2	2	6	8	18
OG0000586	1	4	4	9	18
OG0000587	3	1	6	8	18
OG0000588	9	4	1	4	18
OG0000589	2	1	12	3	18
OG0000590	4	6	5	3	18
OG0000591	3	0	8	7	18
OG0000592	2	1	8	7	18
OG0000593	1	4	7	6	18
OG0000594	0	18	0	0	18
OG0000595	0	18	0	0	18
OG0000596	0	18	0	0	18
OG0000597	0	17	1	0	18
OG0000598	0	18	0	0	18
OG0000599	0	18	0	0	18
OG0000600	0	18	0	0	18
OG0000601	0	0	18	0	18
OG0000602	0	0	1	17	18
OG0000603	10	6	1	0	17
OG0000604	3	2	1	11	17
OG0000605	4	10	2	1	17
OG0000606	8	1	4	4	17
OG0000607	16	1	0	0	17
OG0000608	12	5	0	0	17
OG0000609	16	1	0	0	17
OG0000610	15	2	0	0	17
OG0000611	3	5	4	5	17
OG0000612	1	1	9	6	17
OG0000613	4	3	6	4	17
OG0000614	3	3	5	6	17
OG0000615	5	12	0	0	17
OG0000616	5	3	5	4	17
OG0000617	5	4	4	4	17
OG0000618	4	4	4	5	17
OG0000619	4	4	5	4	17
OG0000620	3	3	5	6	17
OG0000621	6	1	6	4	17
OG0000622	2	2	7	6	17
OG0000623	6	3	4	4	17
OG0000624	1	1	7	8	17
OG0000625	5	5	4	3	17
OG0000626	4	5	6	2	17
OG0000627	7	2	4	4	17
OG0000628	5	6	1	5	17
OG0000629	2	2	4	9	17
OG0000630	2	1	4	10	17
OG0000631	2	4	11	0	17
OG0000632	8	3	3	3	17
OG0000633	7	8	1	1	17
OG0000634	5	4	4	4	17
OG0000635	4	3	3	7	17
OG0000636	7	8	1	1	17
OG0000637	1	14	2	0	17
OG0000638	13	2	1	1	17
OG0000639	3	3	4	7	17
OG0000640	2	1	6	8	17
OG0000641	10	0	1	6	17
OG0000642	1	1	8	7	17
OG0000643	1	0	9	7	17
OG0000644	3	1	7	6	17
OG0000645	3	4	5	5	17
OG0000646	3	3	5	6	17
OG0000647	1	1	10	5	17
OG0000648	3	1	8	5	17
OG0000649	4	3	4	6	17
OG0000650	5	5	2	5	17
OG0000651	2	2	5	8	17
OG0000652	2	1	14	0	17
OG0000653	9	0	1	7	17
OG0000654	1	2	8	6	17
OG0000655	1	0	6	10	17
OG0000656	1	14	0	2	17
OG0000657	0	17	0	0	17
OG0000658	0	17	0	0	17
OG0000659	0	17	0	0	17
OG0000660	0	17	0	0	17
OG0000661	0	17	0	0	17
OG0000662	0	16	1	0	17
OG0000663	0	1	12	4	17
OG0000664	0	17	0	0	17
OG0000665	0	17	0	0	17
OG0000666	0	17	0	0	17
OG0000667	0	2	13	2	17
OG0000668	0	4	0	13	17
OG0000669	0	4	6	7	17
OG0000670	0	13	1	3	17
OG0000671	3	3	6	4	16
OG0000672	16	0	0	0	16
OG0000673	5	3	4	4	16
OG0000674	1	1	8	6	16
OG0000675	16	0	0	0	16
OG0000676	4	7	0	5	16
OG0000677	15	1	0	0	16
OG0000678	4	12	0	0	16
OG0000679	5	1	5	5	16
OG0000680	4	4	3	5	16
OG0000681	3	3	2	8	16
OG0000682	5	4	4	3	16
OG0000683	4	2	5	5	16
OG0000684	16	0	0	0	16
OG0000685	4	11	0	1	16
OG0000686	16	0	0	0	16
OG0000687	16	0	0	0	16
OG0000688	3	4	5	4	16
OG0000689	11	4	0	1	16
OG0000690	8	5	2	1	16
OG0000691	6	6	2	2	16
OG0000692	3	3	5	5	16
OG0000693	1	1	7	7	16
OG0000694	2	1	7	6	16
OG0000695	4	3	4	5	16
OG0000696	2	1	5	8	16
OG0000697	5	3	6	2	16
OG0000698	6	4	2	4	16
OG0000699	3	2	4	7	16
OG0000700	1	1	9	5	16
OG0000701	8	4	1	3	16
OG0000702	3	10	1	2	16
OG0000703	2	1	8	5	16
OG0000704	11	5	0	0	16
OG0000705	2	14	0	0	16
OG0000706	8	6	1	1	16
OG0000707	8	4	2	2	16
OG0000708	5	2	4	5	16
OG0000709	3	11	1	1	16
OG0000710	5	5	5	1	16
OG0000711	3	1	7	5	16
OG0000712	1	1	5	9	16
OG0000713	4	2	7	3	16
OG0000714	4	2	5	5	16
OG0000715	4	5	2	5	16
OG0000716	1	1	12	2	16
OG0000717	2	2	11	1	16
OG0000718	1	1	5	9	16
OG0000719	2	1	5	8	16
OG0000720	4	3	2	7	16
OG0000721	2	0	11	3	16
OG0000722	6	8	1	1	16
OG0000723	1	14	0	1	16
OG0000724	3	1	6	6	16
OG0000725	1	1	6	8	16
OG0000726	2	1	8	5	16
OG0000727	1	1	5	9	16
OG0000728	16	0	0	0	16
OG0000729	2	1	7	6	16
OG0000730	4	4	5	3	16
OG0000731	5	2	2	7	16
OG0000732	15	0	1	0	16
OG0000733	1	14	1	0	16
OG0000734	5	5	3	3	16
OG0000735	1	5	10	0	16
OG0000736	2	1	6	7	16
OG0000737	1	0	6	9	16
OG0000738	1	5	6	4	16
OG0000739	1	1	4	10	16
OG0000740	1	15	0	0	16
OG0000741	2	1	2	11	16
OG0000742	5	6	3	2	16
OG0000743	11	5	0	0	16
OG0000744	1	2	5	8	16
OG0000745	1	0	15	0	16
OG0000746	0	16	0	0	16
OG0000747	0	16	0	0	16
OG0000748	0	16	0	0	16
OG0000749	0	14	1	1	16
OG0000750	0	16	0	0	16
OG0000751	0	16	0	0	16
OG0000752	0	16	0	0	16
OG0000753	0	15	1	0	16
OG0000754	0	16	0	0	16
OG0000755	0	13	1	2	16
OG0000756	0	1	11	4	16
OG0000757	0	0	1	15	16
OG0000758	0	0	1	15	16
OG0000759	0	0	10	6	16
OG0000760	13	2	0	0	15
OG0000761	15	0	0	0	15
OG0000762	7	7	1	0	15
OG0000763	1	1	2	11	15
OG0000764	15	0	0	0	15
OG0000765	15	0	0	0	15
OG0000766	6	3	3	3	15
OG0000767	14	1	0	0	15
OG0000768	7	6	1	1	15
OG0000769	4	4	4	3	15
OG0000770	7	7	1	0	15
OG0000771	7	8	0	0	15
OG0000772	1	1	0	13	15
OG0000773	1	0	8	6	15
OG0000774	1	1	8	5	15
OG0000775	3	3	5	4	15
OG0000776	4	2	4	5	15
OG0000777	9	5	1	0	15
OG0000778	3	3	4	5	15
OG0000779	3	2	4	6	15
OG0000780	6	5	4	0	15
OG0000781	6	5	2	2	15
OG0000782	4	3	3	5	15
OG0000783	4	4	4	3	15
OG0000784	1	1	8	5	15
OG0000785	2	1	7	5	15
OG0000786	15	0	0	0	15
OG0000787	2	1	3	9	15
OG0000788	2	13	0	0	15
OG0000789	3	3	5	4	15
OG0000790	7	2	2	4	15
OG0000791	5	4	2	4	15
OG0000792	3	12	0	0	15
OG0000793	3	3	6	3	15
OG0000794	4	3	4	4	15
OG0000795	4	5	4	2	15
OG0000796	3	6	3	3	15
OG0000797	1	1	2	11	15
OG0000798	3	5	4	3	15
OG0000799	2	1	8	4	15
OG0000800	4	4	3	4	15
OG0000801	13	2	0	0	15
OG0000802	4	3	3	5	15
OG0000803	2	1	5	7	15
OG0000804	1	3	6	5	15
OG0000805	3	4	4	4	15
OG0000806	4	4	4	3	15
OG0000807	3	2	6	4	15
OG0000808	2	4	6	3	15
OG0000809	3	6	3	3	15
OG0000810	5	2	3	5	15
OG0000811	4	3	4	4	15
OG0000812	1	1	7	6	15
OG0000813	1	14	0	0	15
OG0000814	6	2	3	4	15
OG0000815	2	1	4	8	15
OG0000816	1	1	8	5	15
OG0000817	3	1	6	5	15
OG0000818	7	4	2	2	15
OG0000819	5	5	3	2	15
OG0000820	1	13	1	0	15
OG0000821	3	2	5	5	15
OG0000822	1	1	4	9	15
OG0000823	1	1	5	8	15
OG0000824	6	3	5	1	15
OG0000825	3	2	6	4	15
OG0000826	1	5	2	7	15
OG0000827	3	3	4	5	15
OG0000828	4	2	5	4	15
OG0000829	3	5	4	3	15
OG0000830	2	2	3	8	15
OG0000831	2	13	0	0	15
OG0000832	7	6	1	1	15
OG0000833	4	2	6	3	15
OG0000834	1	1	8	5	15
OG0000835	3	1	5	6	15
OG0000836	1	1	6	7	15
OG0000837	3	1	7	4	15
OG0000838	3	2	4	6	15
OG0000839	7	3	4	1	15
OG0000840	1	1	4	9	15
OG0000841	2	4	4	5	15
OG0000842	3	3	3	6	15
OG0000843	1	1	8	5	15
OG0000844	1	14	0	0	15
OG0000845	2	1	1	11	15
OG0000846	3	2	7	3	15
OG0000847	4	9	1	1	15
OG0000848	2	2	3	8	15
OG0000849	5	4	4	2	15
OG0000850	1	1	3	10	15
OG0000851	2	1	4	8	15
OG0000852	1	1	10	3	15
OG0000853	3	1	5	6	15
OG0000854	1	1	2	11	15
OG0000855	4	2	5	4	15
OG0000856	3	2	2	8	15
OG0000857	0	15	0	0	15
OG0000858	0	14	1	0	15
OG0000859	0	15	0	0	15
OG0000860	0	15	0	0	15
OG0000861	0	15	0	0	15
OG0000862	0	15	0	0	15
OG0000863	0	15	0	0	15
OG0000864	0	14	1	0	15
OG0000865	0	5	1	9	15
OG0000866	0	15	0	0	15
OG0000867	0	1	5	9	15
OG0000868	0	15	0	0	15
OG0000869	0	1	5	9	15
OG0000870	0	0	14	1	15
OG0000871	0	0	10	5	15
OG0000872	0	0	0	15	15
OG0000873	10	4	0	0	14
OG0000874	7	7	0	0	14
OG0000875	13	1	0	0	14
OG0000876	2	2	6	4	14
OG0000877	1	1	11	1	14
OG0000878	13	1	0	0	14
OG0000879	2	11	1	0	14
OG0000880	10	4	0	0	14
OG0000881	10	2	1	1	14
OG0000882	1	1	4	8	14
OG0000883	3	0	11	0	14
OG0000884	5	4	3	2	14
OG0000885	4	1	4	5	14
OG0000886	7	5	0	2	14
OG0000887	5	2	4	3	14
OG0000888	2	1	7	4	14
OG0000889	14	0	0	0	14
OG0000890	11	3	0	0	14
OG0000891	4	10	0	0	14
OG0000892	3	3	4	4	14
OG0000893	5	5	2	2	14
OG0000894	2	1	10	1	14
OG0000895	5	1	7	1	14
OG0000896	1	0	6	7	14
OG0000897	4	2	4	4	14
OG0000898	1	0	9	4	14
OG0000899	1	1	9	3	14
OG0000900	4	3	3	4	14
OG0000901	4	3	4	3	14
OG0000902	4	4	3	3	14
OG0000903	1	2	3	8	14
OG0000904	1	4	4	5	14
OG0000905	11	2	1	0	14
OG0000906	3	3	4	4	14
OG0000907	6	7	1	0	14
OG0000908	3	5	3	3	14
OG0000909	3	1	4	6	14
OG0000910	4	3	4	3	14
OG0000911	5	3	3	3	14
OG0000912	9	3	1	1	14
OG0000913	1	1	7	5	14
OG0000914	4	1	2	7	14
OG0000915	6	4	1	3	14
OG0000916	5	2	4	3	14
OG0000917	7	4	2	1	14
OG0000918	7	2	2	3	14
OG0000919	1	1	4	8	14
OG0000920	1	1	5	7	14
OG0000921	2	2	5	5	14
OG0000922	4	3	3	4	14
OG0000923	2	1	6	5	14
OG0000924	3	5	4	2	14
OG0000925	4	4	2	4	14
OG0000926	2	1	5	6	14
OG0000927	4	4	2	4	14
OG0000928	2	11	1	0	14
OG0000929	3	11	0	0	14
OG0000930	4	2	3	5	14
OG0000931	4	2	3	5	14
OG0000932	4	2	4	4	14
OG0000933	6	3	2	3	14
OG0000934	4	1	4	5	14
OG0000935	1	1	2	10	14
OG0000936	2	1	5	6	14
OG0000937	1	1	3	9	14
OG0000938	2	1	3	8	14
OG0000939	1	1	4	8	14
OG0000940	2	3	4	5	14
OG0000941	1	0	8	5	14
OG0000942	2	1	4	7	14
OG0000943	2	2	5	5	14
OG0000944	4	1	5	4	14
OG0000945	4	3	4	3	14
OG0000946	1	13	0	0	14
OG0000947	3	1	8	2	14
OG0000948	1	1	2	10	14
OG0000949	4	5	2	3	14
OG0000950	4	5	3	2	14
OG0000951	1	1	7	5	14
OG0000952	5	5	2	2	14
OG0000953	7	4	2	1	14
OG0000954	2	12	0	0	14
OG0000955	5	5	3	1	14
OG0000956	1	13	0	0	14
OG0000957	1	0	5	8	14
OG0000958	5	4	3	2	14
OG0000959	2	1	8	3	14
OG0000960	1	1	5	7	14
OG0000961	1	1	6	6	14
OG0000962	3	1	5	5	14
OG0000963	1	1	5	7	14
OG0000964	1	1	5	7	14
OG0000965	4	2	2	6	14
OG0000966	2	1	5	6	14
OG0000967	1	1	7	5	14
OG0000968	1	1	2	10	14
OG0000969	2	4	5	3	14
OG0000970	3	1	4	6	14
OG0000971	1	1	5	7	14
OG0000972	5	0	6	3	14
OG0000973	4	2	5	3	14
OG0000974	2	1	3	8	14
OG0000975	1	1	5	7	14
OG0000976	3	1	3	7	14
OG0000977	2	1	4	7	14
OG0000978	1	4	6	3	14
OG0000979	2	3	4	5	14
OG0000980	1	1	5	7	14
OG0000981	2	11	1	0	14
OG0000982	1	1	8	4	14
OG0000983	2	2	3	7	14
OG0000984	2	1	6	5	14
OG0000985	1	1	6	6	14
OG0000986	2	1	6	5	14
OG0000987	0	13	1	0	14
OG0000988	0	14	0	0	14
OG0000989	0	12	1	1	14
OG0000990	0	14	0	0	14
OG0000991	0	14	0	0	14
OG0000992	0	14	0	0	14
OG0000993	0	14	0	0	14
OG0000994	0	1	8	5	14
OG0000995	0	14	0	0	14
OG0000996	0	14	0	0	14
OG0000997	0	14	0	0	14
OG0000998	0	10	2	2	14
OG0000999	0	9	2	3	14
OG0001000	0	5	4	5	14
OG0001001	0	1	13	0	14
OG0001002	0	0	9	5	14
OG0001003	0	0	5	9	14
OG0001004	0	0	1	13	14
OG0001005	11	1	1	0	13
OG0001006	9	2	0	2	13
OG0001007	9	4	0	0	13
OG0001008	8	5	0	0	13
OG0001009	12	1	0	0	13
OG0001010	12	1	0	0	13
OG0001011	13	0	0	0	13
OG0001012	7	6	0	0	13
OG0001013	9	4	0	0	13
OG0001014	5	6	1	1	13
OG0001015	12	1	0	0	13
OG0001016	5	8	0	0	13
OG0001017	13	0	0	0	13
OG0001018	3	10	0	0	13
OG0001019	1	1	6	5	13
OG0001020	3	3	4	3	13
OG0001021	3	3	4	3	13
OG0001022	4	3	3	3	13
OG0001023	2	6	3	2	13
OG0001024	5	1	4	3	13
OG0001025	2	1	3	7	13
OG0001026	3	3	3	4	13
OG0001027	3	2	5	3	13
OG0001028	3	0	3	7	13
OG0001029	4	2	4	3	13
OG0001030	5	8	0	0	13
OG0001031	5	5	1	2	13
OG0001032	9	4	0	0	13
OG0001033	4	2	4	3	13
OG0001034	11	2	0	0	13
OG0001035	1	12	0	0	13
OG0001036	7	1	2	3	13
OG0001037	13	0	0	0	13
OG0001038	1	2	1	9	13
OG0001039	3	1	4	5	13
OG0001040	6	7	0	0	13
OG0001041	4	1	3	5	13
OG0001042	3	4	2	4	13
OG0001043	2	1	5	5	13
OG0001044	4	4	2	3	13
OG0001045	5	3	3	2	13
OG0001046	3	3	3	4	13
OG0001047	5	7	0	1	13
OG0001048	3	2	3	5	13
OG0001049	2	1	3	7	13
OG0001050	5	4	2	2	13
OG0001051	4	2	4	3	13
OG0001052	1	3	4	5	13
OG0001053	9	4	0	0	13
OG0001054	6	1	2	4	13
OG0001055	3	3	4	3	13
OG0001056	3	3	3	4	13
OG0001057	4	4	2	3	13
OG0001058	9	4	0	0	13
OG0001059	2	2	3	6	13
OG0001060	4	4	3	2	13
OG0001061	2	1	6	4	13
OG0001062	3	4	3	3	13
OG0001063	2	1	1	9	13
OG0001064	1	1	6	5	13
OG0001065	3	3	3	4	13
OG0001066	1	1	7	4	13
OG0001067	3	3	4	3	13
OG0001068	2	1	6	4	13
OG0001069	2	1	6	4	13
OG0001070	1	3	3	6	13
OG0001071	6	5	1	1	13
OG0001072	1	12	0	0	13
OG0001073	2	3	4	4	13
OG0001074	2	2	6	3	13
OG0001075	1	12	0	0	13
OG0001076	3	2	4	4	13
OG0001077	3	2	4	4	13
OG0001078	2	1	1	9	13
OG0001079	3	3	4	3	13
OG0001080	3	10	0	0	13
OG0001081	7	3	2	1	13
OG0001082	7	1	2	3	13
OG0001083	3	3	3	4	13
OG0001084	1	0	4	8	13
OG0001085	2	1	5	5	13
OG0001086	1	3	7	2	13
OG0001087	1	1	5	6	13
OG0001088	1	1	9	2	13
OG0001089	4	2	5	2	13
OG0001090	3	9	1	0	13
OG0001091	5	2	3	3	13
OG0001092	2	10	1	0	13
OG0001093	1	7	3	2	13
OG0001094	1	1	5	6	13
OG0001095	1	5	3	4	13
OG0001096	1	1	10	1	13
OG0001097	1	1	7	4	13
OG0001098	3	3	4	3	13
OG0001099	4	3	4	2	13
OG0001100	3	1	4	5	13
OG0001101	2	10	1	0	13
OG0001102	3	2	5	3	13
OG0001103	1	12	0	0	13
OG0001104	3	2	6	2	13
OG0001105	3	2	6	2	13
OG0001106	4	7	1	1	13
OG0001107	1	1	3	8	13
OG0001108	1	1	6	5	13
OG0001109	2	1	2	8	13
OG0001110	4	2	4	3	13
OG0001111	4	4	2	3	13
OG0001112	2	1	6	4	13
OG0001113	2	2	5	4	13
OG0001114	2	1	4	6	13
OG0001115	5	1	5	2	13
OG0001116	2	10	1	0	13
OG0001117	3	10	0	0	13
OG0001118	3	3	4	3	13
OG0001119	2	1	6	4	13
OG0001120	1	1	7	4	13
OG0001121	1	12	0	0	13
OG0001122	3	3	3	4	13
OG0001123	2	11	0	0	13
OG0001124	1	1	6	5	13
OG0001125	1	12	0	0	13
OG0001126	12	1	0	0	13
OG0001127	7	3	1	2	13
OG0001128	1	0	6	6	13
OG0001129	2	1	4	6	13
OG0001130	1	1	2	9	13
OG0001131	1	1	8	3	13
OG0001132	1	1	6	5	13
OG0001133	5	2	3	3	13
OG0001134	1	1	7	4	13
OG0001135	1	1	2	9	13
OG0001136	3	2	4	4	13
OG0001137	1	1	3	8	13
OG0001138	3	2	3	5	13
OG0001139	2	1	6	4	13
OG0001140	1	12	0	0	13
OG0001141	2	1	6	4	13
OG0001142	1	1	7	4	13
OG0001143	8	5	0	0	13
OG0001144	1	0	5	7	13
OG0001145	2	1	6	4	13
OG0001146	4	3	3	3	13
OG0001147	1	12	0	0	13
OG0001148	1	0	5	7	13
OG0001149	2	1	2	8	13
OG0001150	3	3	4	3	13
OG0001151	1	1	3	8	13
OG0001152	3	8	1	1	13
OG0001153	2	7	2	2	13
OG0001154	4	2	3	4	13
OG0001155	3	10	0	0	13
OG0001156	2	1	6	4	13
OG0001157	4	5	3	1	13
OG0001158	1	12	0	0	13
OG0001159	2	2	6	3	13
OG0001160	1	1	3	8	13
OG0001161	1	12	0	0	13
OG0001162	2	2	6	3	13
OG0001163	1	1	5	6	13
OG0001164	3	8	0	2	13
OG0001165	2	2	4	5	13
OG0001166	4	5	2	2	13
OG0001167	1	11	0	1	13
OG0001168	5	3	3	2	13
OG0001169	1	1	5	6	13
OG0001170	1	1	7	4	13
OG0001171	1	3	2	7	13
OG0001172	0	13	0	0	13
OG0001173	0	13	0	0	13
OG0001174	0	13	0	0	13
OG0001175	0	12	1	0	13
OG0001176	0	13	0	0	13
OG0001177	0	13	0	0	13
OG0001178	0	13	0	0	13
OG0001179	0	13	0	0	13
OG0001180	0	4	9	0	13
OG0001181	0	1	12	0	13
OG0001182	0	0	11	2	13
OG0001183	0	0	12	1	13
OG0001184	0	0	7	6	13
OG0001185	0	0	2	11	13
OG0001186	0	0	13	0	13
OG0001187	0	0	6	7	13
OG0001188	0	0	0	13	13
OG0001189	8	4	0	0	12
OG0001190	3	3	2	4	12
OG0001191	9	1	1	1	12
OG0001192	3	3	3	3	12
OG0001193	8	1	1	2	12
OG0001194	11	1	0	0	12
OG0001195	3	3	3	3	12
OG0001196	8	4	0	0	12
OG0001197	2	4	4	2	12
OG0001198	12	0	0	0	12
OG0001199	8	4	0	0	12
OG0001200	4	2	3	3	12
OG0001201	9	3	0	0	12
OG0001202	4	2	4	2	12
OG0001203	1	11	0	0	12
OG0001204	11	1	0	0	12
OG0001205	3	2	3	4	12
OG0001206	2	10	0	0	12
OG0001207	12	0	0	0	12
OG0001208	1	1	5	5	12
OG0001209	2	6	1	3	12
OG0001210	3	3	3	3	12
OG0001211	3	3	3	3	12
OG0001212	3	2	3	4	12
OG0001213	2	2	4	4	12
OG0001214	1	1	9	1	12
OG0001215	11	1	0	0	12
OG0001216	1	1	4	6	12
OG0001217	1	1	4	6	12
OG0001218	3	3	3	3	12
OG0001219	1	1	3	7	12
OG0001220	6	3	1	2	12
OG0001221	4	1	2	5	12
OG0001222	1	1	5	5	12
OG0001223	5	5	1	1	12
OG0001224	3	3	3	3	12
OG0001225	4	2	3	3	12
OG0001226	2	2	5	3	12
OG0001227	1	1	6	4	12
OG0001228	1	1	4	6	12
OG0001229	5	2	2	3	12
OG0001230	4	3	3	2	12
OG0001231	1	1	6	4	12
OG0001232	8	4	0	0	12
OG0001233	7	2	1	2	12
OG0001234	3	4	3	2	12
OG0001235	2	1	4	5	12
OG0001236	3	3	3	3	12
OG0001237	4	2	4	2	12
OG0001238	2	2	4	4	12
OG0001239	3	3	4	2	12
OG0001240	2	2	3	5	12
OG0001241	2	2	3	5	12
OG0001242	2	1	5	4	12
OG0001243	3	3	3	3	12
OG0001244	1	1	6	4	12
OG0001245	1	1	4	6	12
OG0001246	4	4	3	1	12
OG0001247	2	10	0	0	12
OG0001248	10	2	0	0	12
OG0001249	6	2	3	1	12
OG0001250	10	2	0	0	12
OG0001251	2	2	5	3	12
OG0001252	1	1	6	4	12
OG0001253	2	2	5	3	12
OG0001254	1	1	1	9	12
OG0001255	3	3	3	3	12
OG0001256	3	3	3	3	12
OG0001257	1	4	4	3	12
OG0001258	3	3	2	4	12
OG0001259	4	1	5	2	12
OG0001260	1	1	9	1	12
OG0001261	3	3	3	3	12
OG0001262	4	4	2	2	12
OG0001263	10	2	0	0	12
OG0001264	4	7	0	1	12
OG0001265	11	1	0	0	12
OG0001266	4	2	3	3	12
OG0001267	3	6	1	2	12
OG0001268	1	1	7	3	12
OG0001269	6	3	1	2	12
OG0001270	5	1	5	1	12
OG0001271	6	4	1	1	12
OG0001272	5	2	3	2	12
OG0001273	11	1	0	0	12
OG0001274	3	3	3	3	12
OG0001275	3	2	0	7	12
OG0001276	2	5	1	4	12
OG0001277	3	2	3	4	12
OG0001278	3	8	0	1	12
OG0001279	3	3	3	3	12
OG0001280	1	1	1	9	12
OG0001281	2	2	4	4	12
OG0001282	3	3	3	3	12
OG0001283	2	2	4	4	12
OG0001284	3	1	5	3	12
OG0001285	1	2	3	6	12
OG0001286	4	2	3	3	12
OG0001287	2	3	3	4	12
OG0001288	8	2	0	2	12
OG0001289	4	2	3	3	12
OG0001290	2	1	4	5	12
OG0001291	5	2	3	2	12
OG0001292	4	2	3	3	12
OG0001293	2	1	5	4	12
OG0001294	4	4	2	2	12
OG0001295	5	3	3	1	12
OG0001296	2	6	2	2	12
OG0001297	2	5	4	1	12
OG0001298	3	2	2	5	12
OG0001299	1	9	1	1	12
OG0001300	1	1	8	2	12
OG0001301	2	1	6	3	12
OG0001302	3	3	3	3	12
OG0001303	1	2	5	4	12
OG0001304	4	2	3	3	12
OG0001305	2	10	0	0	12
OG0001306	2	1	2	7	12
OG0001307	3	1	5	3	12
OG0001308	1	1	2	8	12
OG0001309	7	1	2	2	12
OG0001310	1	1	4	6	12
OG0001311	1	8	1	2	12
OG0001312	3	2	2	5	12
OG0001313	5	1	4	2	12
OG0001314	6	2	2	2	12
OG0001315	2	2	1	7	12
OG0001316	1	3	2	6	12
OG0001317	3	2	3	4	12
OG0001318	3	1	3	5	12
OG0001319	1	1	2	8	12
OG0001320	12	0	0	0	12
OG0001321	3	1	3	5	12
OG0001322	2	7	1	2	12
OG0001323	2	5	3	2	12
OG0001324	2	1	4	5	12
OG0001325	2	3	3	4	12
OG0001326	1	1	2	8	12
OG0001327	7	3	0	2	12
OG0001328	2	2	4	4	12
OG0001329	4	3	2	3	12
OG0001330	2	2	7	1	12
OG0001331	3	4	2	3	12
OG0001332	1	1	7	3	12
OG0001333	1	1	7	3	12
OG0001334	1	1	6	4	12
OG0001335	2	2	5	3	12
OG0001336	1	1	5	5	12
OG0001337	1	1	5	5	12
OG0001338	2	1	3	6	12
OG0001339	3	3	2	4	12
OG0001340	1	1	5	5	12
OG0001341	2	1	3	6	12
OG0001342	2	1	6	3	12
OG0001343	1	1	2	8	12
OG0001344	2	1	5	4	12
OG0001345	1	1	10	0	12
OG0001346	2	1	9	0	12
OG0001347	4	2	3	3	12
OG0001348	2	10	0	0	12
OG0001349	1	1	8	2	12
OG0001350	2	1	7	2	12
OG0001351	1	1	3	7	12
OG0001352	3	3	4	2	12
OG0001353	3	3	3	3	12
OG0001354	3	2	3	4	12
OG0001355	2	2	8	0	12
OG0001356	2	1	6	3	12
OG0001357	2	2	4	4	12
OG0001358	1	11	0	0	12
OG0001359	1	1	4	6	12
OG0001360	1	1	4	6	12
OG0001361	2	2	3	5	12
OG0001362	4	1	2	5	12
OG0001363	3	1	4	4	12
OG0001364	1	1	6	4	12
OG0001365	2	3	3	4	12
OG0001366	1	1	3	7	12
OG0001367	1	1	4	6	12
OG0001368	4	2	4	2	12
OG0001369	1	1	6	4	12
OG0001370	1	1	4	6	12
OG0001371	1	1	5	5	12
OG0001372	2	1	5	4	12
OG0001373	2	1	3	6	12
OG0001374	1	0	5	6	12
OG0001375	1	1	5	5	12
OG0001376	1	2	6	3	12
OG0001377	4	2	3	3	12
OG0001378	4	2	3	3	12
OG0001379	3	2	3	4	12
OG0001380	1	5	4	2	12
OG0001381	8	1	0	3	12
OG0001382	7	3	1	1	12
OG0001383	1	1	1	9	12
OG0001384	2	2	4	4	12
OG0001385	1	1	2	8	12
OG0001386	1	1	7	3	12
OG0001387	3	3	4	2	12
OG0001388	1	1	4	6	12
OG0001389	1	1	1	9	12
OG0001390	2	2	5	3	12
OG0001391	2	1	5	4	12
OG0001392	4	2	2	4	12
OG0001393	2	2	5	3	12
OG0001394	1	1	3	7	12
OG0001395	4	6	1	1	12
OG0001396	3	3	3	3	12
OG0001397	2	1	5	4	12
OG0001398	5	3	2	2	12
OG0001399	1	1	3	7	12
OG0001400	3	3	3	3	12
OG0001401	4	4	2	2	12
OG0001402	2	2	3	5	12
OG0001403	1	0	4	7	12
OG0001404	2	2	2	6	12
OG0001405	1	5	1	5	12
OG0001406	2	10	0	0	12
OG0001407	3	4	2	3	12
OG0001408	3	2	3	4	12
OG0001409	2	3	3	4	12
OG0001410	2	2	4	4	12
OG0001411	11	1	0	0	12
OG0001412	1	1	1	9	12
OG0001413	4	5	2	1	12
OG0001414	3	1	4	4	12
OG0001415	2	1	4	5	12
OG0001416	1	1	4	6	12
OG0001417	6	3	1	2	12
OG0001418	1	1	4	6	12
OG0001419	1	1	4	6	12
OG0001420	3	1	4	4	12
OG0001421	1	1	2	8	12
OG0001422	3	5	2	2	12
OG0001423	1	1	2	8	12
OG0001424	3	3	3	3	12
OG0001425	2	1	1	8	12
OG0001426	2	1	5	4	12
OG0001427	3	4	3	2	12
OG0001428	1	1	3	7	12
OG0001429	3	2	4	3	12
OG0001430	1	11	0	0	12
OG0001431	1	1	0	10	12
OG0001432	3	1	4	4	12
OG0001433	1	2	2	7	12
OG0001434	2	1	1	8	12
OG0001435	2	1	2	7	12
OG0001436	2	0	5	5	12
OG0001437	1	2	2	7	12
OG0001438	1	1	6	4	12
OG0001439	4	2	2	4	12
OG0001440	1	11	0	0	12
OG0001441	1	11	0	0	12
OG0001442	1	1	5	5	12
OG0001443	1	11	0	0	12
OG0001444	1	2	3	6	12
OG0001445	2	2	4	4	12
OG0001446	1	11	0	0	12
OG0001447	0	12	0	0	12
OG0001448	0	12	0	0	12
OG0001449	0	12	0	0	12
OG0001450	0	12	0	0	12
OG0001451	0	12	0	0	12
OG0001452	0	12	0	0	12
OG0001453	0	12	0	0	12
OG0001454	0	5	4	3	12
OG0001455	0	12	0	0	12
OG0001456	0	12	0	0	12
OG0001457	0	12	0	0	12
OG0001458	0	1	9	2	12
OG0001459	0	1	0	11	12
OG0001460	0	6	5	1	12
OG0001461	0	11	0	1	12
OG0001462	0	0	9	3	12
OG0001463	0	0	11	1	12
OG0001464	0	0	6	6	12
OG0001465	0	0	6	6	12
OG0001466	0	0	1	11	12
OG0001467	0	0	2	10	12
OG0001468	0	0	0	12	12
OG0001469	0	0	0	12	12
OG0001470	0	0	0	12	12
OG0001471	0	0	0	12	12
OG0001472	7	3	0	1	11
OG0001473	7	2	1	1	11
OG0001474	3	2	3	3	11
OG0001475	8	3	0	0	11
OG0001476	11	0	0	0	11
OG0001477	1	1	3	6	11
OG0001478	9	2	0	0	11
OG0001479	9	2	0	0	11
OG0001480	8	1	1	1	11
OG0001481	6	4	1	0	11
OG0001482	4	3	3	1	11
OG0001483	2	8	0	1	11
OG0001484	2	3	3	3	11
OG0001485	2	1	3	5	11
OG0001486	2	2	3	4	11
OG0001487	11	0	0	0	11
OG0001488	9	2	0	0	11
OG0001489	3	4	3	1	11
OG0001490	2	1	4	4	11
OG0001491	2	5	2	2	11
OG0001492	3	1	3	4	11
OG0001493	3	3	4	1	11
OG0001494	2	0	7	2	11
OG0001495	2	1	4	4	11
OG0001496	6	5	0	0	11
OG0001497	4	1	3	3	11
OG0001498	3	2	3	3	11
OG0001499	3	1	3	4	11
OG0001500	3	3	2	3	11
OG0001501	1	1	2	7	11
OG0001502	2	1	4	4	11
OG0001503	3	3	4	1	11
OG0001504	1	1	2	7	11
OG0001505	2	2	5	2	11
OG0001506	3	1	3	4	11
OG0001507	10	1	0	0	11
OG0001508	2	2	4	3	11
OG0001509	4	2	3	2	11
OG0001510	1	1	2	7	11
OG0001511	3	3	4	1	11
OG0001512	8	3	0	0	11
OG0001513	2	1	3	5	11
OG0001514	1	10	0	0	11
OG0001515	2	1	4	4	11
OG0001516	11	0	0	0	11
OG0001517	11	0	0	0	11
OG0001518	1	10	0	0	11
OG0001519	1	1	2	7	11
OG0001520	7	2	1	1	11
OG0001521	11	0	0	0	11
OG0001522	10	1	0	0	11
OG0001523	4	3	2	2	11
OG0001524	3	0	4	4	11
OG0001525	1	1	4	5	11
OG0001526	4	3	2	2	11
OG0001527	3	1	4	3	11
OG0001528	2	3	1	5	11
OG0001529	2	2	4	3	11
OG0001530	2	1	6	2	11
OG0001531	1	1	2	7	11
OG0001532	2	2	5	2	11
OG0001533	1	1	6	3	11
OG0001534	1	1	2	7	11
OG0001535	1	0	7	3	11
OG0001536	3	2	5	1	11
OG0001537	1	1	1	8	11
OG0001538	2	2	4	3	11
OG0001539	2	1	3	5	11
OG0001540	1	1	3	6	11
OG0001541	3	2	3	3	11
OG0001542	5	2	2	2	11
OG0001543	2	5	1	3	11
OG0001544	5	1	2	3	11
OG0001545	3	3	3	2	11
OG0001546	3	2	4	2	11
OG0001547	4	2	2	3	11
OG0001548	6	5	0	0	11
OG0001549	4	2	2	3	11
OG0001550	8	1	1	1	11
OG0001551	1	10	0	0	11
OG0001552	1	9	0	1	11
OG0001553	3	1	5	2	11
OG0001554	2	2	2	5	11
OG0001555	1	2	4	4	11
OG0001556	3	2	3	3	11
OG0001557	1	3	2	5	11
OG0001558	1	1	6	3	11
OG0001559	4	3	2	2	11
OG0001560	1	1	5	4	11
OG0001561	1	1	4	5	11
OG0001562	3	3	3	2	11
OG0001563	2	2	3	4	11
OG0001564	2	1	3	5	11
OG0001565	2	3	5	1	11
OG0001566	1	2	5	3	11
OG0001567	3	2	4	2	11
OG0001568	10	1	0	0	11
OG0001569	3	1	2	5	11
OG0001570	3	3	3	2	11
OG0001571	3	1	5	2	11
OG0001572	1	10	0	0	11
OG0001573	2	1	4	4	11
OG0001574	9	2	0	0	11
OG0001575	11	0	0	0	11
OG0001576	11	0	0	0	11
OG0001577	5	4	1	1	11
OG0001578	2	2	5	2	11
OG0001579	3	1	4	3	11
OG0001580	5	4	0	2	11
OG0001581	4	5	1	1	11
OG0001582	1	1	4	5	11
OG0001583	2	2	5	2	11
OG0001584	2	3	4	2	11
OG0001585	3	2	2	4	11
OG0001586	1	1	6	3	11
OG0001587	1	6	3	1	11
OG0001588	3	2	3	3	11
OG0001589	4	5	1	1	11
OG0001590	1	1	4	5	11
OG0001591	3	2	4	2	11
OG0001592	2	1	4	4	11
OG0001593	1	1	5	4	11
OG0001594	3	3	3	2	11
OG0001595	2	3	3	3	11
OG0001596	3	2	3	3	11
OG0001597	1	1	1	8	11
OG0001598	5	2	2	2	11
OG0001599	1	1	8	1	11
OG0001600	1	1	5	4	11
OG0001601	1	1	3	6	11
OG0001602	2	3	3	3	11
OG0001603	4	3	2	2	11
OG0001604	7	3	0	1	11
OG0001605	2	1	4	4	11
OG0001606	2	2	5	2	11
OG0001607	2	6	1	2	11
OG0001608	1	10	0	0	11
OG0001609	2	9	0	0	11
OG0001610	3	1	4	3	11
OG0001611	3	3	2	3	11
OG0001612	7	2	1	1	11
OG0001613	1	1	5	4	11
OG0001614	2	1	4	4	11
OG0001615	3	2	4	2	11
OG0001616	5	1	2	3	11
OG0001617	2	1	4	4	11
OG0001618	2	2	3	4	11
OG0001619	4	7	0	0	11
OG0001620	2	3	3	3	11
OG0001621	1	9	1	0	11
OG0001622	4	3	1	3	11
OG0001623	3	3	2	3	11
OG0001624	4	2	2	3	11
OG0001625	3	2	2	4	11
OG0001626	2	2	4	3	11
OG0001627	1	1	5	4	11
OG0001628	1	1	4	5	11
OG0001629	2	0	4	5	11
OG0001630	3	4	2	2	11
OG0001631	3	3	3	2	11
OG0001632	2	1	6	2	11
OG0001633	2	1	3	5	11
OG0001634	2	1	3	5	11
OG0001635	2	0	5	4	11
OG0001636	1	1	0	9	11
OG0001637	1	0	6	4	11
OG0001638	2	2	1	6	11
OG0001639	2	2	4	3	11
OG0001640	1	9	1	0	11
OG0001641	2	1	4	4	11
OG0001642	3	2	4	2	11
OG0001643	3	1	4	3	11
OG0001644	2	2	6	1	11
OG0001645	2	1	6	2	11
OG0001646	2	1	5	3	11
OG0001647	1	1	4	5	11
OG0001648	6	4	1	0	11
OG0001649	2	1	4	4	11
OG0001650	1	1	4	5	11
OG0001651	2	2	4	3	11
OG0001652	1	1	2	7	11
OG0001653	1	1	6	3	11
OG0001654	2	1	4	4	11
OG0001655	1	1	5	4	11
OG0001656	3	7	1	0	11
OG0001657	1	1	3	6	11
OG0001658	1	1	4	5	11
OG0001659	1	2	5	3	11
OG0001660	2	1	5	3	11
OG0001661	1	1	4	5	11
OG0001662	1	1	3	6	11
OG0001663	1	1	4	5	11
OG0001664	3	3	3	2	11
OG0001665	2	1	4	4	11
OG0001666	3	1	2	5	11
OG0001667	2	1	3	5	11
OG0001668	2	1	3	5	11
OG0001669	2	2	4	3	11
OG0001670	2	2	3	4	11
OG0001671	1	1	6	3	11
OG0001672	1	1	5	4	11
OG0001673	1	1	3	6	11
OG0001674	2	2	4	3	11
OG0001675	3	1	1	6	11
OG0001676	2	2	5	2	11
OG0001677	1	1	3	6	11
OG0001678	1	1	7	2	11
OG0001679	1	1	3	6	11
OG0001680	2	1	2	6	11
OG0001681	3	1	4	3	11
OG0001682	1	0	1	9	11
OG0001683	1	1	2	7	11
OG0001684	1	1	7	2	11
OG0001685	2	3	3	3	11
OG0001686	2	1	2	6	11
OG0001687	3	3	3	2	11
OG0001688	1	1	3	6	11
OG0001689	2	1	7	1	11
OG0001690	4	4	2	1	11
OG0001691	1	2	1	7	11
OG0001692	1	1	4	5	11
OG0001693	2	2	4	3	11
OG0001694	2	1	6	2	11
OG0001695	3	1	2	5	11
OG0001696	1	10	0	0	11
OG0001697	2	2	3	4	11
OG0001698	1	1	5	4	11
OG0001699	1	1	2	7	11
OG0001700	5	2	2	2	11
OG0001701	1	0	2	8	11
OG0001702	1	1	3	6	11
OG0001703	1	1	6	3	11
OG0001704	1	1	6	3	11
OG0001705	3	3	4	1	11
OG0001706	2	2	3	4	11
OG0001707	2	1	5	3	11
OG0001708	2	1	3	5	11
OG0001709	3	3	3	2	11
OG0001710	1	1	4	5	11
OG0001711	1	0	8	2	11
OG0001712	2	1	4	4	11
OG0001713	1	1	6	3	11
OG0001714	1	1	4	5	11
OG0001715	3	3	3	2	11
OG0001716	2	1	3	5	11
OG0001717	4	2	3	2	11
OG0001718	4	2	3	2	11
OG0001719	1	1	2	7	11
OG0001720	3	1	2	5	11
OG0001721	3	0	1	7	11
OG0001722	1	1	5	4	11
OG0001723	1	1	5	4	11
OG0001724	7	0	2	2	11
OG0001725	2	2	4	3	11
OG0001726	1	0	6	4	11
OG0001727	2	2	4	3	11
OG0001728	3	4	2	2	11
OG0001729	1	8	0	2	11
OG0001730	1	2	7	1	11
OG0001731	4	3	3	1	11
OG0001732	2	1	5	3	11
OG0001733	5	1	2	3	11
OG0001734	2	0	5	4	11
OG0001735	2	1	5	3	11
OG0001736	3	1	3	4	11
OG0001737	1	1	4	5	11
OG0001738	3	3	3	2	11
OG0001739	3	1	4	3	11
OG0001740	2	1	4	4	11
OG0001741	2	1	3	5	11
OG0001742	1	1	3	6	11
OG0001743	6	3	1	1	11
OG0001744	3	1	3	4	11
OG0001745	3	1	3	4	11
OG0001746	2	9	0	0	11
OG0001747	1	1	4	5	11
OG0001748	2	1	5	3	11
OG0001749	1	1	5	4	11
OG0001750	2	3	2	4	11
OG0001751	3	2	2	4	11
OG0001752	2	1	4	4	11
OG0001753	2	1	4	4	11
OG0001754	1	1	4	5	11
OG0001755	1	2	1	7	11
OG0001756	2	9	0	0	11
OG0001757	1	1	4	5	11
OG0001758	3	1	3	4	11
OG0001759	1	1	5	4	11
OG0001760	5	3	2	1	11
OG0001761	1	1	6	3	11
OG0001762	1	1	4	5	11
OG0001763	1	2	3	5	11
OG0001764	3	1	4	3	11
OG0001765	1	1	5	4	11
OG0001766	1	1	4	5	11
OG0001767	4	3	3	1	11
OG0001768	2	2	3	4	11
OG0001769	4	3	1	3	11
OG0001770	1	1	6	3	11
OG0001771	1	1	4	5	11
OG0001772	1	1	8	1	11
OG0001773	1	10	0	0	11
OG0001774	0	11	0	0	11
OG0001775	0	11	0	0	11
OG0001776	0	11	0	0	11
OG0001777	0	11	0	0	11
OG0001778	0	11	0	0	11
OG0001779	0	2	8	1	11
OG0001780	0	11	0	0	11
OG0001781	0	10	1	0	11
OG0001782	0	1	8	2	11
OG0001783	0	11	0	0	11
OG0001784	0	11	0	0	11
OG0001785	0	9	1	1	11
OG0001786	0	2	6	3	11
OG0001787	0	7	2	2	11
OG0001788	0	6	5	0	11
OG0001789	0	5	2	4	11
OG0001790	0	10	0	1	11
OG0001791	0	1	5	5	11
OG0001792	0	6	3	2	11
OG0001793	0	1	4	6	11
OG0001794	0	11	0	0	11
OG0001795	0	2	6	3	11
OG0001796	0	2	6	3	11
OG0001797	0	0	8	3	11
OG0001798	0	0	1	10	11
OG0001799	0	0	7	4	11
OG0001800	0	0	1	10	11
OG0001801	0	0	1	10	11
OG0001802	0	0	7	4	11
OG0001803	0	0	2	9	11
OG0001804	0	0	11	0	11
OG0001805	0	0	1	10	11
OG0001806	0	0	8	3	11
OG0001807	0	0	1	10	11
OG0001808	0	0	0	11	11
OG0001809	0	0	0	11	11
OG0001810	2	1	3	4	10
OG0001811	1	9	0	0	10
OG0001812	9	1	0	0	10
OG0001813	4	6	0	0	10
OG0001814	9	1	0	0	10
OG0001815	1	1	3	5	10
OG0001816	7	3	0	0	10
OG0001817	5	2	1	2	10
OG0001818	3	1	4	2	10
OG0001819	1	1	5	3	10
OG0001820	6	2	1	1	10
OG0001821	9	1	0	0	10
OG0001822	6	4	0	0	10
OG0001823	3	2	4	1	10
OG0001824	4	2	0	4	10
OG0001825	2	2	3	3	10
OG0001826	2	4	2	2	10
OG0001827	1	1	3	5	10
OG0001828	5	1	2	2	10
OG0001829	2	2	2	4	10
OG0001830	5	5	0	0	10
OG0001831	1	1	6	2	10
OG0001832	1	1	4	4	10
OG0001833	4	2	3	1	10
OG0001834	3	2	2	3	10
OG0001835	2	1	2	5	10
OG0001836	1	0	4	5	10
OG0001837	3	2	3	2	10
OG0001838	2	3	2	3	10
OG0001839	1	1	4	4	10
OG0001840	2	2	3	3	10
OG0001841	4	1	4	1	10
OG0001842	1	1	3	5	10
OG0001843	2	1	2	5	10
OG0001844	2	2	4	2	10
OG0001845	1	1	5	3	10
OG0001846	4	1	3	2	10
OG0001847	1	1	4	4	10
OG0001848	2	1	3	4	10
OG0001849	1	1	4	4	10
OG0001850	1	1	3	5	10
OG0001851	3	1	4	2	10
OG0001852	2	1	6	1	10
OG0001853	1	1	3	5	10
OG0001854	3	3	2	2	10
OG0001855	4	2	2	2	10
OG0001856	2	1	4	3	10
OG0001857	1	1	3	5	10
OG0001858	4	2	2	2	10
OG0001859	2	0	6	2	10
OG0001860	1	1	3	5	10
OG0001861	1	9	0	0	10
OG0001862	1	1	7	1	10
OG0001863	3	3	2	2	10
OG0001864	3	1	2	4	10
OG0001865	5	1	1	3	10
OG0001866	3	5	1	1	10
OG0001867	1	1	3	5	10
OG0001868	6	4	0	0	10
OG0001869	2	8	0	0	10
OG0001870	2	1	4	3	10
OG0001871	3	2	3	2	10
OG0001872	9	1	0	0	10
OG0001873	9	1	0	0	10
OG0001874	2	2	3	3	10
OG0001875	1	2	2	5	10
OG0001876	1	1	4	4	10
OG0001877	1	0	5	4	10
OG0001878	1	1	4	4	10
OG0001879	2	1	4	3	10
OG0001880	3	2	3	2	10
OG0001881	1	1	4	4	10
OG0001882	3	2	2	3	10
OG0001883	2	3	3	2	10
OG0001884	2	3	1	4	10
OG0001885	1	9	0	0	10
OG0001886	2	2	4	2	10
OG0001887	5	5	0	0	10
OG0001888	1	1	3	5	10
OG0001889	3	1	3	3	10
OG0001890	2	2	4	2	10
OG0001891	2	2	3	3	10
OG0001892	2	4	1	3	10
OG0001893	1	1	3	5	10
OG0001894	1	1	3	5	10
OG0001895	1	1	4	4	10
OG0001896	2	2	4	2	10
OG0001897	1	1	3	5	10
OG0001898	1	1	4	4	10
OG0001899	1	1	6	2	10
OG0001900	3	1	3	3	10
OG0001901	2	4	2	2	10
OG0001902	2	2	5	1	10
OG0001903	10	0	0	0	10
OG0001904	2	2	2	4	10
OG0001905	5	5	0	0	10
OG0001906	2	1	4	3	10
OG0001907	1	1	5	3	10
OG0001908	10	0	0	0	10
OG0001909	1	1	1	7	10
OG0001910	2	1	4	3	10
OG0001911	2	1	2	5	10
OG0001912	3	3	2	2	10
OG0001913	3	2	3	2	10
OG0001914	3	1	3	3	10
OG0001915	3	2	3	2	10
OG0001916	1	1	7	1	10
OG0001917	4	3	2	1	10
OG0001918	1	1	1	7	10
OG0001919	3	1	2	4	10
OG0001920	4	3	1	2	10
OG0001921	1	1	5	3	10
OG0001922	1	1	3	5	10
OG0001923	3	1	3	3	10
OG0001924	4	2	2	2	10
OG0001925	5	3	1	1	10
OG0001926	4	5	1	0	10
OG0001927	2	2	3	3	10
OG0001928	3	2	3	2	10
OG0001929	1	1	5	3	10
OG0001930	3	2	2	3	10
OG0001931	2	2	3	3	10
OG0001932	1	4	3	2	10
OG0001933	2	1	4	3	10
OG0001934	4	2	2	2	10
OG0001935	6	3	1	0	10
OG0001936	8	2	0	0	10
OG0001937	6	4	0	0	10
OG0001938	2	2	0	6	10
OG0001939	10	0	0	0	10
OG0001940	2	2	3	3	10
OG0001941	6	2	1	1	10
OG0001942	1	1	4	4	10
OG0001943	7	3	0	0	10
OG0001944	1	9	0	0	10
OG0001945	1	9	0	0	10
OG0001946	1	1	4	4	10
OG0001947	1	1	4	4	10
OG0001948	7	1	1	1	10
OG0001949	3	1	4	2	10
OG0001950	2	1	2	5	10
OG0001951	1	1	5	3	10
OG0001952	4	5	0	1	10
OG0001953	4	3	2	1	10
OG0001954	2	3	1	4	10
OG0001955	1	9	0	0	10
OG0001956	2	1	4	3	10
OG0001957	3	1	2	4	10
OG0001958	3	2	2	3	10
OG0001959	4	1	3	2	10
OG0001960	3	3	2	2	10
OG0001961	2	2	3	3	10
OG0001962	1	1	4	4	10
OG0001963	5	3	1	1	10
OG0001964	3	2	3	2	10
OG0001965	1	2	3	4	10
OG0001966	4	2	2	2	10
OG0001967	1	1	4	4	10
OG0001968	2	4	2	2	10
OG0001969	1	1	6	2	10
OG0001970	5	1	2	2	10
OG0001971	3	1	3	3	10
OG0001972	2	2	3	3	10
OG0001973	2	1	2	5	10
OG0001974	5	1	2	2	10
OG0001975	2	0	6	2	10
OG0001976	2	2	4	2	10
OG0001977	2	1	3	4	10
OG0001978	2	2	3	3	10
OG0001979	1	1	4	4	10
OG0001980	1	1	3	5	10
OG0001981	2	2	3	3	10
OG0001982	1	0	5	4	10
OG0001983	1	9	0	0	10
OG0001984	3	1	2	4	10
OG0001985	1	2	4	3	10
OG0001986	4	0	2	4	10
OG0001987	4	6	0	0	10
OG0001988	3	1	3	3	10
OG0001989	1	1	2	6	10
OG0001990	7	3	0	0	10
OG0001991	2	6	0	2	10
OG0001992	4	2	2	2	10
OG0001993	2	3	2	3	10
OG0001994	6	4	0	0	10
OG0001995	2	1	4	3	10
OG0001996	2	2	3	3	10
OG0001997	4	1	2	3	10
OG0001998	1	0	6	3	10
OG0001999	4	3	1	2	10
OG0002000	5	3	1	1	10
OG0002001	1	1	4	4	10
OG0002002	2	0	6	2	10
OG0002003	2	2	3	3	10
OG0002004	4	1	2	3	10
OG0002005	3	1	4	2	10
OG0002006	2	1	1	6	10
OG0002007	5	3	1	1	10
OG0002008	2	2	2	4	10
OG0002009	8	0	1	1	10
OG0002010	2	4	2	2	10
OG0002011	2	1	6	1	10
OG0002012	4	3	1	2	10
OG0002013	9	1	0	0	10
OG0002014	3	4	2	1	10
OG0002015	1	1	4	4	10
OG0002016	4	2	2	2	10
OG0002017	7	1	1	1	10
OG0002018	1	1	4	4	10
OG0002019	2	1	2	5	10
OG0002020	2	3	3	2	10
OG0002021	10	0	0	0	10
OG0002022	1	9	0	0	10
OG0002023	3	2	2	3	10
OG0002024	1	1	4	4	10
OG0002025	2	2	3	3	10
OG0002026	2	2	3	3	10
OG0002027	2	2	3	3	10
OG0002028	2	2	3	3	10
OG0002029	3	2	2	3	10
OG0002030	1	2	2	5	10
OG0002031	2	3	1	4	10
OG0002032	1	1	4	4	10
OG0002033	1	1	2	6	10
OG0002034	3	3	2	2	10
OG0002035	2	1	1	6	10
OG0002036	1	1	3	5	10
OG0002037	3	3	2	2	10
OG0002038	1	1	3	5	10
OG0002039	2	2	4	2	10
OG0002040	2	1	2	5	10
OG0002041	1	1	1	7	10
OG0002042	1	1	2	6	10
OG0002043	1	1	6	2	10
OG0002044	2	1	3	4	10
OG0002045	1	1	2	6	10
OG0002046	4	1	2	3	10
OG0002047	1	1	5	3	10
OG0002048	3	2	2	3	10
OG0002049	6	2	1	1	10
OG0002050	2	2	4	2	10
OG0002051	2	1	6	1	10
OG0002052	1	1	6	2	10
OG0002053	8	2	0	0	10
OG0002054	2	3	2	3	10
OG0002055	2	0	7	1	10
OG0002056	1	1	5	3	10
OG0002057	1	1	3	5	10
OG0002058	6	2	1	1	10
OG0002059	1	1	5	3	10
OG0002060	1	1	4	4	10
OG0002061	2	2	3	3	10
OG0002062	4	1	3	2	10
OG0002063	1	1	2	6	10
OG0002064	3	5	1	1	10
OG0002065	2	2	3	3	10
OG0002066	2	2	3	3	10
OG0002067	2	2	4	2	10
OG0002068	2	2	3	3	10
OG0002069	3	2	2	3	10
OG0002070	1	1	2	6	10
OG0002071	2	2	2	4	10
OG0002072	4	1	2	3	10
OG0002073	1	1	4	4	10
OG0002074	1	1	6	2	10
OG0002075	2	1	4	3	10
OG0002076	2	2	3	3	10
OG0002077	1	1	4	4	10
OG0002078	3	2	1	4	10
OG0002079	1	1	4	4	10
OG0002080	2	1	3	4	10
OG0002081	2	1	2	5	10
OG0002082	4	1	3	2	10
OG0002083	5	3	1	1	10
OG0002084	2	2	3	3	10
OG0002085	1	1	4	4	10
OG0002086	1	1	4	4	10
OG0002087	3	2	2	3	10
OG0002088	1	1	5	3	10
OG0002089	2	3	2	3	10
OG0002090	1	0	3	6	10
OG0002091	2	1	2	5	10
OG0002092	1	1	4	4	10
OG0002093	1	1	4	4	10
OG0002094	1	1	4	4	10
OG0002095	1	1	3	5	10
OG0002096	2	1	2	5	10
OG0002097	1	1	3	5	10
OG0002098	1	1	4	4	10
OG0002099	2	8	0	0	10
OG0002100	2	1	2	5	10
OG0002101	1	1	4	4	10
OG0002102	1	1	5	3	10
OG0002103	1	1	1	7	10
OG0002104	1	1	4	4	10
OG0002105	2	2	4	2	10
OG0002106	2	3	2	3	10
OG0002107	3	3	2	2	10
OG0002108	1	1	4	4	10
OG0002109	1	1	5	3	10
OG0002110	2	1	4	3	10
OG0002111	1	1	4	4	10
OG0002112	1	1	4	4	10
OG0002113	2	1	3	4	10
OG0002114	1	1	5	3	10
OG0002115	3	3	2	2	10
OG0002116	1	1	4	4	10
OG0002117	3	5	1	1	10
OG0002118	1	1	4	4	10
OG0002119	1	1	3	5	10
OG0002120	1	1	4	4	10
OG0002121	2	1	6	1	10
OG0002122	1	1	4	4	10
OG0002123	1	1	4	4	10
OG0002124	2	2	3	3	10
OG0002125	3	2	3	2	10
OG0002126	2	0	4	4	10
OG0002127	2	2	3	3	10
OG0002128	3	3	2	2	10
OG0002129	2	2	3	3	10
OG0002130	2	1	3	4	10
OG0002131	2	3	3	2	10
OG0002132	2	1	2	5	10
OG0002133	2	2	2	4	10
OG0002134	1	1	4	4	10
OG0002135	4	2	2	2	10
OG0002136	1	2	5	2	10
OG0002137	1	1	4	4	10
OG0002138	2	1	3	4	10
OG0002139	1	0	4	5	10
OG0002140	3	7	0	0	10
OG0002141	5	2	1	2	10
OG0002142	1	1	5	3	10
OG0002143	2	1	2	5	10
OG0002144	3	3	3	1	10
OG0002145	1	1	4	4	10
OG0002146	3	2	2	3	10
OG0002147	1	1	1	7	10
OG0002148	1	1	5	3	10
OG0002149	2	1	5	2	10
OG0002150	2	1	3	4	10
OG0002151	1	1	4	4	10
OG0002152	1	1	3	5	10
OG0002153	1	1	2	6	10
OG0002154	4	1	2	3	10
OG0002155	1	1	4	4	10
OG0002156	2	1	2	5	10
OG0002157	1	2	1	6	10
OG0002158	2	1	3	4	10
OG0002159	1	1	5	3	10
OG0002160	1	1	4	4	10
OG0002161	1	4	2	3	10
OG0002162	1	1	5	3	10
OG0002163	2	2	4	2	10
OG0002164	3	3	3	1	10
OG0002165	2	1	6	1	10
OG0002166	2	1	1	6	10
OG0002167	2	1	4	3	10
OG0002168	4	1	1	4	10
OG0002169	4	2	2	2	10
OG0002170	2	8	0	0	10
OG0002171	1	2	1	6	10
OG0002172	4	4	1	1	10
OG0002173	2	2	2	4	10
OG0002174	1	3	3	3	10
OG0002175	1	1	1	7	10
OG0002176	2	2	2	4	10
OG0002177	3	2	2	3	10
OG0002178	3	1	3	3	10
OG0002179	2	1	1	6	10
OG0002180	1	1	4	4	10
OG0002181	4	1	2	3	10
OG0002182	2	1	5	2	10
OG0002183	1	1	6	2	10
OG0002184	1	1	7	1	10
OG0002185	4	1	1	4	10
OG0002186	2	1	5	2	10
OG0002187	2	3	2	3	10
OG0002188	6	2	1	1	10
OG0002189	2	2	3	3	10
OG0002190	2	6	1	1	10
OG0002191	1	1	3	5	10
OG0002192	3	1	4	2	10
OG0002193	2	1	6	1	10
OG0002194	1	1	5	3	10
OG0002195	1	1	4	4	10
OG0002196	6	0	2	2	10
OG0002197	2	0	6	2	10
OG0002198	2	2	4	2	10
OG0002199	10	0	0	0	10
OG0002200	1	3	2	4	10
OG0002201	4	1	3	2	10
OG0002202	3	1	3	3	10
OG0002203	2	1	4	3	10
OG0002204	1	1	6	2	10
OG0002205	1	1	7	1	10
OG0002206	1	1	2	6	10
OG0002207	1	1	5	3	10
OG0002208	1	1	5	3	10
OG0002209	3	1	5	1	10
OG0002210	2	2	3	3	10
OG0002211	1	1	2	6	10
OG0002212	1	0	1	8	10
OG0002213	1	1	4	4	10
OG0002214	5	1	2	2	10
OG0002215	1	1	4	4	10
OG0002216	2	1	3	4	10
OG0002217	2	2	3	3	10
OG0002218	1	1	2	6	10
OG0002219	1	1	5	3	10
OG0002220	4	3	1	2	10
OG0002221	1	7	1	1	10
OG0002222	1	1	3	5	10
OG0002223	2	0	3	5	10
OG0002224	1	1	4	4	10
OG0002225	1	1	5	3	10
OG0002226	2	1	2	5	10
OG0002227	9	1	0	0	10
OG0002228	5	1	3	1	10
OG0002229	3	1	3	3	10
OG0002230	1	4	3	2	10
OG0002231	3	5	1	1	10
OG0002232	1	1	4	4	10
OG0002233	2	1	4	3	10
OG0002234	1	0	4	5	10
OG0002235	1	1	4	4	10
OG0002236	10	0	0	0	10
OG0002237	10	0	0	0	10
OG0002238	5	1	3	1	10
OG0002239	2	1	3	4	10
OG0002240	2	1	3	4	10
OG0002241	0	10	0	0	10
OG0002242	0	10	0	0	10
OG0002243	0	10	0	0	10
OG0002244	0	10	0	0	10
OG0002245	0	6	1	3	10
OG0002246	0	10	0	0	10
OG0002247	0	10	0	0	10
OG0002248	0	10	0	0	10
OG0002249	0	10	0	0	10
OG0002250	0	10	0	0	10
OG0002251	0	10	0	0	10
OG0002252	0	1	5	4	10
OG0002253	0	1	3	6	10
OG0002254	0	10	0	0	10
OG0002255	0	4	3	3	10
OG0002256	0	1	6	3	10
OG0002257	0	10	0	0	10
OG0002258	0	10	0	0	10
OG0002259	0	10	0	0	10
OG0002260	0	10	0	0	10
OG0002261	0	6	2	2	10
OG0002262	0	5	2	3	10
OG0002263	0	10	0	0	10
OG0002264	0	10	0	0	10
OG0002265	0	10	0	0	10
OG0002266	0	10	0	0	10
OG0002267	0	1	4	5	10
OG0002268	0	10	0	0	10
OG0002269	0	10	0	0	10
OG0002270	0	10	0	0	10
OG0002271	0	2	0	8	10
OG0002272	0	10	0	0	10
OG0002273	0	10	0	0	10
OG0002274	0	10	0	0	10
OG0002275	0	8	1	1	10
OG0002276	0	1	9	0	10
OG0002277	0	10	0	0	10
OG0002278	0	9	0	1	10
OG0002279	0	1	3	6	10
OG0002280	0	6	2	2	10
OG0002281	0	9	0	1	10
OG0002282	0	1	6	3	10
OG0002283	0	1	4	5	10
OG0002284	0	2	5	3	10
OG0002285	0	0	8	2	10
OG0002286	0	0	10	0	10
OG0002287	0	0	3	7	10
OG0002288	0	0	8	2	10
OG0002289	0	0	9	1	10
OG0002290	0	0	7	3	10
OG0002291	0	0	2	8	10
OG0002292	0	0	1	9	10
OG0002293	0	0	5	5	10
OG0002294	0	0	1	9	10
OG0002295	0	0	2	8	10
OG0002296	0	0	2	8	10
OG0002297	0	0	10	0	10
OG0002298	0	0	10	0	10
OG0002299	0	0	2	8	10
OG0002300	0	0	2	8	10
OG0002301	0	0	7	3	10
OG0002302	0	0	0	10	10
OG0002303	0	0	0	10	10
OG0002304	1	1	3	4	9
OG0002305	7	2	0	0	9
OG0002306	8	1	0	0	9
OG0002307	5	2	1	1	9
OG0002308	1	2	3	3	9
OG0002309	2	1	4	2	9
OG0002310	1	1	4	3	9
OG0002311	2	2	2	3	9
OG0002312	1	1	6	1	9
OG0002313	1	1	3	4	9
OG0002314	9	0	0	0	9
OG0002315	1	0	4	4	9
OG0002316	6	3	0	0	9
OG0002317	1	1	1	6	9
OG0002318	5	2	1	1	9
OG0002319	1	1	1	6	9
OG0002320	3	2	2	2	9
OG0002321	2	2	3	2	9
OG0002322	9	0	0	0	9
OG0002323	2	3	2	2	9
OG0002324	8	1	0	0	9
OG0002325	2	2	3	2	9
OG0002326	5	2	1	1	9
OG0002327	1	8	0	0	9
OG0002328	6	1	1	1	9
OG0002329	3	1	3	2	9
OG0002330	4	3	1	1	9
OG0002331	8	0	0	1	9
OG0002332	2	1	3	3	9
OG0002333	3	3	2	1	9
OG0002334	2	1	2	4	9
OG0002335	2	1	4	2	9
OG0002336	1	1	4	3	9
OG0002337	2	1	4	2	9
OG0002338	5	2	1	1	9
OG0002339	9	0	0	0	9
OG0002340	5	3	0	1	9
OG0002341	1	1	6	1	9
OG0002342	1	1	3	4	9
OG0002343	2	1	3	3	9
OG0002344	3	2	2	2	9
OG0002345	1	6	1	1	9
OG0002346	1	1	2	5	9
OG0002347	9	0	0	0	9
OG0002348	4	3	1	1	9
OG0002349	1	1	1	6	9
OG0002350	2	1	3	3	9
OG0002351	1	5	1	2	9
OG0002352	4	2	1	2	9
OG0002353	1	3	3	2	9
OG0002354	1	1	4	3	9
OG0002355	1	0	4	4	9
OG0002356	2	1	3	3	9
OG0002357	2	1	2	4	9
OG0002358	1	1	5	2	9
OG0002359	1	1	4	3	9
OG0002360	3	2	2	2	9
OG0002361	1	0	3	5	9
OG0002362	1	1	4	3	9
OG0002363	1	1	5	2	9
OG0002364	2	1	4	2	9
OG0002365	2	2	2	3	9
OG0002366	2	2	3	2	9
OG0002367	2	1	4	2	9
OG0002368	3	2	2	2	9
OG0002369	1	1	6	1	9
OG0002370	4	3	1	1	9
OG0002371	4	3	1	1	9
OG0002372	1	0	4	4	9
OG0002373	2	1	4	2	9
OG0002374	2	2	4	1	9
OG0002375	1	1	4	3	9
OG0002376	1	1	5	2	9
OG0002377	3	1	4	1	9
OG0002378	4	4	0	1	9
OG0002379	7	1	1	0	9
OG0002380	5	3	0	1	9
OG0002381	2	1	3	3	9
OG0002382	2	2	3	2	9
OG0002383	9	0	0	0	9
OG0002384	1	0	5	3	9
OG0002385	1	1	3	4	9
OG0002386	3	1	2	3	9
OG0002387	6	3	0	0	9
OG0002388	1	1	6	1	9
OG0002389	2	1	3	3	9
OG0002390	3	6	0	0	9
OG0002391	2	7	0	0	9
OG0002392	4	2	1	2	9
OG0002393	1	1	4	3	9
OG0002394	2	1	2	4	9
OG0002395	6	2	1	0	9
OG0002396	4	4	0	1	9
OG0002397	3	1	2	3	9
OG0002398	2	7	0	0	9
OG0002399	1	1	3	4	9
OG0002400	8	1	0	0	9
OG0002401	9	0	0	0	9
OG0002402	1	1	1	6	9
OG0002403	7	2	0	0	9
OG0002404	9	0	0	0	9
OG0002405	4	4	1	0	9
OG0002406	5	1	1	2	9
OG0002407	1	1	3	4	9
OG0002408	7	2	0	0	9
OG0002409	1	5	0	3	9
OG0002410	3	2	1	3	9
OG0002411	7	2	0	0	9
OG0002412	6	3	0	0	9
OG0002413	3	3	1	2	9
OG0002414	1	1	4	3	9
OG0002415	2	2	1	4	9
OG0002416	1	1	3	4	9
OG0002417	1	1	5	2	9
OG0002418	1	2	2	4	9
OG0002419	1	1	4	3	9
OG0002420	8	1	0	0	9
OG0002421	1	1	3	4	9
OG0002422	1	1	3	4	9
OG0002423	1	1	2	5	9
OG0002424	2	1	2	4	9
OG0002425	1	0	5	3	9
OG0002426	1	1	5	2	9
OG0002427	3	1	3	2	9
OG0002428	2	2	3	2	9
OG0002429	1	1	5	2	9
OG0002430	3	1	1	4	9
OG0002431	2	2	2	3	9
OG0002432	1	1	2	5	9
OG0002433	2	2	2	3	9
OG0002434	3	1	2	3	9
OG0002435	1	1	3	4	9
OG0002436	1	1	5	2	9
OG0002437	3	2	2	2	9
OG0002438	1	1	3	4	9
OG0002439	1	1	3	4	9
OG0002440	1	1	2	5	9
OG0002441	2	2	2	3	9
OG0002442	1	1	4	3	9
OG0002443	1	1	3	4	9
OG0002444	4	3	1	1	9
OG0002445	3	2	2	2	9
OG0002446	3	1	4	1	9
OG0002447	1	1	3	4	9
OG0002448	3	2	2	2	9
OG0002449	2	2	2	3	9
OG0002450	4	2	1	2	9
OG0002451	3	1	2	3	9
OG0002452	1	1	3	4	9
OG0002453	1	1	2	5	9
OG0002454	1	1	5	2	9
OG0002455	2	1	2	4	9
OG0002456	3	3	2	1	9
OG0002457	8	1	0	0	9
OG0002458	2	1	2	4	9
OG0002459	2	1	5	1	9
OG0002460	2	2	1	4	9
OG0002461	2	1	2	4	9
OG0002462	1	1	3	4	9
OG0002463	1	1	2	5	9
OG0002464	3	3	1	2	9
OG0002465	1	1	5	2	9
OG0002466	3	1	2	3	9
OG0002467	3	1	2	3	9
OG0002468	1	1	1	6	9
OG0002469	1	8	0	0	9
OG0002470	3	1	1	4	9
OG0002471	3	1	2	3	9
OG0002472	5	2	1	1	9
OG0002473	4	5	0	0	9
OG0002474	2	3	2	2	9
OG0002475	6	3	0	0	9
OG0002476	2	7	0	0	9
OG0002477	7	2	0	0	9
OG0002478	2	2	2	3	9
OG0002479	2	1	2	4	9
OG0002480	3	2	2	2	9
OG0002481	1	1	3	4	9
OG0002482	2	1	2	4	9
OG0002483	1	1	4	3	9
OG0002484	1	1	3	4	9
OG0002485	3	4	1	1	9
OG0002486	1	1	3	4	9
OG0002487	1	1	3	4	9
OG0002488	2	1	1	5	9
OG0002489	3	2	2	2	9
OG0002490	3	3	2	1	9
OG0002491	2	1	3	3	9
OG0002492	1	1	2	5	9
OG0002493	2	2	3	2	9
OG0002494	4	1	1	3	9
OG0002495	1	1	5	2	9
OG0002496	6	1	1	1	9
OG0002497	1	2	4	2	9
OG0002498	1	1	3	4	9
OG0002499	1	5	2	1	9
OG0002500	9	0	0	0	9
OG0002501	2	2	2	3	9
OG0002502	1	1	2	5	9
OG0002503	4	3	1	1	9
OG0002504	1	1	2	5	9
OG0002505	1	1	2	5	9
OG0002506	7	0	2	0	9
OG0002507	1	4	1	3	9
OG0002508	2	2	3	2	9
OG0002509	4	3	1	1	9
OG0002510	2	1	4	2	9
OG0002511	5	2	2	0	9
OG0002512	3	2	2	2	9
OG0002513	2	1	2	4	9
OG0002514	2	2	2	3	9
OG0002515	3	3	1	2	9
OG0002516	2	3	3	1	9
OG0002517	1	1	4	3	9
OG0002518	4	2	1	2	9
OG0002519	1	1	5	2	9
OG0002520	1	1	3	4	9
OG0002521	9	0	0	0	9
OG0002522	2	2	3	2	9
OG0002523	2	2	2	3	9
OG0002524	2	2	3	2	9
OG0002525	4	3	1	1	9
OG0002526	2	1	2	4	9
OG0002527	6	3	0	0	9
OG0002528	2	1	5	1	9
OG0002529	2	2	3	2	9
OG0002530	1	1	2	5	9
OG0002531	1	1	4	3	9
OG0002532	2	1	2	4	9
OG0002533	4	3	1	1	9
OG0002534	5	2	1	1	9
OG0002535	2	2	3	2	9
OG0002536	3	2	2	2	9
OG0002537	1	1	2	5	9
OG0002538	1	0	1	7	9
OG0002539	1	1	2	5	9
OG0002540	1	1	2	5	9
OG0002541	3	1	1	4	9
OG0002542	2	1	3	3	9
OG0002543	1	1	5	2	9
OG0002544	1	1	2	5	9
OG0002545	1	1	4	3	9
OG0002546	1	1	5	2	9
OG0002547	1	1	4	3	9
OG0002548	3	2	2	2	9
OG0002549	1	1	3	4	9
OG0002550	2	1	3	3	9
OG0002551	1	1	5	2	9
OG0002552	1	1	4	3	9
OG0002553	1	1	2	5	9
OG0002554	1	1	3	4	9
OG0002555	2	2	2	3	9
OG0002556	1	1	3	4	9
OG0002557	3	2	2	2	9
OG0002558	2	3	4	0	9
OG0002559	1	1	4	3	9
OG0002560	1	1	3	4	9
OG0002561	2	2	3	2	9
OG0002562	2	2	2	3	9
OG0002563	1	1	2	5	9
OG0002564	2	1	3	3	9
OG0002565	2	2	3	2	9
OG0002566	2	1	5	1	9
OG0002567	2	2	2	3	9
OG0002568	1	1	3	4	9
OG0002569	2	2	2	3	9
OG0002570	3	2	2	2	9
OG0002571	1	1	2	5	9
OG0002572	3	1	1	4	9
OG0002573	5	2	1	1	9
OG0002574	2	1	4	2	9
OG0002575	2	2	2	3	9
OG0002576	2	2	2	3	9
OG0002577	1	1	3	4	9
OG0002578	2	3	2	2	9
OG0002579	3	1	3	2	9
OG0002580	3	6	0	0	9
OG0002581	1	1	3	4	9
OG0002582	1	3	2	3	9
OG0002583	3	2	2	2	9
OG0002584	1	6	1	1	9
OG0002585	2	1	4	2	9
OG0002586	1	1	2	5	9
OG0002587	3	2	2	2	9
OG0002588	4	4	0	1	9
OG0002589	2	2	3	2	9
OG0002590	1	1	3	4	9
OG0002591	2	3	2	2	9
OG0002592	4	1	2	2	9
OG0002593	2	2	3	2	9
OG0002594	1	1	1	6	9
OG0002595	2	1	3	3	9
OG0002596	1	1	4	3	9
OG0002597	6	3	0	0	9
OG0002598	3	3	2	1	9
OG0002599	2	1	2	4	9
OG0002600	1	1	2	5	9
OG0002601	2	2	3	2	9
OG0002602	1	1	3	4	9
OG0002603	5	2	1	1	9
OG0002604	2	5	1	1	9
OG0002605	4	3	1	1	9
OG0002606	2	1	3	3	9
OG0002607	4	2	1	2	9
OG0002608	2	1	3	3	9
OG0002609	2	1	2	4	9
OG0002610	3	2	2	2	9
OG0002611	2	1	3	3	9
OG0002612	2	5	1	1	9
OG0002613	1	8	0	0	9
OG0002614	4	4	0	1	9
OG0002615	1	1	1	6	9
OG0002616	1	1	3	4	9
OG0002617	2	1	2	4	9
OG0002618	2	1	1	5	9
OG0002619	2	2	2	3	9
OG0002620	1	2	4	2	9
OG0002621	2	1	4	2	9
OG0002622	1	1	3	4	9
OG0002623	2	2	2	3	9
OG0002624	1	1	1	6	9
OG0002625	2	1	3	3	9
OG0002626	2	3	2	2	9
OG0002627	1	1	5	2	9
OG0002628	1	1	4	3	9
OG0002629	1	1	5	2	9
OG0002630	2	3	3	1	9
OG0002631	2	1	2	4	9
OG0002632	1	3	2	3	9
OG0002633	1	1	2	5	9
OG0002634	2	1	4	2	9
OG0002635	2	3	2	2	9
OG0002636	2	2	3	2	9
OG0002637	3	1	5	0	9
OG0002638	3	2	2	2	9
OG0002639	4	2	1	2	9
OG0002640	1	1	2	5	9
OG0002641	1	1	6	1	9
OG0002642	1	1	2	5	9
OG0002643	4	1	2	2	9
OG0002644	3	2	2	2	9
OG0002645	1	1	4	3	9
OG0002646	4	2	1	2	9
OG0002647	1	1	1	6	9
OG0002648	2	1	4	2	9
OG0002649	2	2	3	2	9
OG0002650	2	1	2	4	9
OG0002651	2	2	2	3	9
OG0002652	3	3	2	1	9
OG0002653	1	1	4	3	9
OG0002654	3	2	2	2	9
OG0002655	1	1	4	3	9
OG0002656	3	3	2	1	9
OG0002657	1	1	4	3	9
OG0002658	2	1	3	3	9
OG0002659	2	2	2	3	9
OG0002660	1	1	3	4	9
OG0002661	2	0	4	3	9
OG0002662	1	1	2	5	9
OG0002663	8	1	0	0	9
OG0002664	5	1	2	1	9
OG0002665	9	0	0	0	9
OG0002666	2	1	2	4	9
OG0002667	1	1	3	4	9
OG0002668	2	1	3	3	9
OG0002669	1	1	3	4	9
OG0002670	1	1	3	4	9
OG0002671	1	8	0	0	9
OG0002672	1	1	4	3	9
OG0002673	1	1	5	2	9
OG0002674	2	2	3	2	9
OG0002675	1	1	5	2	9
OG0002676	2	1	2	4	9
OG0002677	1	1	2	5	9
OG0002678	2	4	2	1	9
OG0002679	1	1	2	5	9
OG0002680	1	1	5	2	9
OG0002681	2	1	3	3	9
OG0002682	3	2	3	1	9
OG0002683	2	1	2	4	9
OG0002684	1	8	0	0	9
OG0002685	2	1	2	4	9
OG0002686	2	1	2	4	9
OG0002687	2	1	2	4	9
OG0002688	2	1	2	4	9
OG0002689	2	5	1	1	9
OG0002690	2	2	2	3	9
OG0002691	1	1	3	4	9
OG0002692	1	0	4	4	9
OG0002693	2	1	4	2	9
OG0002694	2	2	3	2	9
OG0002695	1	1	2	5	9
OG0002696	2	2	2	3	9
OG0002697	1	1	3	4	9
OG0002698	2	3	2	2	9
OG0002699	2	1	4	2	9
OG0002700	2	1	3	3	9
OG0002701	2	2	3	2	9
OG0002702	3	4	1	1	9
OG0002703	2	2	2	3	9
OG0002704	1	1	3	4	9
OG0002705	2	2	4	1	9
OG0002706	1	1	4	3	9
OG0002707	2	1	2	4	9
OG0002708	1	1	3	4	9
OG0002709	1	1	3	4	9
OG0002710	2	1	4	2	9
OG0002711	4	2	1	2	9
OG0002712	6	1	1	1	9
OG0002713	3	4	1	1	9
OG0002714	1	1	3	4	9
OG0002715	2	2	2	3	9
OG0002716	2	1	3	3	9
OG0002717	1	1	4	3	9
OG0002718	2	2	2	3	9
OG0002719	3	1	2	3	9
OG0002720	1	1	5	2	9
OG0002721	1	1	4	3	9
OG0002722	2	1	2	4	9
OG0002723	2	1	2	4	9
OG0002724	1	1	3	4	9
OG0002725	1	1	3	4	9
OG0002726	2	2	3	2	9
OG0002727	1	1	2	5	9
OG0002728	3	1	2	3	9
OG0002729	1	1	2	5	9
OG0002730	1	1	5	2	9
OG0002731	1	1	4	3	9
OG0002732	3	1	3	2	9
OG0002733	1	1	3	4	9
OG0002734	3	2	2	2	9
OG0002735	3	3	2	1	9
OG0002736	1	1	3	4	9
OG0002737	3	4	1	1	9
OG0002738	2	1	3	3	9
OG0002739	2	2	4	1	9
OG0002740	1	1	3	4	9
OG0002741	2	2	2	3	9
OG0002742	4	4	0	1	9
OG0002743	2	2	1	4	9
OG0002744	1	1	3	4	9
OG0002745	2	2	3	2	9
OG0002746	1	1	4	3	9
OG0002747	1	1	4	3	9
OG0002748	1	1	3	4	9
OG0002749	1	1	1	6	9
OG0002750	1	1	4	3	9
OG0002751	2	1	3	3	9
OG0002752	2	1	3	3	9
OG0002753	1	1	2	5	9
OG0002754	1	1	4	3	9
OG0002755	1	1	3	4	9
OG0002756	3	2	2	2	9
OG0002757	2	1	2	4	9
OG0002758	1	3	3	2	9
OG0002759	1	1	2	5	9
OG0002760	2	1	2	4	9
OG0002761	3	1	3	2	9
OG0002762	2	2	3	2	9
OG0002763	1	1	2	5	9
OG0002764	3	1	3	2	9
OG0002765	2	0	0	7	9
OG0002766	1	1	2	5	9
OG0002767	1	1	2	5	9
OG0002768	4	1	3	1	9
OG0002769	1	1	4	3	9
OG0002770	1	1	4	3	9
OG0002771	1	2	4	2	9
OG0002772	3	2	2	2	9
OG0002773	1	1	4	3	9
OG0002774	1	1	4	3	9
OG0002775	1	1	2	5	9
OG0002776	2	2	2	3	9
OG0002777	1	1	3	4	9
OG0002778	2	2	3	2	9
OG0002779	4	3	1	1	9
OG0002780	1	0	0	8	9
OG0002781	2	1	2	4	9
OG0002782	2	1	3	3	9
OG0002783	3	2	2	2	9
OG0002784	1	1	4	3	9
OG0002785	2	3	2	2	9
OG0002786	3	2	2	2	9
OG0002787	1	1	1	6	9
OG0002788	1	1	4	3	9
OG0002789	1	1	2	5	9
OG0002790	1	1	4	3	9
OG0002791	1	1	5	2	9
OG0002792	2	2	3	2	9
OG0002793	3	2	2	2	9
OG0002794	1	1	3	4	9
OG0002795	2	1	3	3	9
OG0002796	4	1	1	3	9
OG0002797	1	0	5	3	9
OG0002798	2	3	2	2	9
OG0002799	1	1	1	6	9
OG0002800	2	1	2	4	9
OG0002801	2	2	2	3	9
OG0002802	1	1	1	6	9
OG0002803	4	1	1	3	9
OG0002804	1	1	3	4	9
OG0002805	1	1	6	1	9
OG0002806	2	5	1	1	9
OG0002807	2	1	2	4	9
OG0002808	3	1	4	1	9
OG0002809	1	1	2	5	9
OG0002810	2	1	4	2	9
OG0002811	1	1	5	2	9
OG0002812	2	2	1	4	9
OG0002813	1	8	0	0	9
OG0002814	1	8	0	0	9
OG0002815	3	1	3	2	9
OG0002816	4	3	1	1	9
OG0002817	4	2	2	1	9
OG0002818	1	1	2	5	9
OG0002819	2	1	2	4	9
OG0002820	3	1	3	2	9
OG0002821	1	0	8	0	9
OG0002822	1	1	3	4	9
OG0002823	1	1	3	4	9
OG0002824	1	1	1	6	9
OG0002825	3	2	2	2	9
OG0002826	1	1	2	5	9
OG0002827	2	6	1	0	9
OG0002828	1	1	6	1	9
OG0002829	2	2	1	4	9
OG0002830	2	1	4	2	9
OG0002831	1	1	2	5	9
OG0002832	2	1	2	4	9
OG0002833	1	1	2	5	9
OG0002834	3	1	1	4	9
OG0002835	3	1	2	3	9
OG0002836	4	1	2	2	9
OG0002837	2	2	3	2	9
OG0002838	2	1	2	4	9
OG0002839	1	1	2	5	9
OG0002840	3	3	1	2	9
OG0002841	2	1	4	2	9
OG0002842	1	1	4	3	9
OG0002843	4	0	3	2	9
OG0002844	2	1	4	2	9
OG0002845	2	1	3	3	9
OG0002846	1	1	4	3	9
OG0002847	1	1	4	3	9
OG0002848	1	1	2	5	9
OG0002849	1	1	4	3	9
OG0002850	2	1	3	3	9
OG0002851	3	2	2	2	9
OG0002852	1	1	4	3	9
OG0002853	1	1	4	3	9
OG0002854	3	1	3	2	9
OG0002855	3	2	2	2	9
OG0002856	2	2	1	4	9
OG0002857	1	6	1	1	9
OG0002858	1	1	4	3	9
OG0002859	2	1	3	3	9
OG0002860	1	1	3	4	9
OG0002861	1	1	2	5	9
OG0002862	2	1	2	4	9
OG0002863	2	1	2	4	9
OG0002864	7	2	0	0	9
OG0002865	2	3	3	1	9
OG0002866	2	1	2	4	9
OG0002867	1	1	6	1	9
OG0002868	1	5	2	1	9
OG0002869	3	2	1	3	9
OG0002870	2	1	2	4	9
OG0002871	3	2	3	1	9
OG0002872	2	1	2	4	9
OG0002873	3	4	1	1	9
OG0002874	1	1	1	6	9
OG0002875	1	1	4	3	9
OG0002876	2	2	3	2	9
OG0002877	3	2	1	3	9
OG0002878	2	1	4	2	9
OG0002879	1	1	5	2	9
OG0002880	1	1	4	3	9
OG0002881	2	1	4	2	9
OG0002882	1	1	3	4	9
OG0002883	1	8	0	0	9
OG0002884	3	1	3	2	9
OG0002885	2	2	3	2	9
OG0002886	1	1	3	4	9
OG0002887	3	2	2	2	9
OG0002888	2	1	3	3	9
OG0002889	1	3	2	3	9
OG0002890	2	3	2	2	9
OG0002891	1	1	6	1	9
OG0002892	1	1	6	1	9
OG0002893	2	1	4	2	9
OG0002894	1	1	4	3	9
OG0002895	2	1	3	3	9
OG0002896	1	8	0	0	9
OG0002897	1	1	6	1	9
OG0002898	2	2	3	2	9
OG0002899	3	1	2	3	9
OG0002900	3	1	2	3	9
OG0002901	2	1	2	4	9
OG0002902	2	1	4	2	9
OG0002903	4	3	1	1	9
OG0002904	1	1	3	4	9
OG0002905	3	1	1	4	9
OG0002906	2	1	3	3	9
OG0002907	2	2	2	3	9
OG0002908	1	1	3	4	9
OG0002909	3	1	2	3	9
OG0002910	3	4	1	1	9
OG0002911	4	3	1	1	9
OG0002912	1	1	3	4	9
OG0002913	1	1	1	6	9
OG0002914	1	1	4	3	9
OG0002915	1	1	4	3	9
OG0002916	1	1	2	5	9
OG0002917	2	1	3	3	9
OG0002918	2	1	4	2	9
OG0002919	1	1	2	5	9
OG0002920	2	1	2	4	9
OG0002921	1	1	3	4	9
OG0002922	2	1	1	5	9
OG0002923	1	1	2	5	9
OG0002924	1	1	3	4	9
OG0002925	2	2	2	3	9
OG0002926	1	1	2	5	9
OG0002927	2	3	2	2	9
OG0002928	1	1	6	1	9
OG0002929	3	1	2	3	9
OG0002930	2	1	4	2	9
OG0002931	1	1	3	4	9
OG0002932	1	2	4	2	9
OG0002933	1	1	3	4	9
OG0002934	2	2	4	1	9
OG0002935	1	1	4	3	9
OG0002936	1	1	4	3	9
OG0002937	1	1	4	3	9
OG0002938	2	1	3	3	9
OG0002939	1	1	3	4	9
OG0002940	1	1	3	4	9
OG0002941	1	1	1	6	9
OG0002942	2	2	2	3	9
OG0002943	1	1	1	6	9
OG0002944	1	1	7	0	9
OG0002945	2	1	3	3	9
OG0002946	1	1	2	5	9
OG0002947	1	2	2	4	9
OG0002948	1	1	4	3	9
OG0002949	1	1	3	4	9
OG0002950	2	2	3	2	9
OG0002951	1	1	4	3	9
OG0002952	1	0	3	5	9
OG0002953	1	1	4	3	9
OG0002954	0	9	0	0	9
OG0002955	0	3	3	3	9
OG0002956	0	9	0	0	9
OG0002957	0	9	0	0	9
OG0002958	0	9	0	0	9
OG0002959	0	7	1	1	9
OG0002960	0	1	2	6	9
OG0002961	0	9	0	0	9
OG0002962	0	2	7	0	9
OG0002963	0	9	0	0	9
OG0002964	0	1	4	4	9
OG0002965	0	7	1	1	9
OG0002966	0	9	0	0	9
OG0002967	0	2	1	6	9
OG0002968	0	9	0	0	9
OG0002969	0	9	0	0	9
OG0002970	0	8	0	1	9
OG0002971	0	9	0	0	9
OG0002972	0	9	0	0	9
OG0002973	0	9	0	0	9
OG0002974	0	9	0	0	9
OG0002975	0	9	0	0	9
OG0002976	0	1	6	2	9
OG0002977	0	1	1	7	9
OG0002978	0	1	6	2	9
OG0002979	0	9	0	0	9
OG0002980	0	6	3	0	9
OG0002981	0	9	0	0	9
OG0002982	0	1	2	6	9
OG0002983	0	0	9	0	9
OG0002984	0	0	6	3	9
OG0002985	0	0	9	0	9
OG0002986	0	0	3	6	9
OG0002987	0	0	8	1	9
OG0002988	0	0	8	1	9
OG0002989	0	0	8	1	9
OG0002990	0	0	3	6	9
OG0002991	0	0	9	0	9
OG0002992	0	0	1	8	9
OG0002993	0	0	8	1	9
OG0002994	0	0	6	3	9
OG0002995	0	0	9	0	9
OG0002996	0	0	2	7	9
OG0002997	0	0	5	4	9
OG0002998	0	0	5	4	9
OG0002999	0	0	3	6	9
OG0003000	0	0	0	9	9
OG0003001	0	0	0	9	9
OG0003002	0	0	0	9	9
OG0003003	0	0	0	9	9
OG0003004	0	0	0	9	9
OG0003005	0	0	0	9	9
OG0003006	0	0	0	9	9
OG0003007	0	0	0	9	9
OG0003008	4	2	1	1	8
OG0003009	8	0	0	0	8
OG0003010	3	5	0	0	8
OG0003011	2	2	2	2	8
OG0003012	1	1	5	1	8
OG0003013	1	3	2	2	8
OG0003014	2	6	0	0	8
OG0003015	4	4	0	0	8
OG0003016	3	2	2	1	8
OG0003017	1	1	5	1	8
OG0003018	1	1	4	2	8
OG0003019	3	3	2	0	8
OG0003020	5	3	0	0	8
OG0003021	3	5	0	0	8
OG0003022	7	1	0	0	8
OG0003023	6	2	0	0	8
OG0003024	2	2	2	2	8
OG0003025	2	6	0	0	8
OG0003026	7	1	0	0	8
OG0003027	6	2	0	0	8
OG0003028	4	1	2	1	8
OG0003029	8	0	0	0	8
OG0003030	3	1	2	2	8
OG0003031	2	1	1	4	8
OG0003032	2	2	3	1	8
OG0003033	1	1	3	3	8
OG0003034	2	2	2	2	8
OG0003035	3	1	1	3	8
OG0003036	2	1	2	3	8
OG0003037	6	2	0	0	8
OG0003038	2	1	4	1	8
OG0003039	2	2	3	1	8
OG0003040	3	3	2	0	8
OG0003041	1	5	1	1	8
OG0003042	6	2	0	0	8
OG0003043	1	1	3	3	8
OG0003044	1	1	4	2	8
OG0003045	1	1	3	3	8
OG0003046	2	1	4	1	8
OG0003047	1	1	3	3	8
OG0003048	3	3	1	1	8
OG0003049	1	2	4	1	8
OG0003050	4	1	2	1	8
OG0003051	1	1	3	3	8
OG0003052	2	1	1	4	8
OG0003053	2	1	3	2	8
OG0003054	3	2	1	2	8
OG0003055	1	1	4	2	8
OG0003056	2	2	1	3	8
OG0003057	1	0	1	6	8
OG0003058	2	2	2	2	8
OG0003059	1	1	2	4	8
OG0003060	2	1	2	3	8
OG0003061	2	2	2	2	8
OG0003062	1	1	1	5	8
OG0003063	1	1	2	4	8
OG0003064	3	2	1	2	8
OG0003065	1	1	3	3	8
OG0003066	8	0	0	0	8
OG0003067	1	1	1	5	8
OG0003068	2	2	2	2	8
OG0003069	6	1	1	0	8
OG0003070	1	1	3	3	8
OG0003071	4	2	1	1	8
OG0003072	2	2	1	3	8
OG0003073	1	2	4	1	8
OG0003074	1	1	3	3	8
OG0003075	1	1	2	4	8
OG0003076	2	2	2	2	8
OG0003077	1	1	3	3	8
OG0003078	2	1	2	3	8
OG0003079	1	0	4	3	8
OG0003080	5	1	1	1	8
OG0003081	2	2	2	2	8
OG0003082	2	1	1	4	8
OG0003083	1	0	1	6	8
OG0003084	2	2	3	1	8
OG0003085	2	1	3	2	8
OG0003086	1	1	4	2	8
OG0003087	2	2	2	2	8
OG0003088	2	1	2	3	8
OG0003089	1	1	3	3	8
OG0003090	1	1	2	4	8
OG0003091	2	2	2	2	8
OG0003092	1	1	1	5	8
OG0003093	1	1	3	3	8
OG0003094	2	2	2	2	8
OG0003095	3	1	2	2	8
OG0003096	1	1	3	3	8
OG0003097	1	1	2	4	8
OG0003098	1	1	5	1	8
OG0003099	2	2	2	2	8
OG0003100	2	1	3	2	8
OG0003101	1	1	3	3	8
OG0003102	2	2	2	2	8
OG0003103	3	1	2	2	8
OG0003104	2	2	2	2	8
OG0003105	2	2	3	1	8
OG0003106	1	1	4	2	8
OG0003107	3	1	2	2	8
OG0003108	1	2	3	2	8
OG0003109	1	0	2	5	8
OG0003110	2	2	2	2	8
OG0003111	1	1	4	2	8
OG0003112	1	1	2	4	8
OG0003113	2	2	2	2	8
OG0003114	1	1	3	3	8
OG0003115	1	1	2	4	8
OG0003116	1	1	4	2	8
OG0003117	1	1	1	5	8
OG0003118	2	2	2	2	8
OG0003119	5	1	1	1	8
OG0003120	6	2	0	0	8
OG0003121	4	2	1	1	8
OG0003122	8	0	0	0	8
OG0003123	1	1	3	3	8
OG0003124	7	1	0	0	8
OG0003125	1	1	2	4	8
OG0003126	1	1	3	3	8
OG0003127	2	5	1	0	8
OG0003128	2	1	3	2	8
OG0003129	3	1	2	2	8
OG0003130	1	1	4	2	8
OG0003131	2	1	3	2	8
OG0003132	3	2	1	2	8
OG0003133	3	1	2	2	8
OG0003134	1	2	3	2	8
OG0003135	2	2	2	2	8
OG0003136	2	1	2	3	8
OG0003137	1	1	2	4	8
OG0003138	1	1	4	2	8
OG0003139	1	1	4	2	8
OG0003140	2	1	2	3	8
OG0003141	2	2	2	2	8
OG0003142	1	1	3	3	8
OG0003143	1	1	3	3	8
OG0003144	2	1	2	3	8
OG0003145	5	2	1	0	8
OG0003146	2	0	1	5	8
OG0003147	7	1	0	0	8
OG0003148	5	1	1	1	8
OG0003149	3	1	2	2	8
OG0003150	6	2	0	0	8
OG0003151	2	1	4	1	8
OG0003152	2	2	2	2	8
OG0003153	4	1	2	1	8
OG0003154	6	1	1	0	8
OG0003155	2	2	2	2	8
OG0003156	2	1	2	3	8
OG0003157	2	2	3	1	8
OG0003158	1	1	3	3	8
OG0003159	4	2	1	1	8
OG0003160	2	2	2	2	8
OG0003161	4	4	0	0	8
OG0003162	7	1	0	0	8
OG0003163	2	2	2	2	8
OG0003164	5	0	1	2	8
OG0003165	1	1	4	2	8
OG0003166	2	1	2	3	8
OG0003167	3	1	3	1	8
OG0003168	1	1	2	4	8
OG0003169	2	1	2	3	8
OG0003170	7	1	0	0	8
OG0003171	2	1	2	3	8
OG0003172	5	2	0	1	8
OG0003173	2	1	1	4	8
OG0003174	2	0	4	2	8
OG0003175	2	2	2	2	8
OG0003176	5	3	0	0	8
OG0003177	1	1	4	2	8
OG0003178	2	2	1	3	8
OG0003179	1	1	3	3	8
OG0003180	6	1	0	1	8
OG0003181	2	1	2	3	8
OG0003182	3	1	3	1	8
OG0003183	4	2	1	1	8
OG0003184	2	2	2	2	8
OG0003185	2	1	2	3	8
OG0003186	2	2	2	2	8
OG0003187	4	1	1	2	8
OG0003188	3	3	2	0	8
OG0003189	1	1	3	3	8
OG0003190	4	4	0	0	8
OG0003191	1	1	3	3	8
OG0003192	8	0	0	0	8
OG0003193	6	2	0	0	8
OG0003194	2	1	3	2	8
OG0003195	2	1	2	3	8
OG0003196	1	1	2	4	8
OG0003197	1	1	2	4	8
OG0003198	1	1	3	3	8
OG0003199	1	1	4	2	8
OG0003200	1	1	1	5	8
OG0003201	1	1	4	2	8
OG0003202	2	2	2	2	8
OG0003203	2	1	1	4	8
OG0003204	2	1	2	3	8
OG0003205	1	1	4	2	8
OG0003206	2	1	2	3	8
OG0003207	1	1	3	3	8
OG0003208	2	1	3	2	8
OG0003209	2	1	4	1	8
OG0003210	2	2	2	2	8
OG0003211	2	2	2	2	8
OG0003212	2	3	2	1	8
OG0003213	1	1	4	2	8
OG0003214	1	1	3	3	8
OG0003215	1	1	4	2	8
OG0003216	2	2	2	2	8
OG0003217	2	1	3	2	8
OG0003218	1	1	3	3	8
OG0003219	1	1	5	1	8
OG0003220	2	1	3	2	8
OG0003221	1	1	1	5	8
OG0003222	2	2	2	2	8
OG0003223	3	2	2	1	8
OG0003224	2	2	2	2	8
OG0003225	1	1	3	3	8
OG0003226	3	1	2	2	8
OG0003227	2	2	2	2	8
OG0003228	1	1	2	4	8
OG0003229	2	2	2	2	8
OG0003230	1	1	1	5	8
OG0003231	1	1	2	4	8
OG0003232	1	1	4	2	8
OG0003233	1	1	3	3	8
OG0003234	1	2	2	3	8
OG0003235	1	2	4	1	8
OG0003236	1	2	2	3	8
OG0003237	1	1	3	3	8
OG0003238	2	2	2	2	8
OG0003239	3	1	2	2	8
OG0003240	1	1	2	4	8
OG0003241	3	1	2	2	8
OG0003242	2	2	2	2	8
OG0003243	1	2	2	3	8
OG0003244	2	2	2	2	8
OG0003245	1	1	2	4	8
OG0003246	1	2	3	2	8
OG0003247	1	1	2	4	8
OG0003248	2	2	2	2	8
OG0003249	3	1	2	2	8
OG0003250	2	2	3	1	8
OG0003251	2	1	3	2	8
OG0003252	2	1	3	2	8
OG0003253	2	1	2	3	8
OG0003254	6	1	1	0	8
OG0003255	2	1	1	4	8
OG0003256	1	1	4	2	8
OG0003257	2	1	1	4	8
OG0003258	3	2	1	2	8
OG0003259	3	1	2	2	8
OG0003260	2	1	3	2	8
OG0003261	2	1	3	2	8
OG0003262	6	2	0	0	8
OG0003263	1	1	4	2	8
OG0003264	2	2	2	2	8
OG0003265	3	1	2	2	8
OG0003266	1	1	4	2	8
OG0003267	8	0	0	0	8
OG0003268	1	1	2	4	8
OG0003269	3	1	2	2	8
OG0003270	2	1	2	3	8
OG0003271	1	1	3	3	8
OG0003272	1	7	0	0	8
OG0003273	3	1	2	2	8
OG0003274	1	5	1	1	8
OG0003275	1	0	3	4	8
OG0003276	1	3	1	3	8
OG0003277	7	1	0	0	8
OG0003278	5	2	0	1	8
OG0003279	2	2	2	2	8
OG0003280	2	2	2	2	8
OG0003281	2	1	3	2	8
OG0003282	7	1	0	0	8
OG0003283	2	1	1	4	8
OG0003284	2	1	2	3	8
OG0003285	3	3	1	1	8
OG0003286	1	1	2	4	8
OG0003287	3	2	1	2	8
OG0003288	2	2	2	2	8
OG0003289	2	2	2	2	8
OG0003290	1	1	3	3	8
OG0003291	2	1	2	3	8
OG0003292	2	1	3	2	8
OG0003293	2	2	2	2	8
OG0003294	2	1	3	2	8
OG0003295	1	1	2	4	8
OG0003296	2	2	2	2	8
OG0003297	1	1	1	5	8
OG0003298	2	2	2	2	8
OG0003299	2	0	3	3	8
OG0003300	1	1	2	4	8
OG0003301	3	1	1	3	8
OG0003302	1	1	2	4	8
OG0003303	3	1	2	2	8
OG0003304	2	2	2	2	8
OG0003305	2	1	3	2	8
OG0003306	2	1	3	2	8
OG0003307	2	4	1	1	8
OG0003308	2	2	1	3	8
OG0003309	1	1	3	3	8
OG0003310	1	1	4	2	8
OG0003311	3	3	1	1	8
OG0003312	1	1	3	3	8
OG0003313	1	1	3	3	8
OG0003314	2	2	1	3	8
OG0003315	2	2	2	2	8
OG0003316	2	1	3	2	8
OG0003317	2	1	2	3	8
OG0003318	2	2	2	2	8
OG0003319	4	2	1	1	8
OG0003320	2	2	2	2	8
OG0003321	1	2	3	2	8
OG0003322	1	3	3	1	8
OG0003323	1	1	3	3	8
OG0003324	2	2	2	2	8
OG0003325	1	1	5	1	8
OG0003326	6	2	0	0	8
OG0003327	1	0	3	4	8
OG0003328	3	3	2	0	8
OG0003329	2	2	3	1	8
OG0003330	1	1	4	2	8
OG0003331	2	2	2	2	8
OG0003332	1	1	4	2	8
OG0003333	3	5	0	0	8
OG0003334	2	1	3	2	8
OG0003335	1	3	3	1	8
OG0003336	2	2	2	2	8
OG0003337	2	1	3	2	8
OG0003338	2	2	2	2	8
OG0003339	1	1	3	3	8
OG0003340	7	1	0	0	8
OG0003341	3	1	2	2	8
OG0003342	1	2	0	5	8
OG0003343	7	1	0	0	8
OG0003344	6	0	0	2	8
OG0003345	2	2	2	2	8
OG0003346	8	0	0	0	8
OG0003347	3	2	2	1	8
OG0003348	1	7	0	0	8
OG0003349	1	5	2	0	8
OG0003350	2	1	3	2	8
OG0003351	1	1	4	2	8
OG0003352	1	1	4	2	8
OG0003353	8	0	0	0	8
OG0003354	1	1	3	3	8
OG0003355	8	0	0	0	8
OG0003356	2	1	2	3	8
OG0003357	2	1	2	3	8
OG0003358	2	1	2	3	8
OG0003359	2	1	3	2	8
OG0003360	2	1	2	3	8
OG0003361	4	3	1	0	8
OG0003362	2	1	2	3	8
OG0003363	2	1	2	3	8
OG0003364	1	1	2	4	8
OG0003365	1	1	2	4	8
OG0003366	3	1	2	2	8
OG0003367	1	1	2	4	8
OG0003368	6	2	0	0	8
OG0003369	1	1	4	2	8
OG0003370	1	0	2	5	8
OG0003371	1	1	3	3	8
OG0003372	3	3	1	1	8
OG0003373	1	1	4	2	8
OG0003374	1	1	3	3	8
OG0003375	1	1	3	3	8
OG0003376	2	2	2	2	8
OG0003377	2	1	2	3	8
OG0003378	4	3	0	1	8
OG0003379	4	4	0	0	8
OG0003380	2	1	2	3	8
OG0003381	2	1	2	3	8
OG0003382	1	1	2	4	8
OG0003383	1	1	3	3	8
OG0003384	2	1	4	1	8
OG0003385	3	1	2	2	8
OG0003386	1	1	3	3	8
OG0003387	3	1	2	2	8
OG0003388	1	1	1	5	8
OG0003389	1	1	3	3	8
OG0003390	2	2	2	2	8
OG0003391	1	1	3	3	8
OG0003392	1	1	3	3	8
OG0003393	1	1	5	1	8
OG0003394	1	1	3	3	8
OG0003395	1	0	3	4	8
OG0003396	3	1	2	2	8
OG0003397	1	1	2	4	8
OG0003398	1	1	2	4	8
OG0003399	2	2	2	2	8
OG0003400	2	2	2	2	8
OG0003401	1	1	5	1	8
OG0003402	2	1	1	4	8
OG0003403	2	1	4	1	8
OG0003404	2	1	2	3	8
OG0003405	1	1	3	3	8
OG0003406	1	1	1	5	8
OG0003407	2	1	3	2	8
OG0003408	1	1	3	3	8
OG0003409	2	2	2	2	8
OG0003410	1	1	2	4	8
OG0003411	1	1	0	6	8
OG0003412	2	1	2	3	8
OG0003413	1	1	2	4	8
OG0003414	1	1	1	5	8
OG0003415	1	1	4	2	8
OG0003416	2	2	2	2	8
OG0003417	5	1	1	1	8
OG0003418	1	1	5	1	8
OG0003419	1	1	2	4	8
OG0003420	1	3	2	2	8
OG0003421	1	1	2	4	8
OG0003422	1	1	2	4	8
OG0003423	2	2	2	2	8
OG0003424	1	2	2	3	8
OG0003425	2	1	1	4	8
OG0003426	1	1	3	3	8
OG0003427	1	0	2	5	8
OG0003428	1	1	3	3	8
OG0003429	3	1	1	3	8
OG0003430	2	2	2	2	8
OG0003431	2	1	3	2	8
OG0003432	2	1	2	3	8
OG0003433	3	3	1	1	8
OG0003434	2	3	1	2	8
OG0003435	8	0	0	0	8
OG0003436	3	1	2	2	8
OG0003437	1	0	4	3	8
OG0003438	2	2	2	2	8
OG0003439	2	2	2	2	8
OG0003440	1	1	2	4	8
OG0003441	2	2	2	2	8
OG0003442	2	2	2	2	8
OG0003443	2	2	2	2	8
OG0003444	2	2	2	2	8
OG0003445	2	2	2	2	8
OG0003446	2	1	3	2	8
OG0003447	1	1	1	5	8
OG0003448	2	1	3	2	8
OG0003449	2	1	2	3	8
OG0003450	1	7	0	0	8
OG0003451	1	1	3	3	8
OG0003452	1	1	2	4	8
OG0003453	3	5	0	0	8
OG0003454	2	2	2	2	8
OG0003455	2	2	2	2	8
OG0003456	2	2	1	3	8
OG0003457	3	1	2	2	8
OG0003458	1	1	3	3	8
OG0003459	2	2	2	2	8
OG0003460	1	1	4	2	8
OG0003461	2	2	2	2	8
OG0003462	1	1	3	3	8
OG0003463	2	1	2	3	8
OG0003464	2	3	1	2	8
OG0003465	1	2	3	2	8
OG0003466	2	1	1	4	8
OG0003467	2	2	2	2	8
OG0003468	2	2	2	2	8
OG0003469	6	2	0	0	8
OG0003470	2	1	1	4	8
OG0003471	2	1	2	3	8
OG0003472	2	2	3	1	8
OG0003473	2	2	2	2	8
OG0003474	3	1	3	1	8
OG0003475	1	1	5	1	8
OG0003476	1	1	3	3	8
OG0003477	3	1	1	3	8
OG0003478	2	4	1	1	8
OG0003479	6	1	0	1	8
OG0003480	3	1	3	1	8
OG0003481	2	2	2	2	8
OG0003482	1	0	4	3	8
OG0003483	1	1	2	4	8
OG0003484	2	1	1	4	8
OG0003485	1	2	1	4	8
OG0003486	1	1	3	3	8
OG0003487	1	1	3	3	8
OG0003488	3	2	2	1	8
OG0003489	7	0	1	0	8
OG0003490	1	1	2	4	8
OG0003491	2	1	3	2	8
OG0003492	3	1	1	3	8
OG0003493	2	2	2	2	8
OG0003494	2	2	2	2	8
OG0003495	5	1	1	1	8
OG0003496	3	5	0	0	8
OG0003497	3	3	1	1	8
OG0003498	3	2	2	1	8
OG0003499	2	0	2	4	8
OG0003500	1	2	2	3	8
OG0003501	1	0	3	4	8
OG0003502	2	2	2	2	8
OG0003503	2	1	4	1	8
OG0003504	1	0	3	4	8
OG0003505	2	1	2	3	8
OG0003506	1	1	3	3	8
OG0003507	2	6	0	0	8
OG0003508	1	7	0	0	8
OG0003509	3	1	1	3	8
OG0003510	3	1	2	2	8
OG0003511	1	7	0	0	8
OG0003512	4	0	2	2	8
OG0003513	4	4	0	0	8
OG0003514	4	1	1	2	8
OG0003515	1	5	1	1	8
OG0003516	1	0	3	4	8
OG0003517	1	1	1	5	8
OG0003518	3	5	0	0	8
OG0003519	1	1	1	5	8
OG0003520	1	1	3	3	8
OG0003521	3	2	2	1	8
OG0003522	1	1	4	2	8
OG0003523	1	4	3	0	8
OG0003524	3	5	0	0	8
OG0003525	2	1	2	3	8
OG0003526	2	1	2	3	8
OG0003527	2	1	3	2	8
OG0003528	5	2	1	0	8
OG0003529	1	1	4	2	8
OG0003530	1	1	1	5	8
OG0003531	2	6	0	0	8
OG0003532	1	7	0	0	8
OG0003533	2	3	2	1	8
OG0003534	4	4	0	0	8
OG0003535	1	2	3	2	8
OG0003536	2	1	2	3	8
OG0003537	1	3	4	0	8
OG0003538	2	1	2	3	8
OG0003539	2	1	2	3	8
OG0003540	1	2	2	3	8
OG0003541	2	2	2	2	8
OG0003542	2	1	4	1	8
OG0003543	2	1	3	2	8
OG0003544	1	1	3	3	8
OG0003545	1	1	0	6	8
OG0003546	2	2	2	2	8
OG0003547	1	1	3	3	8
OG0003548	4	1	2	1	8
OG0003549	2	2	1	3	8
OG0003550	1	1	3	3	8
OG0003551	2	2	2	2	8
OG0003552	1	1	3	3	8
OG0003553	3	1	4	0	8
OG0003554	8	0	0	0	8
OG0003555	1	0	6	1	8
OG0003556	1	1	3	3	8
OG0003557	1	1	5	1	8
OG0003558	1	1	3	3	8
OG0003559	1	1	2	4	8
OG0003560	2	1	2	3	8
OG0003561	2	6	0	0	8
OG0003562	2	1	2	3	8
OG0003563	1	1	4	2	8
OG0003564	2	2	2	2	8
OG0003565	1	1	3	3	8
OG0003566	2	2	2	2	8
OG0003567	2	1	3	2	8
OG0003568	3	1	3	1	8
OG0003569	2	1	2	3	8
OG0003570	1	1	2	4	8
OG0003571	1	1	2	4	8
OG0003572	2	1	3	2	8
OG0003573	1	1	3	3	8
OG0003574	3	1	2	2	8
OG0003575	1	1	3	3	8
OG0003576	2	1	3	2	8
OG0003577	3	1	1	3	8
OG0003578	2	1	1	4	8
OG0003579	1	1	2	4	8
OG0003580	2	2	2	2	8
OG0003581	1	1	3	3	8
OG0003582	1	1	2	4	8
OG0003583	1	1	3	3	8
OG0003584	1	1	3	3	8
OG0003585	2	1	2	3	8
OG0003586	2	2	1	3	8
OG0003587	3	1	2	2	8
OG0003588	2	1	2	3	8
OG0003589	1	1	3	3	8
OG0003590	1	1	2	4	8
OG0003591	4	1	2	1	8
OG0003592	1	1	1	5	8
OG0003593	2	1	0	5	8
OG0003594	2	2	2	2	8
OG0003595	2	2	2	2	8
OG0003596	1	1	4	2	8
OG0003597	7	1	0	0	8
OG0003598	4	1	1	2	8
OG0003599	2	1	3	2	8
OG0003600	2	1	2	3	8
OG0003601	1	2	2	3	8
OG0003602	2	2	2	2	8
OG0003603	2	1	2	3	8
OG0003604	1	7	0	0	8
OG0003605	1	1	4	2	8
OG0003606	2	1	2	3	8
OG0003607	8	0	0	0	8
OG0003608	2	2	2	2	8
OG0003609	1	1	2	4	8
OG0003610	1	1	2	4	8
OG0003611	1	1	3	3	8
OG0003612	1	0	2	5	8
OG0003613	1	1	4	2	8
OG0003614	2	3	2	1	8
OG0003615	2	1	2	3	8
OG0003616	2	2	2	2	8
OG0003617	2	2	2	2	8
OG0003618	2	2	1	3	8
OG0003619	1	1	2	4	8
OG0003620	1	1	4	2	8
OG0003621	2	1	3	2	8
OG0003622	3	2	1	2	8
OG0003623	2	1	3	2	8
OG0003624	2	2	2	2	8
OG0003625	1	1	1	5	8
OG0003626	4	2	1	1	8
OG0003627	2	2	1	3	8
OG0003628	1	1	3	3	8
OG0003629	1	1	3	3	8
OG0003630	2	2	2	2	8
OG0003631	5	0	1	2	8
OG0003632	2	2	2	2	8
OG0003633	2	2	2	2	8
OG0003634	2	5	1	0	8
OG0003635	2	2	2	2	8
OG0003636	1	1	3	3	8
OG0003637	1	1	2	4	8
OG0003638	1	1	3	3	8
OG0003639	2	2	2	2	8
OG0003640	2	1	2	3	8
OG0003641	1	1	4	2	8
OG0003642	1	1	3	3	8
OG0003643	2	1	3	2	8
OG0003644	1	1	2	4	8
OG0003645	2	2	2	2	8
OG0003646	1	1	3	3	8
OG0003647	1	1	5	1	8
OG0003648	3	4	1	0	8
OG0003649	2	1	3	2	8
OG0003650	2	2	2	2	8
OG0003651	1	1	3	3	8
OG0003652	1	1	2	4	8
OG0003653	1	1	1	5	8
OG0003654	1	1	2	4	8
OG0003655	1	7	0	0	8
OG0003656	8	0	0	0	8
OG0003657	1	1	2	4	8
OG0003658	2	2	2	2	8
OG0003659	1	1	3	3	8
OG0003660	1	2	2	3	8
OG0003661	1	1	3	3	8
OG0003662	1	7	0	0	8
OG0003663	2	2	2	2	8
OG0003664	2	2	2	2	8
OG0003665	2	1	2	3	8
OG0003666	1	2	3	2	8
OG0003667	3	5	0	0	8
OG0003668	2	1	3	2	8
OG0003669	1	1	3	3	8
OG0003670	3	2	1	2	8
OG0003671	2	2	2	2	8
OG0003672	1	1	3	3	8
OG0003673	2	2	2	2	8
OG0003674	1	1	1	5	8
OG0003675	2	1	4	1	8
OG0003676	2	2	3	1	8
OG0003677	1	1	2	4	8
OG0003678	2	1	1	4	8
OG0003679	1	1	3	3	8
OG0003680	1	1	3	3	8
OG0003681	1	1	1	5	8
OG0003682	1	1	2	4	8
OG0003683	2	1	1	4	8
OG0003684	1	1	3	3	8
OG0003685	1	1	2	4	8
OG0003686	2	4	2	0	8
OG0003687	1	1	2	4	8
OG0003688	3	1	1	3	8
OG0003689	2	3	2	1	8
OG0003690	2	3	2	1	8
OG0003691	1	1	2	4	8
OG0003692	2	1	2	3	8
OG0003693	1	0	4	3	8
OG0003694	5	2	1	0	8
OG0003695	2	0	3	3	8
OG0003696	2	2	2	2	8
OG0003697	1	1	4	2	8
OG0003698	2	2	2	2	8
OG0003699	2	1	3	2	8
OG0003700	1	1	4	2	8
OG0003701	1	1	3	3	8
OG0003702	1	1	4	2	8
OG0003703	1	1	3	3	8
OG0003704	1	1	3	3	8
OG0003705	2	2	3	1	8
OG0003706	1	1	2	4	8
OG0003707	2	2	2	2	8
OG0003708	1	1	5	1	8
OG0003709	2	2	2	2	8
OG0003710	1	1	4	2	8
OG0003711	3	3	1	1	8
OG0003712	2	3	2	1	8
OG0003713	2	1	2	3	8
OG0003714	2	1	2	3	8
OG0003715	1	1	1	5	8
OG0003716	3	2	2	1	8
OG0003717	2	1	2	3	8
OG0003718	1	1	1	5	8
OG0003719	1	1	2	4	8
OG0003720	1	1	5	1	8
OG0003721	2	2	2	2	8
OG0003722	2	1	4	1	8
OG0003723	2	2	2	2	8
OG0003724	2	1	3	2	8
OG0003725	2	2	2	2	8
OG0003726	1	1	4	2	8
OG0003727	1	1	2	4	8
OG0003728	1	1	1	5	8
OG0003729	2	1	3	2	8
OG0003730	2	2	3	1	8
OG0003731	2	1	2	3	8
OG0003732	2	2	2	2	8
OG0003733	1	1	3	3	8
OG0003734	2	1	3	2	8
OG0003735	3	2	2	1	8
OG0003736	3	1	2	2	8
OG0003737	1	1	3	3	8
OG0003738	1	1	1	5	8
OG0003739	1	1	3	3	8
OG0003740	2	1	1	4	8
OG0003741	2	2	2	2	8
OG0003742	2	1	3	2	8
OG0003743	3	2	1	2	8
OG0003744	1	1	4	2	8
OG0003745	2	1	1	4	8
OG0003746	1	1	2	4	8
OG0003747	2	1	4	1	8
OG0003748	3	1	2	2	8
OG0003749	2	1	1	4	8
OG0003750	2	1	3	2	8
OG0003751	1	2	3	2	8
OG0003752	1	1	3	3	8
OG0003753	1	2	2	3	8
OG0003754	2	1	4	1	8
OG0003755	2	2	2	2	8
OG0003756	1	1	3	3	8
OG0003757	2	4	1	1	8
OG0003758	1	1	1	5	8
OG0003759	5	0	1	2	8
OG0003760	2	2	2	2	8
OG0003761	3	3	1	1	8
OG0003762	2	1	2	3	8
OG0003763	2	2	1	3	8
OG0003764	2	0	3	3	8
OG0003765	1	1	3	3	8
OG0003766	2	2	2	2	8
OG0003767	2	1	1	4	8
OG0003768	1	0	4	3	8
OG0003769	1	1	2	4	8
OG0003770	2	1	1	4	8
OG0003771	1	1	3	3	8
OG0003772	1	1	3	3	8
OG0003773	4	3	1	0	8
OG0003774	2	2	2	2	8
OG0003775	2	6	0	0	8
OG0003776	1	1	4	2	8
OG0003777	2	1	3	2	8
OG0003778	1	1	4	2	8
OG0003779	1	0	2	5	8
OG0003780	1	2	2	3	8
OG0003781	2	1	2	3	8
OG0003782	2	2	1	3	8
OG0003783	1	1	4	2	8
OG0003784	2	2	2	2	8
OG0003785	1	1	3	3	8
OG0003786	3	3	1	1	8
OG0003787	3	3	1	1	8
OG0003788	1	1	5	1	8
OG0003789	2	4	1	1	8
OG0003790	2	1	2	3	8
OG0003791	1	1	2	4	8
OG0003792	1	1	2	4	8
OG0003793	5	2	0	1	8
OG0003794	2	1	2	3	8
OG0003795	1	1	4	2	8
OG0003796	1	1	3	3	8
OG0003797	1	1	3	3	8
OG0003798	2	2	1	3	8
OG0003799	2	1	2	3	8
OG0003800	1	1	2	4	8
OG0003801	2	2	2	2	8
OG0003802	2	1	3	2	8
OG0003803	2	1	1	4	8
OG0003804	1	1	4	2	8
OG0003805	1	1	4	2	8
OG0003806	1	1	3	3	8
OG0003807	1	1	3	3	8
OG0003808	2	2	2	2	8
OG0003809	1	1	3	3	8
OG0003810	2	2	2	2	8
OG0003811	1	1	3	3	8
OG0003812	1	1	3	3	8
OG0003813	1	1	3	3	8
OG0003814	1	1	2	4	8
OG0003815	1	1	3	3	8
OG0003816	1	1	3	3	8
OG0003817	1	1	3	3	8
OG0003818	2	2	2	2	8
OG0003819	2	1	3	2	8
OG0003820	2	2	2	2	8
OG0003821	2	1	3	2	8
OG0003822	2	2	2	2	8
OG0003823	1	1	3	3	8
OG0003824	1	1	3	3	8
OG0003825	2	1	3	2	8
OG0003826	1	1	4	2	8
OG0003827	3	1	2	2	8
OG0003828	2	1	2	3	8
OG0003829	1	1	3	3	8
OG0003830	1	0	4	3	8
OG0003831	1	1	1	5	8
OG0003832	2	1	2	3	8
OG0003833	1	5	1	1	8
OG0003834	1	7	0	0	8
OG0003835	2	1	2	3	8
OG0003836	7	0	1	0	8
OG0003837	3	1	2	2	8
OG0003838	1	1	4	2	8
OG0003839	2	1	2	3	8
OG0003840	1	1	4	2	8
OG0003841	4	2	1	1	8
OG0003842	1	7	0	0	8
OG0003843	1	1	5	1	8
OG0003844	1	1	3	3	8
OG0003845	1	1	2	4	8
OG0003846	3	1	1	3	8
OG0003847	1	1	3	3	8
OG0003848	4	2	1	1	8
OG0003849	1	1	4	2	8
OG0003850	4	2	1	1	8
OG0003851	1	1	1	5	8
OG0003852	1	1	1	5	8
OG0003853	2	1	3	2	8
OG0003854	1	1	3	3	8
OG0003855	1	1	3	3	8
OG0003856	2	2	2	2	8
OG0003857	2	1	2	3	8
OG0003858	1	1	1	5	8
OG0003859	2	1	1	4	8
OG0003860	1	1	3	3	8
OG0003861	1	1	4	2	8
OG0003862	1	1	2	4	8
OG0003863	2	4	1	1	8
OG0003864	1	1	2	4	8
OG0003865	1	1	1	5	8
OG0003866	2	1	2	3	8
OG0003867	2	1	3	2	8
OG0003868	3	1	2	2	8
OG0003869	1	1	4	2	8
OG0003870	1	0	4	3	8
OG0003871	2	1	2	3	8
OG0003872	1	1	1	5	8
OG0003873	1	1	4	2	8
OG0003874	3	0	3	2	8
OG0003875	3	4	0	1	8
OG0003876	3	1	1	3	8
OG0003877	2	1	2	3	8
OG0003878	2	1	2	3	8
OG0003879	2	2	2	2	8
OG0003880	1	1	3	3	8
OG0003881	1	1	1	5	8
OG0003882	2	1	3	2	8
OG0003883	1	1	3	3	8
OG0003884	2	3	2	1	8
OG0003885	1	1	3	3	8
OG0003886	2	2	2	2	8
OG0003887	1	1	4	2	8
OG0003888	1	1	4	2	8
OG0003889	3	2	1	2	8
OG0003890	1	1	1	5	8
OG0003891	1	1	4	2	8
OG0003892	1	1	3	3	8
OG0003893	1	1	3	3	8
OG0003894	1	1	2	4	8
OG0003895	2	3	2	1	8
OG0003896	1	1	3	3	8
OG0003897	2	4	1	1	8
OG0003898	2	2	1	3	8
OG0003899	1	1	3	3	8
OG0003900	2	2	2	2	8
OG0003901	2	1	3	2	8
OG0003902	1	1	4	2	8
OG0003903	1	1	3	3	8
OG0003904	1	5	1	1	8
OG0003905	1	4	1	2	8
OG0003906	2	4	1	1	8
OG0003907	5	1	1	1	8
OG0003908	1	1	2	4	8
OG0003909	2	1	3	2	8
OG0003910	1	6	0	1	8
OG0003911	1	1	5	1	8
OG0003912	1	1	3	3	8
OG0003913	2	2	2	2	8
OG0003914	1	1	3	3	8
OG0003915	3	2	2	1	8
OG0003916	1	1	3	3	8
OG0003917	1	1	3	3	8
OG0003918	2	2	2	2	8
OG0003919	4	2	1	1	8
OG0003920	2	1	2	3	8
OG0003921	1	1	3	3	8
OG0003922	1	1	3	3	8
OG0003923	1	1	4	2	8
OG0003924	2	1	4	1	8
OG0003925	2	1	2	3	8
OG0003926	1	1	3	3	8
OG0003927	1	1	2	4	8
OG0003928	1	1	2	4	8
OG0003929	1	2	4	1	8
OG0003930	1	1	3	3	8
OG0003931	2	1	1	4	8
OG0003932	1	1	3	3	8
OG0003933	2	2	1	3	8
OG0003934	1	1	2	4	8
OG0003935	1	5	1	1	8
OG0003936	3	1	2	2	8
OG0003937	2	1	2	3	8
OG0003938	1	1	3	3	8
OG0003939	1	1	4	2	8
OG0003940	1	4	2	1	8
OG0003941	1	1	3	3	8
OG0003942	4	2	1	1	8
OG0003943	1	1	2	4	8
OG0003944	1	1	4	2	8
OG0003945	1	1	2	4	8
OG0003946	2	1	3	2	8
OG0003947	1	1	2	4	8
OG0003948	2	2	1	3	8
OG0003949	1	1	3	3	8
OG0003950	4	1	1	2	8
OG0003951	2	1	2	3	8
OG0003952	1	0	5	2	8
OG0003953	2	2	2	2	8
OG0003954	1	7	0	0	8
OG0003955	1	1	5	1	8
OG0003956	1	1	3	3	8
OG0003957	1	1	5	1	8
OG0003958	2	1	2	3	8
OG0003959	2	3	2	1	8
OG0003960	2	2	2	2	8
OG0003961	2	6	0	0	8
OG0003962	2	1	3	2	8
OG0003963	2	1	4	1	8
OG0003964	2	1	2	3	8
OG0003965	1	1	2	4	8
OG0003966	2	2	2	2	8
OG0003967	1	1	5	1	8
OG0003968	1	1	3	3	8
OG0003969	2	2	3	1	8
OG0003970	1	1	2	4	8
OG0003971	1	1	3	3	8
OG0003972	1	1	3	3	8
OG0003973	1	1	4	2	8
OG0003974	1	1	2	4	8
OG0003975	1	5	1	1	8
OG0003976	1	1	3	3	8
OG0003977	2	3	1	2	8
OG0003978	2	0	2	4	8
OG0003979	1	1	2	4	8
OG0003980	2	1	2	3	8
OG0003981	1	1	3	3	8
OG0003982	2	1	4	1	8
OG0003983	1	1	3	3	8
OG0003984	1	1	2	4	8
OG0003985	1	7	0	0	8
OG0003986	2	2	2	2	8
OG0003987	1	1	3	3	8
OG0003988	1	0	1	6	8
OG0003989	4	2	1	1	8
OG0003990	1	0	2	5	8
OG0003991	1	1	2	4	8
OG0003992	1	1	4	2	8
OG0003993	1	7	0	0	8
OG0003994	1	1	3	3	8
OG0003995	2	1	3	2	8
OG0003996	2	1	2	3	8
OG0003997	3	2	2	1	8
OG0003998	2	2	2	2	8
OG0003999	2	2	2	2	8
OG0004000	2	1	2	3	8
OG0004001	2	2	2	2	8
OG0004002	1	1	3	3	8
OG0004003	2	4	1	1	8
OG0004004	2	2	2	2	8
OG0004005	1	1	3	3	8
OG0004006	1	1	2	4	8
OG0004007	3	3	1	1	8
OG0004008	1	2	3	2	8
OG0004009	1	1	3	3	8
OG0004010	1	0	3	4	8
OG0004011	5	1	1	1	8
OG0004012	2	2	2	2	8
OG0004013	2	1	2	3	8
OG0004014	1	1	5	1	8
OG0004015	1	0	5	2	8
OG0004016	3	1	2	2	8
OG0004017	2	1	2	3	8
OG0004018	1	1	2	4	8
OG0004019	1	1	4	2	8
OG0004020	2	1	1	4	8
OG0004021	2	1	4	1	8
OG0004022	1	1	2	4	8
OG0004023	1	1	2	4	8
OG0004024	1	1	2	4	8
OG0004025	1	0	2	5	8
OG0004026	2	1	3	2	8
OG0004027	1	1	3	3	8
OG0004028	2	1	2	3	8
OG0004029	1	1	2	4	8
OG0004030	1	5	1	1	8
OG0004031	1	1	3	3	8
OG0004032	5	1	1	1	8
OG0004033	1	1	4	2	8
OG0004034	1	1	2	4	8
OG0004035	1	1	3	3	8
OG0004036	3	1	2	2	8
OG0004037	1	0	5	2	8
OG0004038	1	1	3	3	8
OG0004039	2	1	3	2	8
OG0004040	1	1	3	3	8
OG0004041	1	1	4	2	8
OG0004042	3	1	2	2	8
OG0004043	1	1	3	3	8
OG0004044	1	1	3	3	8
OG0004045	2	1	2	3	8
OG0004046	1	1	2	4	8
OG0004047	1	1	3	3	8
OG0004048	1	7	0	0	8
OG0004049	1	3	3	1	8
OG0004050	1	1	4	2	8
OG0004051	2	2	2	2	8
OG0004052	1	1	2	4	8
OG0004053	8	0	0	0	8
OG0004054	1	1	3	3	8
OG0004055	1	1	5	1	8
OG0004056	1	4	2	1	8
OG0004057	1	7	0	0	8
OG0004058	1	1	2	4	8
OG0004059	1	1	3	3	8
OG0004060	1	0	4	3	8
OG0004061	2	2	2	2	8
OG0004062	1	1	5	1	8
OG0004063	1	0	5	2	8
OG0004064	1	1	3	3	8
OG0004065	0	8	0	0	8
OG0004066	0	8	0	0	8
OG0004067	0	8	0	0	8
OG0004068	0	8	0	0	8
OG0004069	0	8	0	0	8
OG0004070	0	8	0	0	8
OG0004071	0	8	0	0	8
OG0004072	0	2	2	4	8
OG0004073	0	2	3	3	8
OG0004074	0	8	0	0	8
OG0004075	0	8	0	0	8
OG0004076	0	8	0	0	8
OG0004077	0	8	0	0	8
OG0004078	0	8	0	0	8
OG0004079	0	4	4	0	8
OG0004080	0	8	0	0	8
OG0004081	0	8	0	0	8
OG0004082	0	8	0	0	8
OG0004083	0	8	0	0	8
OG0004084	0	8	0	0	8
OG0004085	0	8	0	0	8
OG0004086	0	8	0	0	8
OG0004087	0	8	0	0	8
OG0004088	0	6	1	1	8
OG0004089	0	8	0	0	8
OG0004090	0	8	0	0	8
OG0004091	0	8	0	0	8
OG0004092	0	2	4	2	8
OG0004093	0	8	0	0	8
OG0004094	0	8	0	0	8
OG0004095	0	2	5	1	8
OG0004096	0	8	0	0	8
OG0004097	0	1	5	2	8
OG0004098	0	2	4	2	8
OG0004099	0	1	4	3	8
OG0004100	0	3	1	4	8
OG0004101	0	5	2	1	8
OG0004102	0	1	4	3	8
OG0004103	0	8	0	0	8
OG0004104	0	4	3	1	8
OG0004105	0	2	3	3	8
OG0004106	0	4	3	1	8
OG0004107	0	4	2	2	8
OG0004108	0	1	1	6	8
OG0004109	0	1	1	6	8
OG0004110	0	1	2	5	8
OG0004111	0	1	5	2	8
OG0004112	0	1	1	6	8
OG0004113	0	0	7	1	8
OG0004114	0	0	7	1	8
OG0004115	0	0	8	0	8
OG0004116	0	0	6	2	8
OG0004117	0	0	7	1	8
OG0004118	0	0	5	3	8
OG0004119	0	0	7	1	8
OG0004120	0	0	1	7	8
OG0004121	0	0	2	6	8
OG0004122	0	0	5	3	8
OG0004123	0	0	3	5	8
OG0004124	0	0	8	0	8
OG0004125	0	0	1	7	8
OG0004126	0	0	1	7	8
OG0004127	0	0	1	7	8
OG0004128	0	0	6	2	8
OG0004129	0	0	5	3	8
OG0004130	0	0	7	1	8
OG0004131	0	0	8	0	8
OG0004132	0	0	2	6	8
OG0004133	0	0	2	6	8
OG0004134	0	0	2	6	8
OG0004135	0	0	6	2	8
OG0004136	0	0	4	4	8
OG0004137	0	0	1	7	8
OG0004138	0	0	7	1	8
OG0004139	0	0	8	0	8
OG0004140	0	0	0	8	8
OG0004141	0	0	0	8	8
OG0004142	2	1	2	2	7
OG0004143	5	2	0	0	7
OG0004144	3	3	0	1	7
OG0004145	1	1	2	3	7
OG0004146	2	3	1	1	7
OG0004147	1	1	1	4	7
OG0004148	3	2	1	1	7
OG0004149	5	2	0	0	7
OG0004150	5	2	0	0	7
OG0004151	2	1	1	3	7
OG0004152	2	1	2	2	7
OG0004153	1	0	2	4	7
OG0004154	1	0	3	3	7
OG0004155	7	0	0	0	7
OG0004156	4	1	1	1	7
OG0004157	1	1	3	2	7
OG0004158	2	1	1	3	7
OG0004159	2	1	2	2	7
OG0004160	4	3	0	0	7
OG0004161	6	1	0	0	7
OG0004162	5	2	0	0	7
OG0004163	1	1	1	4	7
OG0004164	1	1	2	3	7
OG0004165	6	1	0	0	7
OG0004166	1	1	4	1	7
OG0004167	2	5	0	0	7
OG0004168	2	1	2	2	7
OG0004169	1	1	4	1	7
OG0004170	6	1	0	0	7
OG0004171	2	1	2	2	7
OG0004172	1	1	1	4	7
OG0004173	2	1	2	2	7
OG0004174	6	1	0	0	7
OG0004175	1	1	1	4	7
OG0004176	1	1	4	1	7
OG0004177	1	1	4	1	7
OG0004178	3	2	1	1	7
OG0004179	3	2	1	1	7
OG0004180	1	2	1	3	7
OG0004181	2	1	2	2	7
OG0004182	2	1	2	2	7
OG0004183	1	2	2	2	7
OG0004184	1	1	4	1	7
OG0004185	1	1	2	3	7
OG0004186	2	2	0	3	7
OG0004187	2	1	2	2	7
OG0004188	5	1	0	1	7
OG0004189	1	1	4	1	7
OG0004190	2	0	4	1	7
OG0004191	1	0	4	2	7
OG0004192	6	0	1	0	7
OG0004193	1	1	1	4	7
OG0004194	1	1	2	3	7
OG0004195	1	4	1	1	7
OG0004196	1	1	2	3	7
OG0004197	3	2	0	2	7
OG0004198	3	3	0	1	7
OG0004199	1	3	1	2	7
OG0004200	1	1	3	2	7
OG0004201	3	1	2	1	7
OG0004202	1	1	4	1	7
OG0004203	2	2	2	1	7
OG0004204	3	1	1	2	7
OG0004205	1	4	1	1	7
OG0004206	1	1	2	3	7
OG0004207	1	1	2	3	7
OG0004208	1	1	2	3	7
OG0004209	2	2	1	2	7
OG0004210	1	1	2	3	7
OG0004211	1	1	3	2	7
OG0004212	1	1	2	3	7
OG0004213	1	1	2	3	7
OG0004214	2	1	3	1	7
OG0004215	3	2	1	1	7
OG0004216	6	1	0	0	7
OG0004217	1	1	2	3	7
OG0004218	1	6	0	0	7
OG0004219	2	1	1	3	7
OG0004220	1	1	2	3	7
OG0004221	1	1	1	4	7
OG0004222	1	1	3	2	7
OG0004223	2	1	2	2	7
OG0004224	1	2	1	3	7
OG0004225	2	3	1	1	7
OG0004226	2	1	1	3	7
OG0004227	1	1	4	1	7
OG0004228	2	1	2	2	7
OG0004229	2	2	2	1	7
OG0004230	2	1	3	1	7
OG0004231	3	1	2	1	7
OG0004232	1	1	2	3	7
OG0004233	1	1	3	2	7
OG0004234	1	1	4	1	7
OG0004235	2	2	2	1	7
OG0004236	2	3	1	1	7
OG0004237	2	1	1	3	7
OG0004238	2	1	2	2	7
OG0004239	1	1	3	2	7
OG0004240	2	1	4	0	7
OG0004241	1	1	3	2	7
OG0004242	2	1	2	2	7
OG0004243	1	1	2	3	7
OG0004244	1	1	2	3	7
OG0004245	1	1	3	2	7
OG0004246	1	1	2	3	7
OG0004247	1	1	1	4	7
OG0004248	1	1	1	4	7
OG0004249	1	1	2	3	7
OG0004250	1	1	3	2	7
OG0004251	1	0	6	0	7
OG0004252	2	2	2	1	7
OG0004253	3	2	1	1	7
OG0004254	6	0	0	1	7
OG0004255	2	1	2	2	7
OG0004256	3	2	1	1	7
OG0004257	2	1	3	1	7
OG0004258	1	1	2	3	7
OG0004259	1	1	3	2	7
OG0004260	1	1	2	3	7
OG0004261	1	1	1	4	7
OG0004262	2	1	2	2	7
OG0004263	1	1	2	3	7
OG0004264	1	1	2	3	7
OG0004265	7	0	0	0	7
OG0004266	1	1	3	2	7
OG0004267	1	1	3	2	7
OG0004268	2	1	3	1	7
OG0004269	1	2	1	3	7
OG0004270	2	1	3	1	7
OG0004271	1	1	1	4	7
OG0004272	1	1	1	4	7
OG0004273	1	1	3	2	7
OG0004274	1	1	3	2	7
OG0004275	1	1	2	3	7
OG0004276	1	1	3	2	7
OG0004277	2	1	2	2	7
OG0004278	1	1	3	2	7
OG0004279	3	1	2	1	7
OG0004280	3	2	1	1	7
OG0004281	2	1	1	3	7
OG0004282	2	1	2	2	7
OG0004283	1	1	3	2	7
OG0004284	1	1	2	3	7
OG0004285	1	1	2	3	7
OG0004286	1	1	2	3	7
OG0004287	3	2	1	1	7
OG0004288	1	1	3	2	7
OG0004289	2	1	3	1	7
OG0004290	1	1	3	2	7
OG0004291	3	2	1	1	7
OG0004292	2	1	2	2	7
OG0004293	1	1	2	3	7
OG0004294	2	2	1	2	7
OG0004295	2	1	2	2	7
OG0004296	1	1	3	2	7
OG0004297	1	1	1	4	7
OG0004298	2	1	2	2	7
OG0004299	2	2	1	2	7
OG0004300	2	1	2	2	7
OG0004301	1	1	2	3	7
OG0004302	1	1	2	3	7
OG0004303	1	2	2	2	7
OG0004304	1	1	2	3	7
OG0004305	2	1	2	2	7
OG0004306	5	2	0	0	7
OG0004307	2	1	1	3	7
OG0004308	1	1	3	2	7
OG0004309	4	1	1	1	7
OG0004310	2	0	4	1	7
OG0004311	2	1	1	3	7
OG0004312	3	2	1	1	7
OG0004313	1	0	2	4	7
OG0004314	1	1	2	3	7
OG0004315	3	1	1	2	7
OG0004316	1	1	2	3	7
OG0004317	1	1	3	2	7
OG0004318	1	1	3	2	7
OG0004319	1	1	2	3	7
OG0004320	1	1	1	4	7
OG0004321	1	1	4	1	7
OG0004322	2	2	1	2	7
OG0004323	1	1	4	1	7
OG0004324	3	1	1	2	7
OG0004325	2	1	1	3	7
OG0004326	1	6	0	0	7
OG0004327	3	2	1	1	7
OG0004328	2	2	1	2	7
OG0004329	2	2	2	1	7
OG0004330	1	1	4	1	7
OG0004331	5	1	0	1	7
OG0004332	3	1	2	1	7
OG0004333	1	1	2	3	7
OG0004334	2	2	2	1	7
OG0004335	2	1	2	2	7
OG0004336	2	3	1	1	7
OG0004337	6	1	0	0	7
OG0004338	2	1	2	2	7
OG0004339	1	1	1	4	7
OG0004340	6	1	0	0	7
OG0004341	2	1	2	2	7
OG0004342	7	0	0	0	7
OG0004343	1	0	3	3	7
OG0004344	1	1	3	2	7
OG0004345	2	1	2	2	7
OG0004346	2	2	1	2	7
OG0004347	1	1	3	2	7
OG0004348	7	0	0	0	7
OG0004349	4	2	0	1	7
OG0004350	2	3	1	1	7
OG0004351	2	1	2	2	7
OG0004352	6	1	0	0	7
OG0004353	3	1	2	1	7
OG0004354	7	0	0	0	7
OG0004355	1	1	2	3	7
OG0004356	2	1	3	1	7
OG0004357	7	0	0	0	7
OG0004358	1	1	3	2	7
OG0004359	1	6	0	0	7
OG0004360	2	3	1	1	7
OG0004361	2	1	0	4	7
OG0004362	2	1	2	2	7
OG0004363	2	1	2	2	7
OG0004364	3	1	1	2	7
OG0004365	3	1	1	2	7
OG0004366	1	1	3	2	7
OG0004367	1	1	3	2	7
OG0004368	1	1	2	3	7
OG0004369	4	3	0	0	7
OG0004370	1	6	0	0	7
OG0004371	2	1	3	1	7
OG0004372	2	1	2	2	7
OG0004373	1	1	2	3	7
OG0004374	1	1	3	2	7
OG0004375	2	1	2	2	7
OG0004376	1	1	1	4	7
OG0004377	1	1	1	4	7
OG0004378	3	1	2	1	7
OG0004379	1	2	1	3	7
OG0004380	2	1	2	2	7
OG0004381	1	1	3	2	7
OG0004382	1	1	2	3	7
OG0004383	2	1	2	2	7
OG0004384	2	1	2	2	7
OG0004385	2	1	1	3	7
OG0004386	1	1	4	1	7
OG0004387	2	2	2	1	7
OG0004388	2	1	2	2	7
OG0004389	4	1	1	1	7
OG0004390	2	2	2	1	7
OG0004391	1	1	3	2	7
OG0004392	2	0	2	3	7
OG0004393	1	2	1	3	7
OG0004394	1	1	2	3	7
OG0004395	1	1	2	3	7
OG0004396	1	1	1	4	7
OG0004397	1	1	2	3	7
OG0004398	2	2	2	1	7
OG0004399	1	1	3	2	7
OG0004400	4	2	1	0	7
OG0004401	2	2	2	1	7
OG0004402	1	1	3	2	7
OG0004403	2	1	2	2	7
OG0004404	1	1	4	1	7
OG0004405	1	1	3	2	7
OG0004406	2	2	1	2	7
OG0004407	2	1	2	2	7
OG0004408	2	2	2	1	7
OG0004409	1	1	3	2	7
OG0004410	1	1	4	1	7
OG0004411	1	1	2	3	7
OG0004412	5	1	0	1	7
OG0004413	2	2	2	1	7
OG0004414	1	1	3	2	7
OG0004415	1	2	2	2	7
OG0004416	2	3	1	1	7
OG0004417	1	1	3	2	7
OG0004418	1	1	4	1	7
OG0004419	1	1	1	4	7
OG0004420	1	1	2	3	7
OG0004421	2	1	1	3	7
OG0004422	1	1	3	2	7
OG0004423	1	1	3	2	7
OG0004424	2	1	2	2	7
OG0004425	1	0	2	4	7
OG0004426	1	1	2	3	7
OG0004427	2	1	2	2	7
OG0004428	3	3	1	0	7
OG0004429	1	1	2	3	7
OG0004430	2	2	2	1	7
OG0004431	2	1	2	2	7
OG0004432	3	1	1	2	7
OG0004433	2	1	2	2	7
OG0004434	2	1	2	2	7
OG0004435	7	0	0	0	7
OG0004436	3	3	1	0	7
OG0004437	5	1	1	0	7
OG0004438	2	1	2	2	7
OG0004439	3	1	1	2	7
OG0004440	1	1	3	2	7
OG0004441	1	1	1	4	7
OG0004442	1	1	3	2	7
OG0004443	1	1	1	4	7
OG0004444	1	1	1	4	7
OG0004445	2	1	2	2	7
OG0004446	2	1	1	3	7
OG0004447	1	1	2	3	7
OG0004448	1	1	3	2	7
OG0004449	2	3	1	1	7
OG0004450	2	3	1	1	7
OG0004451	1	1	3	2	7
OG0004452	2	2	1	2	7
OG0004453	3	2	1	1	7
OG0004454	6	1	0	0	7
OG0004455	2	1	2	2	7
OG0004456	2	0	3	2	7
OG0004457	4	1	1	1	7
OG0004458	1	2	2	2	7
OG0004459	1	1	3	2	7
OG0004460	1	1	2	3	7
OG0004461	3	2	1	1	7
OG0004462	2	1	2	2	7
OG0004463	2	1	1	3	7
OG0004464	3	1	1	2	7
OG0004465	2	4	0	1	7
OG0004466	2	2	1	2	7
OG0004467	2	1	2	2	7
OG0004468	1	1	4	1	7
OG0004469	3	4	0	0	7
OG0004470	3	2	1	1	7
OG0004471	1	1	1	4	7
OG0004472	1	6	0	0	7
OG0004473	1	1	1	4	7
OG0004474	2	1	1	3	7
OG0004475	3	3	1	0	7
OG0004476	3	1	1	2	7
OG0004477	2	1	3	1	7
OG0004478	2	1	2	2	7
OG0004479	2	1	2	2	7
OG0004480	5	2	0	0	7
OG0004481	2	1	2	2	7
OG0004482	1	1	2	3	7
OG0004483	1	1	3	2	7
OG0004484	2	2	2	1	7
OG0004485	2	1	2	2	7
OG0004486	2	5	0	0	7
OG0004487	3	4	0	0	7
OG0004488	1	0	1	5	7
OG0004489	1	1	2	3	7
OG0004490	2	1	2	2	7
OG0004491	1	1	2	3	7
OG0004492	1	2	2	2	7
OG0004493	1	2	2	2	7
OG0004494	2	1	2	2	7
OG0004495	2	2	2	1	7
OG0004496	2	2	1	2	7
OG0004497	2	1	2	2	7
OG0004498	1	1	2	3	7
OG0004499	2	1	2	2	7
OG0004500	2	1	2	2	7
OG0004501	1	1	2	3	7
OG0004502	2	1	1	3	7
OG0004503	1	1	3	2	7
OG0004504	2	1	2	2	7
OG0004505	3	2	1	1	7
OG0004506	2	1	2	2	7
OG0004507	1	1	2	3	7
OG0004508	1	0	2	4	7
OG0004509	3	2	1	1	7
OG0004510	2	1	2	2	7
OG0004511	1	1	1	4	7
OG0004512	1	2	3	1	7
OG0004513	1	1	2	3	7
OG0004514	7	0	0	0	7
OG0004515	2	1	2	2	7
OG0004516	2	1	3	1	7
OG0004517	1	1	1	4	7
OG0004518	1	1	1	4	7
OG0004519	2	1	2	2	7
OG0004520	2	1	1	3	7
OG0004521	1	1	2	3	7
OG0004522	1	1	2	3	7
OG0004523	1	1	3	2	7
OG0004524	1	1	1	4	7
OG0004525	1	1	2	3	7
OG0004526	2	1	3	1	7
OG0004527	1	6	0	0	7
OG0004528	2	1	2	2	7
OG0004529	1	1	3	2	7
OG0004530	1	2	2	2	7
OG0004531	2	2	2	1	7
OG0004532	1	1	1	4	7
OG0004533	3	2	1	1	7
OG0004534	1	2	4	0	7
OG0004535	1	2	1	3	7
OG0004536	2	1	1	3	7
OG0004537	2	1	3	1	7
OG0004538	1	1	3	2	7
OG0004539	2	1	2	2	7
OG0004540	7	0	0	0	7
OG0004541	1	1	3	2	7
OG0004542	3	1	1	2	7
OG0004543	1	2	1	3	7
OG0004544	1	1	2	3	7
OG0004545	1	2	2	2	7
OG0004546	2	1	2	2	7
OG0004547	1	6	0	0	7
OG0004548	2	3	1	1	7
OG0004549	2	1	3	1	7
OG0004550	2	2	2	1	7
OG0004551	2	1	3	1	7
OG0004552	3	4	0	0	7
OG0004553	1	0	3	3	7
OG0004554	7	0	0	0	7
OG0004555	1	1	2	3	7
OG0004556	5	2	0	0	7
OG0004557	1	1	3	2	7
OG0004558	1	1	2	3	7
OG0004559	1	2	1	3	7
OG0004560	1	1	1	4	7
OG0004561	4	1	1	1	7
OG0004562	7	0	0	0	7
OG0004563	1	1	2	3	7
OG0004564	1	1	2	3	7
OG0004565	2	1	2	2	7
OG0004566	2	1	2	2	7
OG0004567	2	2	1	2	7
OG0004568	4	2	0	1	7
OG0004569	2	5	0	0	7
OG0004570	2	2	1	2	7
OG0004571	1	1	2	3	7
OG0004572	4	1	1	1	7
OG0004573	2	1	3	1	7
OG0004574	1	5	1	0	7
OG0004575	3	2	1	1	7
OG0004576	1	1	3	2	7
OG0004577	1	1	2	3	7
OG0004578	1	1	1	4	7
OG0004579	1	6	0	0	7
OG0004580	4	1	1	1	7
OG0004581	2	2	2	1	7
OG0004582	4	2	0	1	7
OG0004583	1	1	2	3	7
OG0004584	1	2	2	2	7
OG0004585	1	5	1	0	7
OG0004586	2	1	1	3	7
OG0004587	3	1	1	2	7
OG0004588	1	1	4	1	7
OG0004589	1	1	3	2	7
OG0004590	2	5	0	0	7
OG0004591	5	0	1	1	7
OG0004592	2	2	1	2	7
OG0004593	1	1	1	4	7
OG0004594	1	1	3	2	7
OG0004595	1	1	2	3	7
OG0004596	1	1	3	2	7
OG0004597	1	0	3	3	7
OG0004598	1	1	3	2	7
OG0004599	2	5	0	0	7
OG0004600	1	1	2	3	7
OG0004601	2	1	2	2	7
OG0004602	2	1	2	2	7
OG0004603	1	1	2	3	7
OG0004604	1	1	2	3	7
OG0004605	1	1	2	3	7
OG0004606	1	1	2	3	7
OG0004607	3	0	1	3	7
OG0004608	1	1	2	3	7
OG0004609	1	1	2	3	7
OG0004610	1	1	2	3	7
OG0004611	1	2	1	3	7
OG0004612	2	1	2	2	7
OG0004613	2	1	2	2	7
OG0004614	1	2	3	1	7
OG0004615	1	1	1	4	7
OG0004616	2	1	2	2	7
OG0004617	1	1	1	4	7
OG0004618	1	1	2	3	7
OG0004619	2	0	3	2	7
OG0004620	1	3	2	1	7
OG0004621	1	1	1	4	7
OG0004622	2	2	1	2	7
OG0004623	3	1	1	2	7
OG0004624	1	1	1	4	7
OG0004625	2	1	2	2	7
OG0004626	1	1	3	2	7
OG0004627	1	1	2	3	7
OG0004628	2	2	1	2	7
OG0004629	1	1	2	3	7
OG0004630	1	1	3	2	7
OG0004631	2	1	1	3	7
OG0004632	1	1	2	3	7
OG0004633	1	1	3	2	7
OG0004634	1	1	2	3	7
OG0004635	1	2	3	1	7
OG0004636	1	1	3	2	7
OG0004637	1	1	2	3	7
OG0004638	1	1	3	2	7
OG0004639	2	1	1	3	7
OG0004640	1	1	3	2	7
OG0004641	1	2	2	2	7
OG0004642	1	1	2	3	7
OG0004643	1	1	3	2	7
OG0004644	2	1	2	2	7
OG0004645	3	1	2	1	7
OG0004646	1	1	2	3	7
OG0004647	4	1	1	1	7
OG0004648	1	0	3	3	7
OG0004649	2	1	2	2	7
OG0004650	2	3	1	1	7
OG0004651	2	1	2	2	7
OG0004652	1	1	3	2	7
OG0004653	1	1	1	4	7
OG0004654	1	1	3	2	7
OG0004655	1	1	2	3	7
OG0004656	3	2	0	2	7
OG0004657	2	1	2	2	7
OG0004658	2	2	1	2	7
OG0004659	1	1	3	2	7
OG0004660	1	1	3	2	7
OG0004661	1	1	2	3	7
OG0004662	1	1	4	1	7
OG0004663	1	1	3	2	7
OG0004664	6	1	0	0	7
OG0004665	1	1	1	4	7
OG0004666	2	1	2	2	7
OG0004667	1	1	3	2	7
OG0004668	2	1	1	3	7
OG0004669	3	2	1	1	7
OG0004670	2	1	2	2	7
OG0004671	1	1	3	2	7
OG0004672	2	1	2	2	7
OG0004673	2	1	2	2	7
OG0004674	1	1	3	2	7
OG0004675	1	1	1	4	7
OG0004676	1	1	3	2	7
OG0004677	2	0	2	3	7
OG0004678	1	2	2	2	7
OG0004679	1	0	1	5	7
OG0004680	3	2	1	1	7
OG0004681	3	2	1	1	7
OG0004682	3	3	1	0	7
OG0004683	2	1	2	2	7
OG0004684	2	1	2	2	7
OG0004685	1	0	3	3	7
OG0004686	3	1	2	1	7
OG0004687	1	1	1	4	7
OG0004688	1	1	2	3	7
OG0004689	3	2	2	0	7
OG0004690	4	3	0	0	7
OG0004691	2	1	2	2	7
OG0004692	1	6	0	0	7
OG0004693	1	1	4	1	7
OG0004694	1	1	3	2	7
OG0004695	2	1	2	2	7
OG0004696	1	2	2	2	7
OG0004697	3	4	0	0	7
OG0004698	2	1	1	3	7
OG0004699	2	4	0	1	7
OG0004700	3	4	0	0	7
OG0004701	3	3	1	0	7
OG0004702	3	4	0	0	7
OG0004703	1	6	0	0	7
OG0004704	5	2	0	0	7
OG0004705	1	1	2	3	7
OG0004706	2	1	2	2	7
OG0004707	2	5	0	0	7
OG0004708	1	4	1	1	7
OG0004709	2	2	2	1	7
OG0004710	1	1	2	3	7
OG0004711	1	3	1	2	7
OG0004712	2	1	3	1	7
OG0004713	2	1	2	2	7
OG0004714	2	2	1	2	7
OG0004715	1	6	0	0	7
OG0004716	1	1	2	3	7
OG0004717	3	1	2	1	7
OG0004718	2	1	2	2	7
OG0004719	1	6	0	0	7
OG0004720	1	1	1	4	7
OG0004721	1	1	3	2	7
OG0004722	2	0	5	0	7
OG0004723	2	1	1	3	7
OG0004724	2	1	1	3	7
OG0004725	2	1	2	2	7
OG0004726	2	1	2	2	7
OG0004727	1	1	2	3	7
OG0004728	1	1	1	4	7
OG0004729	1	1	2	3	7
OG0004730	2	3	1	1	7
OG0004731	3	1	2	1	7
OG0004732	2	1	1	3	7
OG0004733	3	2	1	1	7
OG0004734	1	0	4	2	7
OG0004735	1	1	2	3	7
OG0004736	1	1	3	2	7
OG0004737	1	1	2	3	7
OG0004738	2	1	2	2	7
OG0004739	2	3	1	1	7
OG0004740	1	1	2	3	7
OG0004741	1	1	1	4	7
OG0004742	2	2	2	1	7
OG0004743	2	1	1	3	7
OG0004744	2	2	1	2	7
OG0004745	1	1	3	2	7
OG0004746	4	2	0	1	7
OG0004747	1	1	3	2	7
OG0004748	1	2	3	1	7
OG0004749	2	1	1	3	7
OG0004750	1	1	3	2	7
OG0004751	2	2	1	2	7
OG0004752	2	1	2	2	7
OG0004753	2	1	2	2	7
OG0004754	2	1	2	2	7
OG0004755	1	3	2	1	7
OG0004756	1	1	2	3	7
OG0004757	2	1	2	2	7
OG0004758	2	1	2	2	7
OG0004759	2	3	1	1	7
OG0004760	1	1	5	0	7
OG0004761	7	0	0	0	7
OG0004762	1	1	2	3	7
OG0004763	1	1	1	4	7
OG0004764	1	3	2	1	7
OG0004765	2	1	2	2	7
OG0004766	2	1	3	1	7
OG0004767	3	1	1	2	7
OG0004768	5	2	0	0	7
OG0004769	1	2	2	2	7
OG0004770	2	1	3	1	7
OG0004771	3	2	1	1	7
OG0004772	1	1	4	1	7
OG0004773	1	1	2	3	7
OG0004774	1	1	3	2	7
OG0004775	3	0	2	2	7
OG0004776	7	0	0	0	7
OG0004777	4	1	1	1	7
OG0004778	1	2	2	2	7
OG0004779	1	1	4	1	7
OG0004780	1	6	0	0	7
OG0004781	2	2	1	2	7
OG0004782	2	1	1	3	7
OG0004783	2	1	1	3	7
OG0004784	2	1	2	2	7
OG0004785	1	6	0	0	7
OG0004786	1	1	3	2	7
OG0004787	1	1	2	3	7
OG0004788	2	1	2	2	7
OG0004789	3	2	1	1	7
OG0004790	1	1	1	4	7
OG0004791	3	3	1	0	7
OG0004792	2	1	2	2	7
OG0004793	2	2	2	1	7
OG0004794	2	2	2	1	7
OG0004795	2	3	1	1	7
OG0004796	1	2	1	3	7
OG0004797	1	1	2	3	7
OG0004798	2	1	2	2	7
OG0004799	2	2	1	2	7
OG0004800	2	2	2	1	7
OG0004801	2	1	2	2	7
OG0004802	2	3	1	1	7
OG0004803	1	1	3	2	7
OG0004804	2	1	2	2	7
OG0004805	3	2	1	1	7
OG0004806	2	1	2	2	7
OG0004807	1	1	3	2	7
OG0004808	1	1	3	2	7
OG0004809	2	1	2	2	7
OG0004810	1	6	0	0	7
OG0004811	1	1	4	1	7
OG0004812	1	1	3	2	7
OG0004813	2	0	2	3	7
OG0004814	1	1	1	4	7
OG0004815	1	1	2	3	7
OG0004816	1	1	1	4	7
OG0004817	1	1	2	3	7
OG0004818	1	1	2	3	7
OG0004819	1	1	1	4	7
OG0004820	1	1	2	3	7
OG0004821	4	1	1	1	7
OG0004822	1	1	3	2	7
OG0004823	1	1	2	3	7
OG0004824	2	1	2	2	7
OG0004825	1	1	2	3	7
OG0004826	3	2	1	1	7
OG0004827	1	1	2	3	7
OG0004828	1	1	1	4	7
OG0004829	1	1	2	3	7
OG0004830	1	1	3	2	7
OG0004831	1	1	2	3	7
OG0004832	2	1	2	2	7
OG0004833	1	1	2	3	7
OG0004834	1	1	2	3	7
OG0004835	2	1	2	2	7
OG0004836	3	2	1	1	7
OG0004837	2	1	2	2	7
OG0004838	2	1	2	2	7
OG0004839	1	1	2	3	7
OG0004840	1	1	1	4	7
OG0004841	2	2	1	2	7
OG0004842	1	1	2	3	7
OG0004843	1	1	1	4	7
OG0004844	4	2	0	1	7
OG0004845	1	3	2	1	7
OG0004846	1	1	1	4	7
OG0004847	1	1	2	3	7
OG0004848	2	1	3	1	7
OG0004849	1	1	1	4	7
OG0004850	1	2	3	1	7
OG0004851	1	1	4	1	7
OG0004852	1	1	1	4	7
OG0004853	2	3	1	1	7
OG0004854	1	1	3	2	7
OG0004855	2	1	2	2	7
OG0004856	1	1	2	3	7
OG0004857	1	1	2	3	7
OG0004858	1	1	1	4	7
OG0004859	1	1	4	1	7
OG0004860	2	1	2	2	7
OG0004861	2	1	3	1	7
OG0004862	2	1	3	1	7
OG0004863	1	0	4	2	7
OG0004864	1	1	2	3	7
OG0004865	2	2	2	1	7
OG0004866	1	1	2	3	7
OG0004867	3	0	2	2	7
OG0004868	2	1	2	2	7
OG0004869	1	1	3	2	7
OG0004870	1	1	2	3	7
OG0004871	2	2	1	2	7
OG0004872	2	1	2	2	7
OG0004873	2	1	3	1	7
OG0004874	2	1	1	3	7
OG0004875	2	3	1	1	7
OG0004876	2	1	2	2	7
OG0004877	2	1	2	2	7
OG0004878	1	1	3	2	7
OG0004879	2	1	2	2	7
OG0004880	1	1	3	2	7
OG0004881	2	2	2	1	7
OG0004882	1	3	1	2	7
OG0004883	1	1	3	2	7
OG0004884	1	1	4	1	7
OG0004885	1	1	4	1	7
OG0004886	1	1	3	2	7
OG0004887	3	3	0	1	7
OG0004888	1	1	0	5	7
OG0004889	2	1	3	1	7
OG0004890	2	1	2	2	7
OG0004891	2	1	2	2	7
OG0004892	1	1	2	3	7
OG0004893	1	0	0	6	7
OG0004894	1	2	2	2	7
OG0004895	2	2	2	1	7
OG0004896	1	1	2	3	7
OG0004897	2	1	2	2	7
OG0004898	1	1	2	3	7
OG0004899	2	1	2	2	7
OG0004900	1	6	0	0	7
OG0004901	1	1	3	2	7
OG0004902	2	2	1	2	7
OG0004903	2	1	2	2	7
OG0004904	2	2	2	1	7
OG0004905	1	1	2	3	7
OG0004906	1	1	3	2	7
OG0004907	1	1	3	2	7
OG0004908	1	1	2	3	7
OG0004909	1	1	2	3	7
OG0004910	2	1	2	2	7
OG0004911	3	4	0	0	7
OG0004912	1	1	2	3	7
OG0004913	6	1	0	0	7
OG0004914	1	1	2	3	7
OG0004915	1	1	1	4	7
OG0004916	2	1	2	2	7
OG0004917	2	1	3	1	7
OG0004918	2	1	2	2	7
OG0004919	1	1	4	1	7
OG0004920	1	1	3	2	7
OG0004921	2	1	3	1	7
OG0004922	3	2	2	0	7
OG0004923	4	2	1	0	7
OG0004924	4	1	1	1	7
OG0004925	2	1	1	3	7
OG0004926	1	1	2	3	7
OG0004927	1	1	2	3	7
OG0004928	1	2	2	2	7
OG0004929	1	1	3	2	7
OG0004930	1	1	3	2	7
OG0004931	1	1	3	2	7
OG0004932	1	1	2	3	7
OG0004933	2	1	2	2	7
OG0004934	1	0	0	6	7
OG0004935	1	1	2	3	7
OG0004936	2	3	1	1	7
OG0004937	1	1	5	0	7
OG0004938	1	1	2	3	7
OG0004939	1	1	2	3	7
OG0004940	2	1	3	1	7
OG0004941	1	1	2	3	7
OG0004942	2	1	2	2	7
OG0004943	1	1	3	2	7
OG0004944	2	1	2	2	7
OG0004945	1	1	3	2	7
OG0004946	1	2	1	3	7
OG0004947	2	3	1	1	7
OG0004948	2	1	2	2	7
OG0004949	2	2	1	2	7
OG0004950	2	1	1	3	7
OG0004951	1	1	2	3	7
OG0004952	2	1	2	2	7
OG0004953	4	3	0	0	7
OG0004954	1	1	3	2	7
OG0004955	1	1	2	3	7
OG0004956	1	1	2	3	7
OG0004957	2	5	0	0	7
OG0004958	1	1	1	4	7
OG0004959	1	1	3	2	7
OG0004960	2	1	2	2	7
OG0004961	3	2	1	1	7
OG0004962	1	1	2	3	7
OG0004963	2	1	2	2	7
OG0004964	1	1	4	1	7
OG0004965	1	1	1	4	7
OG0004966	7	0	0	0	7
OG0004967	1	1	3	2	7
OG0004968	3	2	1	1	7
OG0004969	1	1	2	3	7
OG0004970	2	2	1	2	7
OG0004971	1	1	2	3	7
OG0004972	1	1	3	2	7
OG0004973	1	1	1	4	7
OG0004974	1	1	3	2	7
OG0004975	2	2	2	1	7
OG0004976	2	1	2	2	7
OG0004977	2	2	2	1	7
OG0004978	1	2	2	2	7
OG0004979	2	2	1	2	7
OG0004980	4	2	1	0	7
OG0004981	1	1	3	2	7
OG0004982	2	3	1	1	7
OG0004983	1	1	2	3	7
OG0004984	1	1	2	3	7
OG0004985	2	3	1	1	7
OG0004986	1	1	2	3	7
OG0004987	1	1	2	3	7
OG0004988	5	2	0	0	7
OG0004989	4	3	0	0	7
OG0004990	1	2	3	1	7
OG0004991	1	1	2	3	7
OG0004992	2	1	2	2	7
OG0004993	1	1	3	2	7
OG0004994	3	1	2	1	7
OG0004995	2	1	3	1	7
OG0004996	1	0	3	3	7
OG0004997	2	1	2	2	7
OG0004998	1	1	3	2	7
OG0004999	2	5	0	0	7
OG0005000	1	5	0	1	7
OG0005001	2	1	2	2	7
OG0005002	2	0	2	3	7
OG0005003	3	1	0	3	7
OG0005004	1	0	0	6	7
OG0005005	2	2	1	2	7
OG0005006	1	1	4	1	7
OG0005007	3	2	1	1	7
OG0005008	1	1	1	4	7
OG0005009	1	1	1	4	7
OG0005010	1	1	3	2	7
OG0005011	2	1	2	2	7
OG0005012	1	1	2	3	7
OG0005013	2	0	2	3	7
OG0005014	2	1	2	2	7
OG0005015	1	1	1	4	7
OG0005016	3	2	1	1	7
OG0005017	2	1	1	3	7
OG0005018	1	1	3	2	7
OG0005019	1	1	2	3	7
OG0005020	1	1	2	3	7
OG0005021	2	1	1	3	7
OG0005022	2	1	2	2	7
OG0005023	1	1	1	4	7
OG0005024	2	1	1	3	7
OG0005025	1	1	2	3	7
OG0005026	1	1	3	2	7
OG0005027	1	1	1	4	7
OG0005028	1	2	1	3	7
OG0005029	1	1	1	4	7
OG0005030	1	1	2	3	7
OG0005031	3	1	2	1	7
OG0005032	2	2	2	1	7
OG0005033	2	1	2	2	7
OG0005034	1	1	3	2	7
OG0005035	1	1	3	2	7
OG0005036	2	1	2	2	7
OG0005037	1	6	0	0	7
OG0005038	4	1	1	1	7
OG0005039	2	1	3	1	7
OG0005040	1	1	2	3	7
OG0005041	1	0	2	4	7
OG0005042	1	1	2	3	7
OG0005043	1	2	3	1	7
OG0005044	3	2	1	1	7
OG0005045	2	1	2	2	7
OG0005046	2	2	2	1	7
OG0005047	3	3	0	1	7
OG0005048	1	5	1	0	7
OG0005049	2	1	2	2	7
OG0005050	2	1	3	1	7
OG0005051	1	1	3	2	7
OG0005052	1	3	2	1	7
OG0005053	2	1	2	2	7
OG0005054	1	1	3	2	7
OG0005055	2	1	2	2	7
OG0005056	1	1	2	3	7
OG0005057	1	1	4	1	7
OG0005058	3	1	2	1	7
OG0005059	2	1	3	1	7
OG0005060	3	1	2	1	7
OG0005061	2	1	2	2	7
OG0005062	1	5	0	1	7
OG0005063	1	1	4	1	7
OG0005064	1	1	2	3	7
OG0005065	2	1	2	2	7
OG0005066	1	1	1	4	7
OG0005067	2	1	3	1	7
OG0005068	3	1	2	1	7
OG0005069	2	2	1	2	7
OG0005070	1	1	3	2	7
OG0005071	1	1	2	3	7
OG0005072	1	2	1	3	7
OG0005073	1	2	3	1	7
OG0005074	2	1	1	3	7
OG0005075	1	2	2	2	7
OG0005076	1	1	1	4	7
OG0005077	1	1	2	3	7
OG0005078	1	1	4	1	7
OG0005079	1	1	2	3	7
OG0005080	3	2	1	1	7
OG0005081	3	2	1	1	7
OG0005082	3	2	1	1	7
OG0005083	2	1	1	3	7
OG0005084	2	2	1	2	7
OG0005085	1	1	2	3	7
OG0005086	1	1	1	4	7
OG0005087	1	1	2	3	7
OG0005088	1	1	3	2	7
OG0005089	1	1	3	2	7
OG0005090	1	1	3	2	7
OG0005091	1	1	2	3	7
OG0005092	4	1	1	1	7
OG0005093	1	1	3	2	7
OG0005094	2	1	2	2	7
OG0005095	2	2	2	1	7
OG0005096	1	1	4	1	7
OG0005097	1	1	2	3	7
OG0005098	1	1	2	3	7
OG0005099	2	1	2	2	7
OG0005100	2	1	1	3	7
OG0005101	1	1	3	2	7
OG0005102	1	1	3	2	7
OG0005103	3	1	2	1	7
OG0005104	2	5	0	0	7
OG0005105	1	1	4	1	7
OG0005106	2	1	2	2	7
OG0005107	1	1	2	3	7
OG0005108	3	1	2	1	7
OG0005109	2	2	1	2	7
OG0005110	2	0	3	2	7
OG0005111	1	1	2	3	7
OG0005112	3	4	0	0	7
OG0005113	1	1	1	4	7
OG0005114	2	1	1	3	7
OG0005115	1	1	3	2	7
OG0005116	1	1	3	2	7
OG0005117	1	1	4	1	7
OG0005118	2	1	2	2	7
OG0005119	2	1	2	2	7
OG0005120	1	4	1	1	7
OG0005121	1	1	2	3	7
OG0005122	1	1	2	3	7
OG0005123	2	1	3	1	7
OG0005124	2	1	2	2	7
OG0005125	2	1	2	2	7
OG0005126	1	1	2	3	7
OG0005127	1	1	3	2	7
OG0005128	1	1	3	2	7
OG0005129	2	1	2	2	7
OG0005130	1	1	3	2	7
OG0005131	2	1	2	2	7
OG0005132	1	1	4	1	7
OG0005133	1	1	1	4	7
OG0005134	1	1	2	3	7
OG0005135	2	1	2	2	7
OG0005136	2	1	1	3	7
OG0005137	1	1	1	4	7
OG0005138	1	1	3	2	7
OG0005139	1	1	3	2	7
OG0005140	2	1	2	2	7
OG0005141	1	1	2	3	7
OG0005142	2	1	2	2	7
OG0005143	1	1	2	3	7
OG0005144	2	1	1	3	7
OG0005145	3	0	2	2	7
OG0005146	2	1	2	2	7
OG0005147	1	1	3	2	7
OG0005148	2	2	1	2	7
OG0005149	1	1	1	4	7
OG0005150	4	1	1	1	7
OG0005151	1	1	1	4	7
OG0005152	3	1	2	1	7
OG0005153	1	1	2	3	7
OG0005154	4	1	1	1	7
OG0005155	1	1	3	2	7
OG0005156	1	1	4	1	7
OG0005157	1	1	2	3	7
OG0005158	2	2	1	2	7
OG0005159	1	1	2	3	7
OG0005160	1	1	2	3	7
OG0005161	2	1	2	2	7
OG0005162	2	2	1	2	7
OG0005163	1	1	3	2	7
OG0005164	1	1	3	2	7
OG0005165	2	5	0	0	7
OG0005166	1	1	1	4	7
OG0005167	1	1	1	4	7
OG0005168	1	1	4	1	7
OG0005169	1	1	2	3	7
OG0005170	1	1	2	3	7
OG0005171	1	1	2	3	7
OG0005172	2	2	2	1	7
OG0005173	2	1	2	2	7
OG0005174	2	1	2	2	7
OG0005175	2	1	2	2	7
OG0005176	1	1	2	3	7
OG0005177	3	2	1	1	7
OG0005178	2	2	1	2	7
OG0005179	1	1	3	2	7
OG0005180	2	1	2	2	7
OG0005181	3	2	1	1	7
OG0005182	1	1	2	3	7
OG0005183	2	1	2	2	7
OG0005184	2	1	2	2	7
OG0005185	1	2	2	2	7
OG0005186	1	1	3	2	7
OG0005187	2	2	1	2	7
OG0005188	1	1	1	4	7
OG0005189	2	1	2	2	7
OG0005190	1	1	2	3	7
OG0005191	1	1	3	2	7
OG0005192	1	1	1	4	7
OG0005193	1	1	2	3	7
OG0005194	1	3	1	2	7
OG0005195	1	1	3	2	7
OG0005196	2	1	2	2	7
OG0005197	1	1	2	3	7
OG0005198	2	1	2	2	7
OG0005199	1	1	2	3	7
OG0005200	1	1	2	3	7
OG0005201	2	1	2	2	7
OG0005202	1	1	2	3	7
OG0005203	2	1	3	1	7
OG0005204	1	1	2	3	7
OG0005205	1	1	3	2	7
OG0005206	1	1	3	2	7
OG0005207	1	1	3	2	7
OG0005208	1	1	2	3	7
OG0005209	1	1	2	3	7
OG0005210	2	1	2	2	7
OG0005211	1	1	2	3	7
OG0005212	3	1	1	2	7
OG0005213	3	1	2	1	7
OG0005214	1	1	2	3	7
OG0005215	2	2	2	1	7
OG0005216	1	1	3	2	7
OG0005217	3	1	1	2	7
OG0005218	2	5	0	0	7
OG0005219	2	1	1	3	7
OG0005220	1	1	2	3	7
OG0005221	3	1	1	2	7
OG0005222	1	2	3	1	7
OG0005223	1	0	4	2	7
OG0005224	1	6	0	0	7
OG0005225	3	1	2	1	7
OG0005226	1	1	3	2	7
OG0005227	2	1	1	3	7
OG0005228	1	1	1	4	7
OG0005229	2	4	0	1	7
OG0005230	2	1	2	2	7
OG0005231	1	1	2	3	7
OG0005232	1	1	3	2	7
OG0005233	1	6	0	0	7
OG0005234	3	1	2	1	7
OG0005235	1	1	2	3	7
OG0005236	1	1	2	3	7
OG0005237	1	1	3	2	7
OG0005238	3	3	0	1	7
OG0005239	2	1	2	2	7
OG0005240	1	0	3	3	7
OG0005241	2	1	2	2	7
OG0005242	2	1	2	2	7
OG0005243	1	1	1	4	7
OG0005244	2	3	1	1	7
OG0005245	2	1	2	2	7
OG0005246	2	1	1	3	7
OG0005247	1	6	0	0	7
OG0005248	1	1	2	3	7
OG0005249	2	1	2	2	7
OG0005250	1	1	3	2	7
OG0005251	1	0	4	2	7
OG0005252	2	1	2	2	7
OG0005253	1	1	3	2	7
OG0005254	1	1	4	1	7
OG0005255	1	1	3	2	7
OG0005256	1	1	2	3	7
OG0005257	1	1	2	3	7
OG0005258	2	2	2	1	7
OG0005259	1	1	3	2	7
OG0005260	1	1	3	2	7
OG0005261	2	3	1	1	7
OG0005262	2	1	2	2	7
OG0005263	1	1	2	3	7
OG0005264	1	1	2	3	7
OG0005265	1	1	1	4	7
OG0005266	2	1	2	2	7
OG0005267	1	1	2	3	7
OG0005268	1	1	2	3	7
OG0005269	1	1	2	3	7
OG0005270	1	1	2	3	7
OG0005271	2	1	2	2	7
OG0005272	2	1	2	2	7
OG0005273	1	1	1	4	7
OG0005274	2	1	2	2	7
OG0005275	1	1	3	2	7
OG0005276	2	1	2	2	7
OG0005277	1	1	4	1	7
OG0005278	1	6	0	0	7
OG0005279	1	1	3	2	7
OG0005280	2	1	3	1	7
OG0005281	6	1	0	0	7
OG0005282	1	1	2	3	7
OG0005283	1	1	3	2	7
OG0005284	2	1	2	2	7
OG0005285	2	1	2	2	7
OG0005286	1	1	3	2	7
OG0005287	4	3	0	0	7
OG0005288	2	1	3	1	7
OG0005289	1	1	3	2	7
OG0005290	1	1	2	3	7
OG0005291	1	1	2	3	7
OG0005292	1	1	2	3	7
OG0005293	1	1	3	2	7
OG0005294	3	1	2	1	7
OG0005295	1	1	2	3	7
OG0005296	1	1	3	2	7
OG0005297	1	4	1	1	7
OG0005298	1	1	2	3	7
OG0005299	1	2	1	3	7
OG0005300	1	2	1	3	7
OG0005301	1	0	2	4	7
OG0005302	3	1	2	1	7
OG0005303	1	1	4	1	7
OG0005304	1	1	2	3	7
OG0005305	1	1	2	3	7
OG0005306	1	1	3	2	7
OG0005307	1	1	4	1	7
OG0005308	1	1	4	1	7
OG0005309	1	1	1	4	7
OG0005310	1	1	2	3	7
OG0005311	1	1	2	3	7
OG0005312	1	3	2	1	7
OG0005313	1	6	0	0	7
OG0005314	1	1	3	2	7
OG0005315	2	1	2	2	7
OG0005316	1	1	4	1	7
OG0005317	1	1	2	3	7
OG0005318	4	0	1	2	7
OG0005319	2	1	1	3	7
OG0005320	1	1	2	3	7
OG0005321	2	1	1	3	7
OG0005322	1	1	2	3	7
OG0005323	2	1	2	2	7
OG0005324	1	1	2	3	7
OG0005325	1	1	4	1	7
OG0005326	1	4	1	1	7
OG0005327	2	1	2	2	7
OG0005328	2	2	2	1	7
OG0005329	2	2	2	1	7
OG0005330	1	1	3	2	7
OG0005331	2	2	2	1	7
OG0005332	1	1	3	2	7
OG0005333	2	1	2	2	7
OG0005334	2	1	2	2	7
OG0005335	1	1	1	4	7
OG0005336	1	1	2	3	7
OG0005337	1	1	2	3	7
OG0005338	1	1	3	2	7
OG0005339	1	1	2	3	7
OG0005340	1	1	3	2	7
OG0005341	1	1	2	3	7
OG0005342	1	1	1	4	7
OG0005343	2	3	1	1	7
OG0005344	1	1	3	2	7
OG0005345	1	1	2	3	7
OG0005346	1	1	2	3	7
OG0005347	1	1	2	3	7
OG0005348	1	1	1	4	7
OG0005349	1	1	2	3	7
OG0005350	2	2	2	1	7
OG0005351	2	1	2	2	7
OG0005352	1	1	3	2	7
OG0005353	2	2	1	2	7
OG0005354	1	1	2	3	7
OG0005355	1	1	2	3	7
OG0005356	1	1	4	1	7
OG0005357	1	1	3	2	7
OG0005358	2	1	2	2	7
OG0005359	2	1	2	2	7
OG0005360	2	1	2	2	7
OG0005361	2	2	2	1	7
OG0005362	1	1	2	3	7
OG0005363	1	1	1	4	7
OG0005364	4	3	0	0	7
OG0005365	2	1	3	1	7
OG0005366	2	1	1	3	7
OG0005367	2	1	2	2	7
OG0005368	1	1	2	3	7
OG0005369	1	0	1	5	7
OG0005370	1	1	1	4	7
OG0005371	1	1	3	2	7
OG0005372	1	1	2	3	7
OG0005373	1	1	1	4	7
OG0005374	1	1	2	3	7
OG0005375	2	2	1	2	7
OG0005376	1	6	0	0	7
OG0005377	2	1	3	1	7
OG0005378	2	0	3	2	7
OG0005379	2	1	3	1	7
OG0005380	1	4	0	2	7
OG0005381	2	1	2	2	7
OG0005382	1	1	1	4	7
OG0005383	1	1	4	1	7
OG0005384	2	2	1	2	7
OG0005385	1	2	2	2	7
OG0005386	1	1	2	3	7
OG0005387	1	1	3	2	7
OG0005388	1	1	3	2	7
OG0005389	2	1	2	2	7
OG0005390	4	1	1	1	7
OG0005391	1	2	3	1	7
OG0005392	1	1	3	2	7
OG0005393	1	2	2	2	7
OG0005394	3	1	1	2	7
OG0005395	1	1	3	2	7
OG0005396	2	1	2	2	7
OG0005397	3	2	1	1	7
OG0005398	1	1	3	2	7
OG0005399	1	1	1	4	7
OG0005400	2	2	2	1	7
OG0005401	3	1	1	2	7
OG0005402	1	1	3	2	7
OG0005403	2	0	3	2	7
OG0005404	2	2	1	2	7
OG0005405	2	1	2	2	7
OG0005406	1	1	2	3	7
OG0005407	3	1	1	2	7
OG0005408	1	1	3	2	7
OG0005409	2	1	2	2	7
OG0005410	1	1	2	3	7
OG0005411	2	2	2	1	7
OG0005412	1	4	1	1	7
OG0005413	1	1	1	4	7
OG0005414	1	1	3	2	7
OG0005415	1	6	0	0	7
OG0005416	1	1	2	3	7
OG0005417	2	1	2	2	7
OG0005418	1	0	4	2	7
OG0005419	1	1	4	1	7
OG0005420	3	2	1	1	7
OG0005421	2	3	1	1	7
OG0005422	2	1	3	1	7
OG0005423	1	1	1	4	7
OG0005424	1	1	2	3	7
OG0005425	1	2	2	2	7
OG0005426	1	1	3	2	7
OG0005427	1	1	3	2	7
OG0005428	2	1	2	2	7
OG0005429	1	1	2	3	7
OG0005430	1	6	0	0	7
OG0005431	1	5	1	0	7
OG0005432	1	1	3	2	7
OG0005433	2	1	2	2	7
OG0005434	1	1	1	4	7
OG0005435	1	1	2	3	7
OG0005436	1	1	2	3	7
OG0005437	1	1	4	1	7
OG0005438	2	2	2	1	7
OG0005439	1	1	4	1	7
OG0005440	1	3	1	2	7
OG0005441	1	1	2	3	7
OG0005442	1	1	3	2	7
OG0005443	1	1	3	2	7
OG0005444	1	1	2	3	7
OG0005445	2	1	2	2	7
OG0005446	1	1	1	4	7
OG0005447	2	1	1	3	7
OG0005448	1	0	2	4	7
OG0005449	1	1	4	1	7
OG0005450	1	1	1	4	7
OG0005451	1	1	3	2	7
OG0005452	1	1	3	2	7
OG0005453	1	1	2	3	7
OG0005454	2	1	2	2	7
OG0005455	1	1	5	0	7
OG0005456	2	1	2	2	7
OG0005457	1	1	3	2	7
OG0005458	1	1	2	3	7
OG0005459	1	1	3	2	7
OG0005460	2	1	2	2	7
OG0005461	1	1	4	1	7
OG0005462	1	1	2	3	7
OG0005463	2	3	1	1	7
OG0005464	1	1	3	2	7
OG0005465	1	2	1	3	7
OG0005466	1	1	3	2	7
OG0005467	2	0	3	2	7
OG0005468	1	1	3	2	7
OG0005469	1	1	1	4	7
OG0005470	2	1	2	2	7
OG0005471	4	1	1	1	7
OG0005472	1	1	1	4	7
OG0005473	1	1	3	2	7
OG0005474	2	1	2	2	7
OG0005475	2	1	2	2	7
OG0005476	1	1	4	1	7
OG0005477	1	1	1	4	7
OG0005478	1	3	1	2	7
OG0005479	2	2	1	2	7
OG0005480	2	2	2	1	7
OG0005481	2	1	3	1	7
OG0005482	1	1	2	3	7
OG0005483	2	1	2	2	7
OG0005484	1	1	1	4	7
OG0005485	1	1	3	2	7
OG0005486	2	1	2	2	7
OG0005487	2	1	2	2	7
OG0005488	1	4	1	1	7
OG0005489	1	1	2	3	7
OG0005490	1	1	2	3	7
OG0005491	1	1	1	4	7
OG0005492	1	1	2	3	7
OG0005493	1	1	2	3	7
OG0005494	3	2	1	1	7
OG0005495	1	0	3	3	7
OG0005496	2	1	2	2	7
OG0005497	2	2	2	1	7
OG0005498	2	1	2	2	7
OG0005499	3	1	1	2	7
OG0005500	1	1	3	2	7
OG0005501	1	2	2	2	7
OG0005502	1	1	2	3	7
OG0005503	2	1	2	2	7
OG0005504	1	1	4	1	7
OG0005505	2	3	1	1	7
OG0005506	1	1	1	4	7
OG0005507	2	1	2	2	7
OG0005508	2	1	2	2	7
OG0005509	2	1	2	2	7
OG0005510	1	1	1	4	7
OG0005511	1	1	2	3	7
OG0005512	1	1	2	3	7
OG0005513	1	1	3	2	7
OG0005514	2	1	3	1	7
OG0005515	1	1	2	3	7
OG0005516	2	1	2	2	7
OG0005517	1	1	3	2	7
OG0005518	1	1	3	2	7
OG0005519	2	1	3	1	7
OG0005520	1	1	3	2	7
OG0005521	1	1	3	2	7
OG0005522	1	1	3	2	7
OG0005523	1	1	3	2	7
OG0005524	1	1	2	3	7
OG0005525	1	2	3	1	7
OG0005526	1	1	1	4	7
OG0005527	3	1	1	2	7
OG0005528	2	2	1	2	7
OG0005529	1	1	3	2	7
OG0005530	1	2	2	2	7
OG0005531	1	1	4	1	7
OG0005532	1	1	2	3	7
OG0005533	1	1	2	3	7
OG0005534	2	3	1	1	7
OG0005535	1	1	3	2	7
OG0005536	1	1	3	2	7
OG0005537	3	1	2	1	7
OG0005538	2	1	2	2	7
OG0005539	1	1	1	4	7
OG0005540	2	1	0	4	7
OG0005541	1	4	1	1	7
OG0005542	1	6	0	0	7
OG0005543	1	2	3	1	7
OG0005544	4	2	1	0	7
OG0005545	1	1	2	3	7
OG0005546	2	1	2	2	7
OG0005547	2	1	2	2	7
OG0005548	2	1	2	2	7
OG0005549	1	1	2	3	7
OG0005550	2	1	2	2	7
OG0005551	1	2	2	2	7
OG0005552	2	1	2	2	7
OG0005553	1	2	2	2	7
OG0005554	2	2	2	1	7
OG0005555	1	1	2	3	7
OG0005556	2	1	1	3	7
OG0005557	2	1	0	4	7
OG0005558	1	1	2	3	7
OG0005559	1	1	2	3	7
OG0005560	1	1	2	3	7
OG0005561	1	1	3	2	7
OG0005562	1	1	3	2	7
OG0005563	2	2	2	1	7
OG0005564	1	1	2	3	7
OG0005565	2	1	2	2	7
OG0005566	1	1	3	2	7
OG0005567	2	1	3	1	7
OG0005568	1	1	2	3	7
OG0005569	1	1	4	1	7
OG0005570	1	1	3	2	7
OG0005571	1	1	3	2	7
OG0005572	2	1	2	2	7
OG0005573	2	3	1	1	7
OG0005574	1	1	1	4	7
OG0005575	1	0	4	2	7
OG0005576	2	1	3	1	7
OG0005577	1	1	4	1	7
OG0005578	1	2	2	2	7
OG0005579	2	1	2	2	7
OG0005580	1	1	3	2	7
OG0005581	1	0	1	5	7
OG0005582	1	1	3	2	7
OG0005583	1	1	3	2	7
OG0005584	1	1	3	2	7
OG0005585	1	1	1	4	7
OG0005586	1	1	2	3	7
OG0005587	1	1	3	2	7
OG0005588	1	1	1	4	7
OG0005589	2	1	1	3	7
OG0005590	1	1	2	3	7
OG0005591	2	1	2	2	7
OG0005592	1	1	3	2	7
OG0005593	1	1	3	2	7
OG0005594	2	1	2	2	7
OG0005595	1	1	3	2	7
OG0005596	1	1	3	2	7
OG0005597	1	1	2	3	7
OG0005598	1	1	3	2	7
OG0005599	1	1	2	3	7
OG0005600	1	1	4	1	7
OG0005601	4	1	1	1	7
OG0005602	2	1	2	2	7
OG0005603	2	1	1	3	7
OG0005604	2	2	1	2	7
OG0005605	1	2	2	2	7
OG0005606	2	1	2	2	7
OG0005607	1	1	1	4	7
OG0005608	2	3	1	1	7
OG0005609	1	2	2	2	7
OG0005610	2	1	2	2	7
OG0005611	2	1	3	1	7
OG0005612	1	5	0	1	7
OG0005613	1	1	2	3	7
OG0005614	1	1	2	3	7
OG0005615	1	1	3	2	7
OG0005616	2	1	2	2	7
OG0005617	2	3	1	1	7
OG0005618	1	1	2	3	7
OG0005619	2	1	2	2	7
OG0005620	1	1	4	1	7
OG0005621	3	1	2	1	7
OG0005622	1	6	0	0	7
OG0005623	1	1	4	1	7
OG0005624	2	1	2	2	7
OG0005625	2	1	2	2	7
OG0005626	1	1	2	3	7
OG0005627	1	1	3	2	7
OG0005628	2	1	3	1	7
OG0005629	1	2	2	2	7
OG0005630	1	1	4	1	7
OG0005631	1	1	2	3	7
OG0005632	1	2	3	1	7
OG0005633	1	1	4	1	7
OG0005634	1	1	1	4	7
OG0005635	0	7	0	0	7
OG0005636	0	7	0	0	7
OG0005637	0	7	0	0	7
OG0005638	0	7	0	0	7
OG0005639	0	7	0	0	7
OG0005640	0	7	0	0	7
OG0005641	0	7	0	0	7
OG0005642	0	7	0	0	7
OG0005643	0	7	0	0	7
OG0005644	0	7	0	0	7
OG0005645	0	7	0	0	7
OG0005646	0	7	0	0	7
OG0005647	0	7	0	0	7
OG0005648	0	6	0	1	7
OG0005649	0	7	0	0	7
OG0005650	0	7	0	0	7
OG0005651	0	7	0	0	7
OG0005652	0	7	0	0	7
OG0005653	0	7	0	0	7
OG0005654	0	7	0	0	7
OG0005655	0	7	0	0	7
OG0005656	0	7	0	0	7
OG0005657	0	7	0	0	7
OG0005658	0	7	0	0	7
OG0005659	0	7	0	0	7
OG0005660	0	7	0	0	7
OG0005661	0	7	0	0	7
OG0005662	0	1	1	5	7
OG0005663	0	1	2	4	7
OG0005664	0	7	0	0	7
OG0005665	0	7	0	0	7
OG0005666	0	7	0	0	7
OG0005667	0	7	0	0	7
OG0005668	0	7	0	0	7
OG0005669	0	7	0	0	7
OG0005670	0	7	0	0	7
OG0005671	0	7	0	0	7
OG0005672	0	7	0	0	7
OG0005673	0	7	0	0	7
OG0005674	0	7	0	0	7
OG0005675	0	7	0	0	7
OG0005676	0	7	0	0	7
OG0005677	0	7	0	0	7
OG0005678	0	7	0	0	7
OG0005679	0	7	0	0	7
OG0005680	0	7	0	0	7
OG0005681	0	7	0	0	7
OG0005682	0	7	0	0	7
OG0005683	0	7	0	0	7
OG0005684	0	7	0	0	7
OG0005685	0	3	0	4	7
OG0005686	0	2	3	2	7
OG0005687	0	5	1	1	7
OG0005688	0	7	0	0	7
OG0005689	0	3	3	1	7
OG0005690	0	1	3	3	7
OG0005691	0	7	0	0	7
OG0005692	0	2	2	3	7
OG0005693	0	2	3	2	7
OG0005694	0	1	4	2	7
OG0005695	0	1	3	3	7
OG0005696	0	2	3	2	7
OG0005697	0	1	1	5	7
OG0005698	0	7	0	0	7
OG0005699	0	0	7	0	7
OG0005700	0	0	1	6	7
OG0005701	0	0	4	3	7
OG0005702	0	0	1	6	7
OG0005703	0	0	1	6	7
OG0005704	0	0	7	0	7
OG0005705	0	0	7	0	7
OG0005706	0	0	7	0	7
OG0005707	0	0	7	0	7
OG0005708	0	0	7	0	7
OG0005709	0	0	6	1	7
OG0005710	0	0	7	0	7
OG0005711	0	0	1	6	7
OG0005712	0	0	3	4	7
OG0005713	0	0	1	6	7
OG0005714	0	0	5	2	7
OG0005715	0	0	7	0	7
OG0005716	0	0	1	6	7
OG0005717	0	0	7	0	7
OG0005718	0	0	6	1	7
OG0005719	0	0	2	5	7
OG0005720	0	0	6	1	7
OG0005721	0	0	7	0	7
OG0005722	0	0	6	1	7
OG0005723	0	0	4	3	7
OG0005724	0	0	6	1	7
OG0005725	0	0	1	6	7
OG0005726	0	0	5	2	7
OG0005727	0	0	7	0	7
OG0005728	0	0	5	2	7
OG0005729	0	0	7	0	7
OG0005730	0	0	3	4	7
OG0005731	0	0	2	5	7
OG0005732	0	0	1	6	7
OG0005733	0	0	5	2	7
OG0005734	0	0	5	2	7
OG0005735	0	0	5	2	7
OG0005736	0	0	1	6	7
OG0005737	0	0	5	2	7
OG0005738	0	0	1	6	7
OG0005739	0	0	4	3	7
OG0005740	0	0	6	1	7
OG0005741	0	0	6	1	7
OG0005742	0	0	1	6	7
OG0005743	0	0	6	1	7
OG0005744	0	0	5	2	7
OG0005745	0	0	3	4	7
OG0005746	0	0	4	3	7
OG0005747	0	0	4	3	7
OG0005748	0	0	6	1	7
OG0005749	0	0	5	2	7
OG0005750	0	0	0	7	7
OG0005751	0	0	0	7	7
OG0005752	0	0	0	7	7
OG0005753	0	0	0	7	7
OG0005754	0	0	0	7	7
OG0005755	0	0	0	7	7
OG0005756	0	0	0	7	7
OG0005757	0	0	0	7	7
OG0005758	0	0	0	7	7
OG0005759	0	0	0	7	7
OG0005760	0	0	0	7	7
OG0005761	0	0	0	7	7
OG0005762	0	0	0	7	7
OG0005763	0	0	0	7	7
OG0005764	0	0	0	7	7
OG0005765	2	2	1	1	6
OG0005766	1	1	2	2	6
OG0005767	6	0	0	0	6
OG0005768	2	1	2	1	6
OG0005769	3	1	0	2	6
OG0005770	1	1	3	1	6
OG0005771	5	1	0	0	6
OG0005772	1	1	3	1	6
OG0005773	6	0	0	0	6
OG0005774	2	4	0	0	6
OG0005775	1	1	1	3	6
OG0005776	1	1	1	3	6
OG0005777	5	1	0	0	6
OG0005778	2	2	1	1	6
OG0005779	2	1	1	2	6
OG0005780	5	1	0	0	6
OG0005781	1	1	0	4	6
OG0005782	6	0	0	0	6
OG0005783	1	1	2	2	6
OG0005784	1	1	2	2	6
OG0005785	2	1	2	1	6
OG0005786	3	3	0	0	6
OG0005787	3	1	1	1	6
OG0005788	2	1	2	1	6
OG0005789	2	2	1	1	6
OG0005790	3	1	1	1	6
OG0005791	2	2	1	1	6
OG0005792	1	1	3	1	6
OG0005793	2	1	2	1	6
OG0005794	1	1	2	2	6
OG0005795	1	1	1	3	6
OG0005796	2	2	1	1	6
OG0005797	5	1	0	0	6
OG0005798	2	1	2	1	6
OG0005799	3	1	1	1	6
OG0005800	3	1	1	1	6
OG0005801	2	2	1	1	6
OG0005802	6	0	0	0	6
OG0005803	4	2	0	0	6
OG0005804	3	2	1	0	6
OG0005805	1	1	2	2	6
OG0005806	1	1	1	3	6
OG0005807	2	1	1	2	6
OG0005808	2	4	0	0	6
OG0005809	1	1	1	3	6
OG0005810	2	1	1	2	6
OG0005811	6	0	0	0	6
OG0005812	1	0	2	3	6
OG0005813	1	1	2	2	6
OG0005814	1	1	2	2	6
OG0005815	1	1	3	1	6
OG0005816	4	2	0	0	6
OG0005817	3	3	0	0	6
OG0005818	5	1	0	0	6
OG0005819	4	2	0	0	6
OG0005820	2	1	1	2	6
OG0005821	6	0	0	0	6
OG0005822	1	1	2	2	6
OG0005823	5	0	1	0	6
OG0005824	2	1	2	1	6
OG0005825	2	1	2	1	6
OG0005826	1	1	1	3	6
OG0005827	2	2	0	2	6
OG0005828	2	1	1	2	6
OG0005829	1	2	2	1	6
OG0005830	1	1	1	3	6
OG0005831	3	1	1	1	6
OG0005832	6	0	0	0	6
OG0005833	2	1	2	1	6
OG0005834	1	1	2	2	6
OG0005835	2	2	1	1	6
OG0005836	2	0	2	2	6
OG0005837	1	1	2	2	6
OG0005838	1	1	2	2	6
OG0005839	3	1	1	1	6
OG0005840	1	1	2	2	6
OG0005841	2	1	2	1	6
OG0005842	1	1	1	3	6
OG0005843	2	1	2	1	6
OG0005844	1	1	3	1	6
OG0005845	1	1	1	3	6
OG0005846	1	1	2	2	6
OG0005847	1	1	3	1	6
OG0005848	1	0	3	2	6
OG0005849	2	1	1	2	6
OG0005850	2	1	1	2	6
OG0005851	1	1	2	2	6
OG0005852	1	1	2	2	6
OG0005853	1	1	3	1	6
OG0005854	5	0	0	1	6
OG0005855	2	1	2	1	6
OG0005856	1	1	1	3	6
OG0005857	3	1	1	1	6
OG0005858	1	1	1	3	6
OG0005859	1	1	2	2	6
OG0005860	2	2	1	1	6
OG0005861	2	2	1	1	6
OG0005862	1	1	2	2	6
OG0005863	1	1	2	2	6
OG0005864	2	1	1	2	6
OG0005865	3	1	1	1	6
OG0005866	3	1	1	1	6
OG0005867	1	1	3	1	6
OG0005868	1	1	2	2	6
OG0005869	1	1	1	3	6
OG0005870	2	2	1	1	6
OG0005871	1	1	2	2	6
OG0005872	1	1	2	2	6
OG0005873	1	1	2	2	6
OG0005874	1	1	2	2	6
OG0005875	1	1	1	3	6
OG0005876	1	1	1	3	6
OG0005877	4	0	1	1	6
OG0005878	1	1	2	2	6
OG0005879	1	1	3	1	6
OG0005880	2	0	2	2	6
OG0005881	1	3	1	1	6
OG0005882	1	1	2	2	6
OG0005883	1	1	2	2	6
OG0005884	2	1	2	1	6
OG0005885	1	1	2	2	6
OG0005886	1	1	2	2	6
OG0005887	1	1	1	3	6
OG0005888	2	1	1	2	6
OG0005889	1	1	1	3	6
OG0005890	1	1	1	3	6
OG0005891	2	1	1	2	6
OG0005892	1	1	2	2	6
OG0005893	1	1	3	1	6
OG0005894	1	1	2	2	6
OG0005895	1	1	2	2	6
OG0005896	1	1	2	2	6
OG0005897	1	1	3	1	6
OG0005898	1	1	2	2	6
OG0005899	1	1	2	2	6
OG0005900	1	1	1	3	6
OG0005901	1	1	3	1	6
OG0005902	1	1	2	2	6
OG0005903	1	1	2	2	6
OG0005904	1	1	2	2	6
OG0005905	1	1	2	2	6
OG0005906	1	1	3	1	6
OG0005907	1	1	2	2	6
OG0005908	1	1	3	1	6
OG0005909	1	1	2	2	6
OG0005910	1	1	3	1	6
OG0005911	1	1	2	2	6
OG0005912	1	2	2	1	6
OG0005913	2	2	1	1	6
OG0005914	1	1	3	1	6
OG0005915	1	1	2	2	6
OG0005916	1	1	2	2	6
OG0005917	2	1	1	2	6
OG0005918	2	1	1	2	6
OG0005919	1	1	3	1	6
OG0005920	1	1	1	3	6
OG0005921	1	1	1	3	6
OG0005922	2	1	1	2	6
OG0005923	1	1	3	1	6
OG0005924	2	1	1	2	6
OG0005925	1	1	2	2	6
OG0005926	1	1	2	2	6
OG0005927	1	1	2	2	6
OG0005928	2	1	1	2	6
OG0005929	1	1	2	2	6
OG0005930	1	2	2	1	6
OG0005931	1	1	1	3	6
OG0005932	1	1	2	2	6
OG0005933	1	1	2	2	6
OG0005934	1	1	3	1	6
OG0005935	2	1	2	1	6
OG0005936	1	1	3	1	6
OG0005937	2	2	1	1	6
OG0005938	2	1	1	2	6
OG0005939	1	1	2	2	6
OG0005940	2	1	1	2	6
OG0005941	1	1	2	2	6
OG0005942	2	1	1	2	6
OG0005943	1	1	1	3	6
OG0005944	1	1	2	2	6
OG0005945	1	1	2	2	6
OG0005946	1	1	2	2	6
OG0005947	2	2	1	1	6
OG0005948	3	1	1	1	6
OG0005949	1	1	3	1	6
OG0005950	2	1	1	2	6
OG0005951	1	1	1	3	6
OG0005952	1	2	1	2	6
OG0005953	2	2	1	1	6
OG0005954	1	1	2	2	6
OG0005955	1	1	2	2	6
OG0005956	1	0	1	4	6
OG0005957	1	1	3	1	6
OG0005958	1	1	2	2	6
OG0005959	2	1	2	1	6
OG0005960	1	1	3	1	6
OG0005961	1	1	3	1	6
OG0005962	2	1	1	2	6
OG0005963	2	1	2	1	6
OG0005964	6	0	0	0	6
OG0005965	1	1	3	1	6
OG0005966	1	1	2	2	6
OG0005967	2	1	2	1	6
OG0005968	1	1	1	3	6
OG0005969	3	1	1	1	6
OG0005970	1	1	2	2	6
OG0005971	2	1	1	2	6
OG0005972	5	1	0	0	6
OG0005973	1	1	1	3	6
OG0005974	2	2	1	1	6
OG0005975	2	1	2	1	6
OG0005976	3	1	1	1	6
OG0005977	4	2	0	0	6
OG0005978	1	1	3	1	6
OG0005979	2	1	1	2	6
OG0005980	2	1	1	2	6
OG0005981	1	1	2	2	6
OG0005982	2	1	2	1	6
OG0005983	1	1	2	2	6
OG0005984	3	1	1	1	6
OG0005985	2	0	2	2	6
OG0005986	1	1	1	3	6
OG0005987	2	2	1	1	6
OG0005988	4	2	0	0	6
OG0005989	1	1	3	1	6
OG0005990	1	1	3	1	6
OG0005991	1	1	2	2	6
OG0005992	1	1	2	2	6
OG0005993	1	1	1	3	6
OG0005994	1	1	2	2	6
OG0005995	1	1	1	3	6
OG0005996	1	1	2	2	6
OG0005997	2	1	2	1	6
OG0005998	1	0	2	3	6
OG0005999	1	1	2	2	6
OG0006000	1	1	2	2	6
OG0006001	1	1	2	2	6
OG0006002	1	1	2	2	6
OG0006003	1	1	2	2	6
OG0006004	1	1	1	3	6
OG0006005	4	2	0	0	6
OG0006006	4	0	1	1	6
OG0006007	2	1	2	1	6
OG0006008	3	1	1	1	6
OG0006009	1	1	3	1	6
OG0006010	2	1	2	1	6
OG0006011	2	1	1	2	6
OG0006012	1	1	2	2	6
OG0006013	1	2	2	1	6
OG0006014	1	1	2	2	6
OG0006015	1	1	2	2	6
OG0006016	1	1	2	2	6
OG0006017	3	1	1	1	6
OG0006018	2	2	1	1	6
OG0006019	1	1	2	2	6
OG0006020	2	2	1	1	6
OG0006021	2	2	1	1	6
OG0006022	1	1	1	3	6
OG0006023	1	1	1	3	6
OG0006024	1	1	2	2	6
OG0006025	1	1	1	3	6
OG0006026	1	1	1	3	6
OG0006027	2	1	2	1	6
OG0006028	1	0	4	1	6
OG0006029	2	2	1	1	6
OG0006030	1	1	2	2	6
OG0006031	1	1	2	2	6
OG0006032	3	2	0	1	6
OG0006033	2	3	0	1	6
OG0006034	2	2	1	1	6
OG0006035	2	2	1	1	6
OG0006036	1	5	0	0	6
OG0006037	2	2	1	1	6
OG0006038	1	1	2	2	6
OG0006039	2	1	1	2	6
OG0006040	1	1	2	2	6
OG0006041	1	1	2	2	6
OG0006042	2	2	1	1	6
OG0006043	2	1	1	2	6
OG0006044	1	1	3	1	6
OG0006045	1	1	2	2	6
OG0006046	2	1	1	2	6
OG0006047	1	1	3	1	6
OG0006048	1	1	2	2	6
OG0006049	2	1	1	2	6
OG0006050	1	1	3	1	6
OG0006051	1	1	2	2	6
OG0006052	2	2	1	1	6
OG0006053	2	2	1	1	6
OG0006054	1	1	2	2	6
OG0006055	2	1	1	2	6
OG0006056	1	1	3	1	6
OG0006057	1	5	0	0	6
OG0006058	1	1	2	2	6
OG0006059	2	2	1	1	6
OG0006060	1	1	1	3	6
OG0006061	2	1	1	2	6
OG0006062	1	1	2	2	6
OG0006063	2	1	1	2	6
OG0006064	1	1	2	2	6
OG0006065	2	3	1	0	6
OG0006066	2	2	1	1	6
OG0006067	2	1	2	1	6
OG0006068	3	3	0	0	6
OG0006069	5	1	0	0	6
OG0006070	1	5	0	0	6
OG0006071	1	1	1	3	6
OG0006072	4	2	0	0	6
OG0006073	2	1	2	1	6
OG0006074	2	2	1	1	6
OG0006075	2	1	2	1	6
OG0006076	1	1	2	2	6
OG0006077	1	1	2	2	6
OG0006078	1	1	2	2	6
OG0006079	4	2	0	0	6
OG0006080	1	1	2	2	6
OG0006081	3	1	1	1	6
OG0006082	1	1	2	2	6
OG0006083	2	1	2	1	6
OG0006084	5	1	0	0	6
OG0006085	3	1	1	1	6
OG0006086	1	5	0	0	6
OG0006087	1	4	1	0	6
OG0006088	5	0	0	1	6
OG0006089	1	1	2	2	6
OG0006090	4	2	0	0	6
OG0006091	1	1	2	2	6
OG0006092	1	1	2	2	6
OG0006093	2	2	1	1	6
OG0006094	1	3	1	1	6
OG0006095	1	1	1	3	6
OG0006096	3	3	0	0	6
OG0006097	1	1	3	1	6
OG0006098	1	1	2	2	6
OG0006099	2	1	2	1	6
OG0006100	1	5	0	0	6
OG0006101	2	1	3	0	6
OG0006102	1	1	3	1	6
OG0006103	1	2	1	2	6
OG0006104	1	1	2	2	6
OG0006105	4	2	0	0	6
OG0006106	2	2	1	1	6
OG0006107	5	0	0	1	6
OG0006108	2	1	2	1	6
OG0006109	2	4	0	0	6
OG0006110	1	1	2	2	6
OG0006111	3	0	1	2	6
OG0006112	5	1	0	0	6
OG0006113	1	1	3	1	6
OG0006114	2	1	1	2	6
OG0006115	6	0	0	0	6
OG0006116	1	5	0	0	6
OG0006117	1	1	2	2	6
OG0006118	2	1	2	1	6
OG0006119	1	1	1	3	6
OG0006120	1	1	2	2	6
OG0006121	1	1	1	3	6
OG0006122	1	1	2	2	6
OG0006123	1	1	1	3	6
OG0006124	1	1	3	1	6
OG0006125	1	1	1	3	6
OG0006126	1	1	1	3	6
OG0006127	1	1	2	2	6
OG0006128	1	0	2	3	6
OG0006129	1	1	3	1	6
OG0006130	2	1	1	2	6
OG0006131	1	1	1	3	6
OG0006132	1	1	2	2	6
OG0006133	1	1	2	2	6
OG0006134	2	1	2	1	6
OG0006135	1	1	2	2	6
OG0006136	1	1	2	2	6
OG0006137	1	1	2	2	6
OG0006138	1	1	2	2	6
OG0006139	1	1	2	2	6
OG0006140	1	1	0	4	6
OG0006141	1	1	3	1	6
OG0006142	1	3	2	0	6
OG0006143	3	1	1	1	6
OG0006144	1	1	1	3	6
OG0006145	1	1	1	3	6
OG0006146	1	1	3	1	6
OG0006147	2	1	1	2	6
OG0006148	1	1	3	1	6
OG0006149	1	1	3	1	6
OG0006150	2	1	1	2	6
OG0006151	3	1	1	1	6
OG0006152	1	1	2	2	6
OG0006153	1	1	1	3	6
OG0006154	2	2	1	1	6
OG0006155	1	1	3	1	6
OG0006156	1	1	1	3	6
OG0006157	1	1	2	2	6
OG0006158	1	1	2	2	6
OG0006159	2	1	1	2	6
OG0006160	1	1	2	2	6
OG0006161	1	1	2	2	6
OG0006162	1	3	1	1	6
OG0006163	1	1	2	2	6
OG0006164	1	1	2	2	6
OG0006165	1	1	2	2	6
OG0006166	1	1	1	3	6
OG0006167	1	1	1	3	6
OG0006168	1	1	3	1	6
OG0006169	1	1	2	2	6
OG0006170	3	0	2	1	6
OG0006171	1	1	2	2	6
OG0006172	1	1	1	3	6
OG0006173	1	1	2	2	6
OG0006174	5	1	0	0	6
OG0006175	1	1	2	2	6
OG0006176	2	1	2	1	6
OG0006177	1	1	2	2	6
OG0006178	1	1	2	2	6
OG0006179	1	1	2	2	6
OG0006180	2	2	1	1	6
OG0006181	2	1	1	2	6
OG0006182	1	1	2	2	6
OG0006183	2	1	2	1	6
OG0006184	1	1	2	2	6
OG0006185	1	1	2	2	6
OG0006186	1	1	3	1	6
OG0006187	1	0	2	3	6
OG0006188	2	1	1	2	6
OG0006189	3	1	1	1	6
OG0006190	2	1	1	2	6
OG0006191	1	1	3	1	6
OG0006192	2	1	1	2	6
OG0006193	3	2	0	1	6
OG0006194	1	1	3	1	6
OG0006195	1	1	3	1	6
OG0006196	1	1	3	1	6
OG0006197	1	1	2	2	6
OG0006198	1	2	2	1	6
OG0006199	1	1	1	3	6
OG0006200	2	1	2	1	6
OG0006201	2	1	2	1	6
OG0006202	1	1	2	2	6
OG0006203	1	1	2	2	6
OG0006204	1	1	2	2	6
OG0006205	2	1	1	2	6
OG0006206	1	1	2	2	6
OG0006207	1	3	1	1	6
OG0006208	2	1	1	2	6
OG0006209	1	1	1	3	6
OG0006210	1	1	3	1	6
OG0006211	1	1	2	2	6
OG0006212	2	1	2	1	6
OG0006213	2	0	2	2	6
OG0006214	1	1	2	2	6
OG0006215	1	1	1	3	6
OG0006216	2	1	1	2	6
OG0006217	1	1	2	2	6
OG0006218	2	1	1	2	6
OG0006219	1	1	2	2	6
OG0006220	3	1	1	1	6
OG0006221	1	2	2	1	6
OG0006222	1	1	3	1	6
OG0006223	2	1	2	1	6
OG0006224	4	2	0	0	6
OG0006225	1	1	2	2	6
OG0006226	1	1	2	2	6
OG0006227	1	1	2	2	6
OG0006228	1	1	2	2	6
OG0006229	1	1	2	2	6
OG0006230	1	1	2	2	6
OG0006231	1	1	1	3	6
OG0006232	1	1	2	2	6
OG0006233	1	1	2	2	6
OG0006234	2	1	3	0	6
OG0006235	1	1	2	2	6
OG0006236	3	1	1	1	6
OG0006237	1	1	2	2	6
OG0006238	1	1	2	2	6
OG0006239	3	1	1	1	6
OG0006240	1	1	2	2	6
OG0006241	1	1	1	3	6
OG0006242	1	1	3	1	6
OG0006243	1	1	1	3	6
OG0006244	1	1	2	2	6
OG0006245	1	1	2	2	6
OG0006246	2	1	2	1	6
OG0006247	2	1	3	0	6
OG0006248	1	1	2	2	6
OG0006249	2	1	1	2	6
OG0006250	2	1	1	2	6
OG0006251	2	1	2	1	6
OG0006252	3	1	1	1	6
OG0006253	1	1	2	2	6
OG0006254	1	1	1	3	6
OG0006255	1	1	2	2	6
OG0006256	1	2	0	3	6
OG0006257	1	1	1	3	6
OG0006258	4	0	1	1	6
OG0006259	3	1	1	1	6
OG0006260	1	1	2	2	6
OG0006261	2	4	0	0	6
OG0006262	2	2	1	1	6
OG0006263	2	1	2	1	6
OG0006264	1	1	2	2	6
OG0006265	1	1	1	3	6
OG0006266	6	0	0	0	6
OG0006267	2	4	0	0	6
OG0006268	6	0	0	0	6
OG0006269	2	1	1	2	6
OG0006270	1	1	2	2	6
OG0006271	1	1	3	1	6
OG0006272	1	1	1	3	6
OG0006273	2	1	2	1	6
OG0006274	1	1	1	3	6
OG0006275	2	2	1	1	6
OG0006276	1	0	4	1	6
OG0006277	1	1	1	3	6
OG0006278	3	3	0	0	6
OG0006279	1	1	2	2	6
OG0006280	1	1	2	2	6
OG0006281	1	1	2	2	6
OG0006282	3	1	1	1	6
OG0006283	3	3	0	0	6
OG0006284	5	1	0	0	6
OG0006285	3	3	0	0	6
OG0006286	3	2	0	1	6
OG0006287	5	1	0	0	6
OG0006288	1	1	3	1	6
OG0006289	1	1	2	2	6
OG0006290	2	2	1	1	6
OG0006291	1	1	2	2	6
OG0006292	6	0	0	0	6
OG0006293	2	2	1	1	6
OG0006294	1	1	1	3	6
OG0006295	1	2	2	1	6
OG0006296	2	1	2	1	6
OG0006297	1	2	2	1	6
OG0006298	1	1	2	2	6
OG0006299	2	1	1	2	6
OG0006300	1	1	3	1	6
OG0006301	2	2	1	1	6
OG0006302	1	1	2	2	6
OG0006303	2	1	1	2	6
OG0006304	2	1	1	2	6
OG0006305	1	1	2	2	6
OG0006306	1	1	2	2	6
OG0006307	1	1	1	3	6
OG0006308	2	1	1	2	6
OG0006309	1	1	0	4	6
OG0006310	1	1	3	1	6
OG0006311	2	1	2	1	6
OG0006312	1	1	1	3	6
OG0006313	1	1	2	2	6
OG0006314	2	1	2	1	6
OG0006315	1	1	2	2	6
OG0006316	4	2	0	0	6
OG0006317	2	1	1	2	6
OG0006318	1	1	2	2	6
OG0006319	1	1	2	2	6
OG0006320	1	1	2	2	6
OG0006321	1	1	2	2	6
OG0006322	1	1	2	2	6
OG0006323	2	2	1	1	6
OG0006324	1	1	3	1	6
OG0006325	1	1	2	2	6
OG0006326	1	1	1	3	6
OG0006327	1	1	2	2	6
OG0006328	1	1	3	1	6
OG0006329	1	1	2	2	6
OG0006330	2	1	1	2	6
OG0006331	1	1	2	2	6
OG0006332	2	2	1	1	6
OG0006333	2	1	2	1	6
OG0006334	2	1	2	1	6
OG0006335	1	1	2	2	6
OG0006336	2	1	2	1	6
OG0006337	2	1	2	1	6
OG0006338	1	1	1	3	6
OG0006339	2	1	1	2	6
OG0006340	1	1	1	3	6
OG0006341	2	2	1	1	6
OG0006342	1	1	2	2	6
OG0006343	1	2	2	1	6
OG0006344	1	1	1	3	6
OG0006345	1	1	2	2	6
OG0006346	1	1	3	1	6
OG0006347	2	1	1	2	6
OG0006348	2	2	1	1	6
OG0006349	1	1	3	1	6
OG0006350	1	1	2	2	6
OG0006351	1	1	3	1	6
OG0006352	1	1	2	2	6
OG0006353	2	1	2	1	6
OG0006354	2	1	2	1	6
OG0006355	1	1	2	2	6
OG0006356	1	2	1	2	6
OG0006357	2	1	2	1	6
OG0006358	1	1	3	1	6
OG0006359	2	1	1	2	6
OG0006360	1	1	2	2	6
OG0006361	1	1	2	2	6
OG0006362	2	0	2	2	6
OG0006363	2	2	1	1	6
OG0006364	3	1	1	1	6
OG0006365	2	1	1	2	6
OG0006366	1	1	2	2	6
OG0006367	1	2	2	1	6
OG0006368	1	1	1	3	6
OG0006369	1	1	3	1	6
OG0006370	2	2	1	1	6
OG0006371	3	1	1	1	6
OG0006372	2	1	1	2	6
OG0006373	1	1	2	2	6
OG0006374	3	1	1	1	6
OG0006375	1	2	2	1	6
OG0006376	1	1	1	3	6
OG0006377	1	1	2	2	6
OG0006378	1	1	2	2	6
OG0006379	1	1	2	2	6
OG0006380	1	1	2	2	6
OG0006381	1	1	2	2	6
OG0006382	1	2	1	2	6
OG0006383	1	1	1	3	6
OG0006384	6	0	0	0	6
OG0006385	3	1	1	1	6
OG0006386	3	2	0	1	6
OG0006387	1	1	2	2	6
OG0006388	1	1	3	1	6
OG0006389	2	2	0	2	6
OG0006390	3	1	1	1	6
OG0006391	1	0	3	2	6
OG0006392	2	2	1	1	6
OG0006393	5	1	0	0	6
OG0006394	5	1	0	0	6
OG0006395	1	1	1	3	6
OG0006396	1	1	2	2	6
OG0006397	3	3	0	0	6
OG0006398	1	0	1	4	6
OG0006399	3	1	1	1	6
OG0006400	2	1	1	2	6
OG0006401	6	0	0	0	6
OG0006402	4	2	0	0	6
OG0006403	1	1	2	2	6
OG0006404	1	0	1	4	6
OG0006405	4	2	0	0	6
OG0006406	1	1	2	2	6
OG0006407	1	1	2	2	6
OG0006408	2	2	2	0	6
OG0006409	5	0	0	1	6
OG0006410	2	1	1	2	6
OG0006411	1	1	1	3	6
OG0006412	2	1	2	1	6
OG0006413	2	1	2	1	6
OG0006414	1	2	1	2	6
OG0006415	1	5	0	0	6
OG0006416	3	1	1	1	6
OG0006417	2	2	1	1	6
OG0006418	2	1	2	1	6
OG0006419	1	1	3	1	6
OG0006420	5	1	0	0	6
OG0006421	1	4	0	1	6
OG0006422	1	2	1	2	6
OG0006423	1	1	2	2	6
OG0006424	2	1	1	2	6
OG0006425	1	1	2	2	6
OG0006426	2	2	1	1	6
OG0006427	6	0	0	0	6
OG0006428	3	3	0	0	6
OG0006429	1	1	2	2	6
OG0006430	1	2	2	1	6
OG0006431	2	1	1	2	6
OG0006432	1	1	2	2	6
OG0006433	1	1	1	3	6
OG0006434	2	1	1	2	6
OG0006435	1	1	3	1	6
OG0006436	1	1	3	1	6
OG0006437	1	2	1	2	6
OG0006438	2	1	2	1	6
OG0006439	2	1	1	2	6
OG0006440	6	0	0	0	6
OG0006441	1	1	1	3	6
OG0006442	2	1	1	2	6
OG0006443	2	1	1	2	6
OG0006444	2	3	0	1	6
OG0006445	1	1	2	2	6
OG0006446	3	1	1	1	6
OG0006447	1	3	1	1	6
OG0006448	1	3	1	1	6
OG0006449	3	1	1	1	6
OG0006450	2	1	1	2	6
OG0006451	2	1	2	1	6
OG0006452	1	5	0	0	6
OG0006453	3	1	1	1	6
OG0006454	4	2	0	0	6
OG0006455	4	2	0	0	6
OG0006456	2	1	1	2	6
OG0006457	1	0	3	2	6
OG0006458	1	1	1	3	6
OG0006459	2	1	2	1	6
OG0006460	1	3	1	1	6
OG0006461	1	0	2	3	6
OG0006462	1	1	1	3	6
OG0006463	1	1	2	2	6
OG0006464	1	2	1	2	6
OG0006465	1	1	1	3	6
OG0006466	2	1	2	1	6
OG0006467	1	2	2	1	6
OG0006468	1	1	1	3	6
OG0006469	1	1	2	2	6
OG0006470	1	1	1	3	6
OG0006471	1	2	1	2	6
OG0006472	1	1	2	2	6
OG0006473	2	1	1	2	6
OG0006474	1	1	0	4	6
OG0006475	1	1	2	2	6
OG0006476	2	1	2	1	6
OG0006477	1	1	1	3	6
OG0006478	1	1	1	3	6
OG0006479	1	0	2	3	6
OG0006480	1	1	1	3	6
OG0006481	1	2	2	1	6
OG0006482	2	1	1	2	6
OG0006483	1	2	2	1	6
OG0006484	3	1	1	1	6
OG0006485	1	1	1	3	6
OG0006486	1	1	2	2	6
OG0006487	2	1	2	1	6
OG0006488	1	1	2	2	6
OG0006489	3	1	1	1	6
OG0006490	3	2	0	1	6
OG0006491	2	1	2	1	6
OG0006492	3	1	1	1	6
OG0006493	1	1	4	0	6
OG0006494	3	1	1	1	6
OG0006495	1	1	2	2	6
OG0006496	1	1	1	3	6
OG0006497	2	1	2	1	6
OG0006498	1	1	2	2	6
OG0006499	2	1	1	2	6
OG0006500	2	1	2	1	6
OG0006501	1	1	2	2	6
OG0006502	1	1	3	1	6
OG0006503	2	2	1	1	6
OG0006504	2	1	1	2	6
OG0006505	1	1	1	3	6
OG0006506	1	1	2	2	6
OG0006507	1	2	1	2	6
OG0006508	3	1	1	1	6
OG0006509	1	1	1	3	6
OG0006510	1	1	3	1	6
OG0006511	1	1	1	3	6
OG0006512	1	1	3	1	6
OG0006513	1	1	2	2	6
OG0006514	1	1	3	1	6
OG0006515	1	1	1	3	6
OG0006516	2	2	2	0	6
OG0006517	2	1	2	1	6
OG0006518	1	1	1	3	6
OG0006519	1	1	3	1	6
OG0006520	2	0	2	2	6
OG0006521	2	0	3	1	6
OG0006522	1	1	1	3	6
OG0006523	1	1	2	2	6
OG0006524	1	1	2	2	6
OG0006525	1	1	1	3	6
OG0006526	1	1	3	1	6
OG0006527	2	1	1	2	6
OG0006528	1	1	1	3	6
OG0006529	1	1	1	3	6
OG0006530	1	1	2	2	6
OG0006531	1	1	1	3	6
OG0006532	1	1	1	3	6
OG0006533	1	1	1	3	6
OG0006534	1	1	1	3	6
OG0006535	1	1	2	2	6
OG0006536	1	2	2	1	6
OG0006537	2	4	0	0	6
OG0006538	2	2	1	1	6
OG0006539	2	1	2	1	6
OG0006540	1	1	1	3	6
OG0006541	1	1	2	2	6
OG0006542	3	1	1	1	6
OG0006543	1	1	3	1	6
OG0006544	1	1	2	2	6
OG0006545	1	1	2	2	6
OG0006546	1	1	2	2	6
OG0006547	1	1	2	2	6
OG0006548	1	1	2	2	6
OG0006549	1	1	2	2	6
OG0006550	1	1	2	2	6
OG0006551	1	1	2	2	6
OG0006552	1	1	2	2	6
OG0006553	1	2	1	2	6
OG0006554	1	1	1	3	6
OG0006555	1	5	0	0	6
OG0006556	1	1	2	2	6
OG0006557	1	1	1	3	6
OG0006558	1	1	1	3	6
OG0006559	1	1	2	2	6
OG0006560	1	0	1	4	6
OG0006561	1	1	1	3	6
OG0006562	1	1	2	2	6
OG0006563	1	1	2	2	6
OG0006564	2	1	1	2	6
OG0006565	1	1	3	1	6
OG0006566	1	1	2	2	6
OG0006567	1	1	3	1	6
OG0006568	1	1	2	2	6
OG0006569	1	1	2	2	6
OG0006570	3	1	1	1	6
OG0006571	1	1	3	1	6
OG0006572	1	1	2	2	6
OG0006573	1	2	2	1	6
OG0006574	1	1	1	3	6
OG0006575	2	1	1	2	6
OG0006576	1	1	2	2	6
OG0006577	1	2	2	1	6
OG0006578	2	1	2	1	6
OG0006579	1	1	2	2	6
OG0006580	1	1	1	3	6
OG0006581	1	1	2	2	6
OG0006582	2	0	2	2	6
OG0006583	1	1	2	2	6
OG0006584	2	2	1	1	6
OG0006585	1	1	2	2	6
OG0006586	1	1	1	3	6
OG0006587	1	0	1	4	6
OG0006588	1	1	2	2	6
OG0006589	1	1	1	3	6
OG0006590	2	2	1	1	6
OG0006591	1	1	2	2	6
OG0006592	2	1	1	2	6
OG0006593	2	1	1	2	6
OG0006594	2	2	1	1	6
OG0006595	1	1	2	2	6
OG0006596	2	0	1	3	6
OG0006597	2	1	2	1	6
OG0006598	1	1	2	2	6
OG0006599	2	1	1	2	6
OG0006600	1	1	2	2	6
OG0006601	1	1	2	2	6
OG0006602	1	1	1	3	6
OG0006603	1	3	1	1	6
OG0006604	2	1	2	1	6
OG0006605	1	1	2	2	6
OG0006606	2	1	2	1	6
OG0006607	2	1	2	1	6
OG0006608	2	2	1	1	6
OG0006609	2	2	1	1	6
OG0006610	1	1	1	3	6
OG0006611	1	1	1	3	6
OG0006612	1	1	3	1	6
OG0006613	1	1	2	2	6
OG0006614	2	1	2	1	6
OG0006615	1	1	2	2	6
OG0006616	1	1	3	1	6
OG0006617	1	1	1	3	6
OG0006618	1	1	2	2	6
OG0006619	1	1	1	3	6
OG0006620	1	1	2	2	6
OG0006621	1	4	0	1	6
OG0006622	1	1	2	2	6
OG0006623	2	1	2	1	6
OG0006624	2	2	1	1	6
OG0006625	3	1	1	1	6
OG0006626	1	5	0	0	6
OG0006627	2	1	1	2	6
OG0006628	1	1	2	2	6
OG0006629	1	1	1	3	6
OG0006630	2	1	1	2	6
OG0006631	2	1	1	2	6
OG0006632	1	1	2	2	6
OG0006633	2	1	1	2	6
OG0006634	2	1	2	1	6
OG0006635	1	1	2	2	6
OG0006636	1	1	2	2	6
OG0006637	2	1	1	2	6
OG0006638	5	1	0	0	6
OG0006639	2	4	0	0	6
OG0006640	2	2	1	1	6
OG0006641	1	1	1	3	6
OG0006642	5	1	0	0	6
OG0006643	1	1	2	2	6
OG0006644	1	2	0	3	6
OG0006645	2	2	1	1	6
OG0006646	2	4	0	0	6
OG0006647	1	5	0	0	6
OG0006648	1	2	2	1	6
OG0006649	1	1	2	2	6
OG0006650	2	4	0	0	6
OG0006651	1	3	1	1	6
OG0006652	6	0	0	0	6
OG0006653	2	2	1	1	6
OG0006654	2	1	1	2	6
OG0006655	1	2	1	2	6
OG0006656	3	3	0	0	6
OG0006657	2	1	1	2	6
OG0006658	1	1	2	2	6
OG0006659	1	1	1	3	6
OG0006660	3	1	1	1	6
OG0006661	2	1	2	1	6
OG0006662	1	1	4	0	6
OG0006663	1	1	2	2	6
OG0006664	2	1	2	1	6
OG0006665	5	1	0	0	6
OG0006666	1	0	2	3	6
OG0006667	1	1	2	2	6
OG0006668	2	4	0	0	6
OG0006669	1	3	0	2	6
OG0006670	1	1	2	2	6
OG0006671	2	1	2	1	6
OG0006672	2	1	1	2	6
OG0006673	1	2	2	1	6
OG0006674	1	1	2	2	6
OG0006675	3	1	2	0	6
OG0006676	1	1	2	2	6
OG0006677	1	1	2	2	6
OG0006678	1	1	3	1	6
OG0006679	2	3	0	1	6
OG0006680	3	2	1	0	6
OG0006681	2	1	1	2	6
OG0006682	1	1	2	2	6
OG0006683	1	1	2	2	6
OG0006684	2	1	1	2	6
OG0006685	2	1	1	2	6
OG0006686	1	1	1	3	6
OG0006687	1	1	3	1	6
OG0006688	1	1	1	3	6
OG0006689	1	1	1	3	6
OG0006690	1	1	2	2	6
OG0006691	2	1	2	1	6
OG0006692	1	1	2	2	6
OG0006693	2	1	1	2	6
OG0006694	1	1	1	3	6
OG0006695	2	2	1	1	6
OG0006696	1	1	1	3	6
OG0006697	1	1	1	3	6
OG0006698	1	1	2	2	6
OG0006699	1	1	2	2	6
OG0006700	1	1	1	3	6
OG0006701	1	1	2	2	6
OG0006702	1	1	2	2	6
OG0006703	1	1	1	3	6
OG0006704	4	2	0	0	6
OG0006705	1	1	2	2	6
OG0006706	1	1	2	2	6
OG0006707	2	1	2	1	6
OG0006708	2	1	2	1	6
OG0006709	1	1	1	3	6
OG0006710	2	1	2	1	6
OG0006711	1	1	2	2	6
OG0006712	2	1	1	2	6
OG0006713	1	1	1	3	6
OG0006714	1	1	2	2	6
OG0006715	2	1	2	1	6
OG0006716	1	0	1	4	6
OG0006717	1	1	2	2	6
OG0006718	2	1	1	2	6
OG0006719	1	1	3	1	6
OG0006720	2	2	1	1	6
OG0006721	1	1	2	2	6
OG0006722	1	1	2	2	6
OG0006723	2	1	2	1	6
OG0006724	1	5	0	0	6
OG0006725	1	1	2	2	6
OG0006726	1	1	2	2	6
OG0006727	1	1	2	2	6
OG0006728	1	1	1	3	6
OG0006729	1	1	3	1	6
OG0006730	1	1	1	3	6
OG0006731	2	1	2	1	6
OG0006732	1	1	2	2	6
OG0006733	1	2	2	1	6
OG0006734	1	2	2	1	6
OG0006735	5	1	0	0	6
OG0006736	1	1	2	2	6
OG0006737	1	5	0	0	6
OG0006738	1	1	3	1	6
OG0006739	1	1	1	3	6
OG0006740	1	1	1	3	6
OG0006741	1	0	2	3	6
OG0006742	1	1	0	4	6
OG0006743	1	2	2	1	6
OG0006744	1	1	3	1	6
OG0006745	1	1	2	2	6
OG0006746	1	1	2	2	6
OG0006747	1	2	2	1	6
OG0006748	1	1	1	3	6
OG0006749	1	1	2	2	6
OG0006750	2	2	1	1	6
OG0006751	1	1	1	3	6
OG0006752	2	1	1	2	6
OG0006753	1	1	1	3	6
OG0006754	1	1	1	3	6
OG0006755	1	0	4	1	6
OG0006756	5	0	1	0	6
OG0006757	3	3	0	0	6
OG0006758	2	1	1	2	6
OG0006759	2	1	1	2	6
OG0006760	1	1	1	3	6
OG0006761	4	2	0	0	6
OG0006762	1	1	1	3	6
OG0006763	1	1	1	3	6
OG0006764	1	1	1	3	6
OG0006765	4	2	0	0	6
OG0006766	1	5	0	0	6
OG0006767	1	1	1	3	6
OG0006768	1	1	1	3	6
OG0006769	2	2	1	1	6
OG0006770	2	2	1	1	6
OG0006771	2	2	1	1	6
OG0006772	1	1	4	0	6
OG0006773	1	1	3	1	6
OG0006774	1	1	2	2	6
OG0006775	1	1	2	2	6
OG0006776	1	1	1	3	6
OG0006777	2	1	2	1	6
OG0006778	2	1	1	2	6
OG0006779	1	1	2	2	6
OG0006780	1	1	3	1	6
OG0006781	1	1	3	1	6
OG0006782	1	1	2	2	6
OG0006783	1	1	3	1	6
OG0006784	1	1	3	1	6
OG0006785	2	2	1	1	6
OG0006786	1	1	3	1	6
OG0006787	2	0	2	2	6
OG0006788	1	1	2	2	6
OG0006789	2	1	1	2	6
OG0006790	1	1	2	2	6
OG0006791	2	1	2	1	6
OG0006792	1	1	1	3	6
OG0006793	1	1	2	2	6
OG0006794	1	1	2	2	6
OG0006795	3	1	1	1	6
OG0006796	1	1	2	2	6
OG0006797	1	1	3	1	6
OG0006798	1	1	2	2	6
OG0006799	1	1	2	2	6
OG0006800	3	1	1	1	6
OG0006801	1	1	1	3	6
OG0006802	1	1	3	1	6
OG0006803	1	1	2	2	6
OG0006804	1	0	1	4	6
OG0006805	1	1	2	2	6
OG0006806	3	1	1	1	6
OG0006807	2	1	0	3	6
OG0006808	1	1	1	3	6
OG0006809	2	1	1	2	6
OG0006810	1	1	2	2	6
OG0006811	1	1	2	2	6
OG0006812	2	2	1	1	6
OG0006813	1	1	2	2	6
OG0006814	1	1	3	1	6
OG0006815	1	0	3	2	6
OG0006816	1	1	2	2	6
OG0006817	1	1	1	3	6
OG0006818	2	1	2	1	6
OG0006819	1	1	2	2	6
OG0006820	1	1	2	2	6
OG0006821	1	1	3	1	6
OG0006822	1	1	2	2	6
OG0006823	1	1	2	2	6
OG0006824	2	1	1	2	6
OG0006825	1	1	2	2	6
OG0006826	1	1	2	2	6
OG0006827	1	1	2	2	6
OG0006828	1	1	3	1	6
OG0006829	1	1	1	3	6
OG0006830	3	1	1	1	6
OG0006831	1	1	1	3	6
OG0006832	1	1	2	2	6
OG0006833	1	1	3	1	6
OG0006834	1	1	1	3	6
OG0006835	1	1	3	1	6
OG0006836	1	1	2	2	6
OG0006837	1	2	2	1	6
OG0006838	3	1	1	1	6
OG0006839	1	1	3	1	6
OG0006840	1	1	2	2	6
OG0006841	1	1	2	2	6
OG0006842	1	1	2	2	6
OG0006843	2	1	2	1	6
OG0006844	1	1	2	2	6
OG0006845	1	1	1	3	6
OG0006846	1	1	2	2	6
OG0006847	1	1	1	3	6
OG0006848	2	2	1	1	6
OG0006849	1	1	2	2	6
OG0006850	1	1	2	2	6
OG0006851	1	1	2	2	6
OG0006852	1	1	2	2	6
OG0006853	2	1	1	2	6
OG0006854	2	2	1	1	6
OG0006855	2	1	2	1	6
OG0006856	2	2	1	1	6
OG0006857	1	1	2	2	6
OG0006858	1	1	3	1	6
OG0006859	1	1	1	3	6
OG0006860	1	1	2	2	6
OG0006861	1	1	2	2	6
OG0006862	1	1	2	2	6
OG0006863	2	1	2	1	6
OG0006864	1	1	2	2	6
OG0006865	1	1	2	2	6
OG0006866	1	1	2	2	6
OG0006867	1	1	1	3	6
OG0006868	2	1	2	1	6
OG0006869	1	1	2	2	6
OG0006870	1	1	2	2	6
OG0006871	1	1	3	1	6
OG0006872	1	1	1	3	6
OG0006873	2	1	2	1	6
OG0006874	2	1	1	2	6
OG0006875	1	1	2	2	6
OG0006876	1	1	2	2	6
OG0006877	2	1	1	2	6
OG0006878	1	0	2	3	6
OG0006879	1	1	2	2	6
OG0006880	1	5	0	0	6
OG0006881	2	1	2	1	6
OG0006882	1	2	1	2	6
OG0006883	1	0	3	2	6
OG0006884	3	2	1	0	6
OG0006885	1	1	2	2	6
OG0006886	1	1	2	2	6
OG0006887	1	1	1	3	6
OG0006888	2	1	2	1	6
OG0006889	2	1	1	2	6
OG0006890	1	1	1	3	6
OG0006891	1	1	1	3	6
OG0006892	3	1	1	1	6
OG0006893	1	1	2	2	6
OG0006894	2	1	1	2	6
OG0006895	2	1	2	1	6
OG0006896	2	1	2	1	6
OG0006897	1	1	2	2	6
OG0006898	1	1	2	2	6
OG0006899	3	1	1	1	6
OG0006900	1	1	2	2	6
OG0006901	1	1	2	2	6
OG0006902	3	1	1	1	6
OG0006903	1	1	3	1	6
OG0006904	1	1	2	2	6
OG0006905	1	1	2	2	6
OG0006906	1	1	2	2	6
OG0006907	1	1	2	2	6
OG0006908	1	1	2	2	6
OG0006909	3	1	1	1	6
OG0006910	1	1	1	3	6
OG0006911	1	1	2	2	6
OG0006912	1	1	1	3	6
OG0006913	1	1	2	2	6
OG0006914	1	1	1	3	6
OG0006915	1	1	2	2	6
OG0006916	1	0	0	5	6
OG0006917	1	1	2	2	6
OG0006918	5	0	0	1	6
OG0006919	3	1	1	1	6
OG0006920	3	1	1	1	6
OG0006921	2	2	1	1	6
OG0006922	3	1	1	1	6
OG0006923	1	1	2	2	6
OG0006924	2	2	1	1	6
OG0006925	1	1	1	3	6
OG0006926	2	1	1	2	6
OG0006927	2	1	2	1	6
OG0006928	1	1	1	3	6
OG0006929	2	1	1	2	6
OG0006930	1	1	2	2	6
OG0006931	2	2	1	1	6
OG0006932	3	1	1	1	6
OG0006933	1	1	2	2	6
OG0006934	2	2	1	1	6
OG0006935	1	1	2	2	6
OG0006936	1	1	3	1	6
OG0006937	2	2	1	1	6
OG0006938	2	1	2	1	6
OG0006939	1	1	2	2	6
OG0006940	1	1	2	2	6
OG0006941	2	2	1	1	6
OG0006942	2	1	1	2	6
OG0006943	2	2	1	1	6
OG0006944	1	1	2	2	6
OG0006945	1	1	1	3	6
OG0006946	2	2	1	1	6
OG0006947	2	1	1	2	6
OG0006948	2	3	1	0	6
OG0006949	3	1	1	1	6
OG0006950	1	1	2	2	6
OG0006951	1	2	1	2	6
OG0006952	2	1	2	1	6
OG0006953	1	1	1	3	6
OG0006954	2	2	1	1	6
OG0006955	1	1	1	3	6
OG0006956	1	1	2	2	6
OG0006957	1	1	2	2	6
OG0006958	1	1	1	3	6
OG0006959	3	1	1	1	6
OG0006960	2	1	1	2	6
OG0006961	1	1	3	1	6
OG0006962	2	1	2	1	6
OG0006963	1	1	2	2	6
OG0006964	1	1	2	2	6
OG0006965	2	1	2	1	6
OG0006966	1	1	3	1	6
OG0006967	6	0	0	0	6
OG0006968	1	1	1	3	6
OG0006969	1	1	2	2	6
OG0006970	1	1	2	2	6
OG0006971	1	1	2	2	6
OG0006972	1	1	2	2	6
OG0006973	1	5	0	0	6
OG0006974	1	1	2	2	6
OG0006975	1	1	2	2	6
OG0006976	1	1	2	2	6
OG0006977	1	1	2	2	6
OG0006978	1	2	1	2	6
OG0006979	1	1	1	3	6
OG0006980	1	1	2	2	6
OG0006981	6	0	0	0	6
OG0006982	1	1	2	2	6
OG0006983	3	1	1	1	6
OG0006984	1	1	2	2	6
OG0006985	1	1	2	2	6
OG0006986	1	1	1	3	6
OG0006987	1	1	2	2	6
OG0006988	1	1	1	3	6
OG0006989	2	1	2	1	6
OG0006990	2	1	1	2	6
OG0006991	2	1	1	2	6
OG0006992	2	1	1	2	6
OG0006993	5	0	0	1	6
OG0006994	1	1	1	3	6
OG0006995	1	1	2	2	6
OG0006996	1	1	3	1	6
OG0006997	2	2	1	1	6
OG0006998	1	1	1	3	6
OG0006999	1	0	4	1	6
OG0007000	1	1	2	2	6
OG0007001	2	1	2	1	6
OG0007002	1	1	2	2	6
OG0007003	1	1	2	2	6
OG0007004	2	2	1	1	6
OG0007005	1	1	2	2	6
OG0007006	1	1	1	3	6
OG0007007	1	1	2	2	6
OG0007008	2	1	2	1	6
OG0007009	3	1	1	1	6
OG0007010	1	1	2	2	6
OG0007011	1	1	2	2	6
OG0007012	2	2	1	1	6
OG0007013	1	1	2	2	6
OG0007014	1	2	1	2	6
OG0007015	1	1	1	3	6
OG0007016	1	1	3	1	6
OG0007017	1	1	2	2	6
OG0007018	1	1	3	1	6
OG0007019	1	1	2	2	6
OG0007020	1	1	2	2	6
OG0007021	1	1	2	2	6
OG0007022	2	1	2	1	6
OG0007023	1	1	2	2	6
OG0007024	1	1	2	2	6
OG0007025	2	1	2	1	6
OG0007026	1	1	2	2	6
OG0007027	2	2	1	1	6
OG0007028	1	1	2	2	6
OG0007029	2	2	1	1	6
OG0007030	1	1	2	2	6
OG0007031	1	1	3	1	6
OG0007032	1	3	1	1	6
OG0007033	2	1	2	1	6
OG0007034	1	1	2	2	6
OG0007035	1	0	2	3	6
OG0007036	1	1	3	1	6
OG0007037	1	1	2	2	6
OG0007038	1	3	1	1	6
OG0007039	1	1	1	3	6
OG0007040	2	1	1	2	6
OG0007041	1	1	2	2	6
OG0007042	2	0	3	1	6
OG0007043	1	1	2	2	6
OG0007044	1	1	1	3	6
OG0007045	1	1	1	3	6
OG0007046	1	1	2	2	6
OG0007047	1	1	2	2	6
OG0007048	1	0	3	2	6
OG0007049	1	1	1	3	6
OG0007050	1	1	1	3	6
OG0007051	1	1	2	2	6
OG0007052	1	1	2	2	6
OG0007053	2	1	2	1	6
OG0007054	1	1	3	1	6
OG0007055	1	1	3	1	6
OG0007056	1	1	1	3	6
OG0007057	1	2	1	2	6
OG0007058	2	1	2	1	6
OG0007059	1	1	1	3	6
OG0007060	2	2	1	1	6
OG0007061	1	1	2	2	6
OG0007062	1	1	3	1	6
OG0007063	1	1	2	2	6
OG0007064	1	1	3	1	6
OG0007065	2	1	2	1	6
OG0007066	1	1	2	2	6
OG0007067	1	1	2	2	6
OG0007068	1	1	2	2	6
OG0007069	2	2	1	1	6
OG0007070	1	1	1	3	6
OG0007071	1	1	3	1	6
OG0007072	1	1	2	2	6
OG0007073	1	1	3	1	6
OG0007074	1	2	1	2	6
OG0007075	1	1	2	2	6
OG0007076	1	1	1	3	6
OG0007077	1	1	1	3	6
OG0007078	2	2	1	1	6
OG0007079	1	1	1	3	6
OG0007080	1	1	2	2	6
OG0007081	1	1	3	1	6
OG0007082	1	1	1	3	6
OG0007083	1	1	3	1	6
OG0007084	1	1	3	1	6
OG0007085	1	2	1	2	6
OG0007086	2	2	1	1	6
OG0007087	1	1	1	3	6
OG0007088	2	2	1	1	6
OG0007089	1	1	2	2	6
OG0007090	1	1	2	2	6
OG0007091	1	1	1	3	6
OG0007092	2	1	1	2	6
OG0007093	1	1	3	1	6
OG0007094	2	1	2	1	6
OG0007095	2	2	1	1	6
OG0007096	2	1	3	0	6
OG0007097	2	2	1	1	6
OG0007098	1	1	3	1	6
OG0007099	1	1	2	2	6
OG0007100	1	1	1	3	6
OG0007101	1	1	2	2	6
OG0007102	2	2	1	1	6
OG0007103	1	1	1	3	6
OG0007104	1	1	2	2	6
OG0007105	1	1	3	1	6
OG0007106	1	2	2	1	6
OG0007107	1	1	2	2	6
OG0007108	1	1	3	1	6
OG0007109	1	1	2	2	6
OG0007110	1	1	2	2	6
OG0007111	1	1	1	3	6
OG0007112	1	5	0	0	6
OG0007113	1	1	2	2	6
OG0007114	2	1	1	2	6
OG0007115	2	0	2	2	6
OG0007116	1	1	2	2	6
OG0007117	2	2	1	1	6
OG0007118	1	1	2	2	6
OG0007119	1	1	1	3	6
OG0007120	1	1	2	2	6
OG0007121	1	1	3	1	6
OG0007122	3	1	1	1	6
OG0007123	1	1	2	2	6
OG0007124	1	1	3	1	6
OG0007125	1	2	1	2	6
OG0007126	1	2	2	1	6
OG0007127	1	1	1	3	6
OG0007128	1	2	1	2	6
OG0007129	1	1	1	3	6
OG0007130	1	1	2	2	6
OG0007131	1	1	2	2	6
OG0007132	1	1	2	2	6
OG0007133	1	1	2	2	6
OG0007134	1	1	2	2	6
OG0007135	1	1	1	3	6
OG0007136	2	1	1	2	6
OG0007137	1	1	2	2	6
OG0007138	2	1	1	2	6
OG0007139	1	1	2	2	6
OG0007140	1	1	2	2	6
OG0007141	1	1	1	3	6
OG0007142	1	1	2	2	6
OG0007143	1	1	1	3	6
OG0007144	2	1	1	2	6
OG0007145	1	1	2	2	6
OG0007146	1	1	2	2	6
OG0007147	3	1	0	2	6
OG0007148	1	1	2	2	6
OG0007149	3	1	1	1	6
OG0007150	2	1	1	2	6
OG0007151	3	1	1	1	6
OG0007152	1	2	2	1	6
OG0007153	1	1	1	3	6
OG0007154	1	1	2	2	6
OG0007155	1	1	2	2	6
OG0007156	2	1	1	2	6
OG0007157	1	1	2	2	6
OG0007158	1	1	2	2	6
OG0007159	1	1	1	3	6
OG0007160	1	1	2	2	6
OG0007161	1	1	2	2	6
OG0007162	1	1	2	2	6
OG0007163	1	1	2	2	6
OG0007164	1	1	3	1	6
OG0007165	1	1	2	2	6
OG0007166	2	2	1	1	6
OG0007167	1	1	2	2	6
OG0007168	1	1	2	2	6
OG0007169	2	1	1	2	6
OG0007170	1	2	2	1	6
OG0007171	1	1	3	1	6
OG0007172	2	2	1	1	6
OG0007173	1	1	3	1	6
OG0007174	1	1	2	2	6
OG0007175	1	1	2	2	6
OG0007176	1	1	2	2	6
OG0007177	1	1	2	2	6
OG0007178	1	1	3	1	6
OG0007179	3	1	1	1	6
OG0007180	1	0	2	3	6
OG0007181	1	1	2	2	6
OG0007182	2	0	2	2	6
OG0007183	1	2	2	1	6
OG0007184	1	1	2	2	6
OG0007185	2	1	1	2	6
OG0007186	2	2	1	1	6
OG0007187	1	1	3	1	6
OG0007188	2	1	1	2	6
OG0007189	2	2	1	1	6
OG0007190	1	1	2	2	6
OG0007191	2	1	2	1	6
OG0007192	2	2	1	1	6
OG0007193	2	1	2	1	6
OG0007194	2	1	2	1	6
OG0007195	1	1	2	2	6
OG0007196	2	1	2	1	6
OG0007197	1	1	1	3	6
OG0007198	1	1	1	3	6
OG0007199	1	1	1	3	6
OG0007200	1	1	2	2	6
OG0007201	1	1	2	2	6
OG0007202	1	0	4	1	6
OG0007203	1	1	2	2	6
OG0007204	2	1	1	2	6
OG0007205	3	2	0	1	6
OG0007206	1	1	2	2	6
OG0007207	2	1	2	1	6
OG0007208	4	2	0	0	6
OG0007209	1	1	2	2	6
OG0007210	1	1	1	3	6
OG0007211	1	1	2	2	6
OG0007212	2	1	2	1	6
OG0007213	1	2	1	2	6
OG0007214	1	5	0	0	6
OG0007215	1	1	3	1	6
OG0007216	1	1	3	1	6
OG0007217	1	5	0	0	6
OG0007218	1	1	2	2	6
OG0007219	1	1	2	2	6
OG0007220	3	1	1	1	6
OG0007221	2	1	1	2	6
OG0007222	1	1	3	1	6
OG0007223	2	1	2	1	6
OG0007224	1	1	2	2	6
OG0007225	1	5	0	0	6
OG0007226	1	1	1	3	6
OG0007227	1	1	2	2	6
OG0007228	2	4	0	0	6
OG0007229	3	1	1	1	6
OG0007230	1	1	1	3	6
OG0007231	1	1	3	1	6
OG0007232	1	1	2	2	6
OG0007233	2	1	1	2	6
OG0007234	3	1	1	1	6
OG0007235	2	2	1	1	6
OG0007236	2	1	1	2	6
OG0007237	1	1	1	3	6
OG0007238	1	1	1	3	6
OG0007239	1	1	2	2	6
OG0007240	2	1	2	1	6
OG0007241	1	1	3	1	6
OG0007242	1	1	1	3	6
OG0007243	1	1	2	2	6
OG0007244	2	2	1	1	6
OG0007245	1	1	1	3	6
OG0007246	1	1	1	3	6
OG0007247	1	2	1	2	6
OG0007248	2	1	1	2	6
OG0007249	1	1	2	2	6
OG0007250	1	1	3	1	6
OG0007251	1	1	2	2	6
OG0007252	1	1	2	2	6
OG0007253	1	2	2	1	6
OG0007254	1	1	2	2	6
OG0007255	1	1	3	1	6
OG0007256	1	1	1	3	6
OG0007257	1	1	2	2	6
OG0007258	5	1	0	0	6
OG0007259	1	1	1	3	6
OG0007260	1	1	1	3	6
OG0007261	1	2	1	2	6
OG0007262	2	1	2	1	6
OG0007263	2	1	1	2	6
OG0007264	1	1	1	3	6
OG0007265	3	1	1	1	6
OG0007266	1	1	2	2	6
OG0007267	1	1	3	1	6
OG0007268	1	1	1	3	6
OG0007269	1	1	2	2	6
OG0007270	1	1	3	1	6
OG0007271	1	5	0	0	6
OG0007272	3	1	1	1	6
OG0007273	1	1	3	1	6
OG0007274	1	1	1	3	6
OG0007275	1	1	2	2	6
OG0007276	2	1	2	1	6
OG0007277	1	1	4	0	6
OG0007278	1	1	2	2	6
OG0007279	1	1	3	1	6
OG0007280	1	1	0	4	6
OG0007281	1	0	3	2	6
OG0007282	1	1	1	3	6
OG0007283	2	1	2	1	6
OG0007284	3	3	0	0	6
OG0007285	1	1	2	2	6
OG0007286	1	1	1	3	6
OG0007287	1	1	3	1	6
OG0007288	1	1	2	2	6
OG0007289	1	1	1	3	6
OG0007290	1	0	3	2	6
OG0007291	1	1	2	2	6
OG0007292	1	1	3	1	6
OG0007293	1	1	2	2	6
OG0007294	1	1	2	2	6
OG0007295	1	1	2	2	6
OG0007296	1	3	1	1	6
OG0007297	1	2	2	1	6
OG0007298	1	1	1	3	6
OG0007299	1	1	2	2	6
OG0007300	1	1	2	2	6
OG0007301	1	1	2	2	6
OG0007302	1	1	3	1	6
OG0007303	1	1	1	3	6
OG0007304	2	1	2	1	6
OG0007305	1	1	2	2	6
OG0007306	2	1	2	1	6
OG0007307	1	1	2	2	6
OG0007308	1	1	2	2	6
OG0007309	2	2	1	1	6
OG0007310	2	1	1	2	6
OG0007311	1	1	3	1	6
OG0007312	1	1	1	3	6
OG0007313	2	2	1	1	6
OG0007314	1	1	2	2	6
OG0007315	1	1	2	2	6
OG0007316	1	1	1	3	6
OG0007317	1	1	3	1	6
OG0007318	2	1	1	2	6
OG0007319	1	1	2	2	6
OG0007320	2	1	1	2	6
OG0007321	3	1	1	1	6
OG0007322	1	1	1	3	6
OG0007323	1	1	2	2	6
OG0007324	1	1	2	2	6
OG0007325	1	1	3	1	6
OG0007326	1	1	2	2	6
OG0007327	1	1	1	3	6
OG0007328	1	1	1	3	6
OG0007329	1	1	2	2	6
OG0007330	1	1	2	2	6
OG0007331	1	1	2	2	6
OG0007332	1	1	3	1	6
OG0007333	1	1	2	2	6
OG0007334	1	1	2	2	6
OG0007335	1	1	1	3	6
OG0007336	1	1	2	2	6
OG0007337	2	2	1	1	6
OG0007338	1	1	2	2	6
OG0007339	1	1	2	2	6
OG0007340	1	1	1	3	6
OG0007341	2	2	1	1	6
OG0007342	1	1	2	2	6
OG0007343	2	1	1	2	6
OG0007344	1	2	1	2	6
OG0007345	1	1	1	3	6
OG0007346	2	1	1	2	6
OG0007347	1	1	1	3	6
OG0007348	1	1	3	1	6
OG0007349	1	1	1	3	6
OG0007350	1	1	2	2	6
OG0007351	1	0	2	3	6
OG0007352	3	1	1	1	6
OG0007353	1	1	2	2	6
OG0007354	2	1	2	1	6
OG0007355	2	1	1	2	6
OG0007356	1	1	3	1	6
OG0007357	1	1	2	2	6
OG0007358	1	1	1	3	6
OG0007359	1	1	3	1	6
OG0007360	1	1	2	2	6
OG0007361	1	1	3	1	6
OG0007362	1	1	2	2	6
OG0007363	2	2	1	1	6
OG0007364	1	1	2	2	6
OG0007365	3	2	1	0	6
OG0007366	1	1	1	3	6
OG0007367	1	1	3	1	6
OG0007368	1	1	2	2	6
OG0007369	1	1	1	3	6
OG0007370	1	1	2	2	6
OG0007371	2	1	2	1	6
OG0007372	1	1	3	1	6
OG0007373	3	1	1	1	6
OG0007374	2	2	1	1	6
OG0007375	1	1	2	2	6
OG0007376	1	0	2	3	6
OG0007377	1	0	2	3	6
OG0007378	1	1	2	2	6
OG0007379	1	1	3	1	6
OG0007380	1	1	3	1	6
OG0007381	2	2	1	1	6
OG0007382	1	1	2	2	6
OG0007383	1	1	3	1	6
OG0007384	1	1	4	0	6
OG0007385	1	1	1	3	6
OG0007386	1	1	2	2	6
OG0007387	1	1	2	2	6
OG0007388	1	0	1	4	6
OG0007389	1	1	2	2	6
OG0007390	1	1	3	1	6
OG0007391	1	1	2	2	6
OG0007392	2	2	1	1	6
OG0007393	1	1	1	3	6
OG0007394	1	1	2	2	6
OG0007395	1	2	1	2	6
OG0007396	1	1	2	2	6
OG0007397	3	1	1	1	6
OG0007398	1	1	1	3	6
OG0007399	1	1	1	3	6
OG0007400	1	1	1	3	6
OG0007401	3	1	1	1	6
OG0007402	2	2	1	1	6
OG0007403	2	1	1	2	6
OG0007404	1	1	3	1	6
OG0007405	1	1	2	2	6
OG0007406	1	1	2	2	6
OG0007407	1	1	2	2	6
OG0007408	2	2	1	1	6
OG0007409	1	1	2	2	6
OG0007410	1	1	2	2	6
OG0007411	2	1	2	1	6
OG0007412	2	1	1	2	6
OG0007413	1	1	2	2	6
OG0007414	1	1	2	2	6
OG0007415	1	1	2	2	6
OG0007416	2	1	2	1	6
OG0007417	2	1	1	2	6
OG0007418	1	1	2	2	6
OG0007419	1	1	2	2	6
OG0007420	2	1	1	2	6
OG0007421	1	1	2	2	6
OG0007422	1	1	1	3	6
OG0007423	1	1	2	2	6
OG0007424	1	3	1	1	6
OG0007425	1	1	1	3	6
OG0007426	2	1	2	1	6
OG0007427	1	1	2	2	6
OG0007428	1	0	1	4	6
OG0007429	1	0	2	3	6
OG0007430	1	1	1	3	6
OG0007431	1	1	2	2	6
OG0007432	2	1	1	2	6
OG0007433	2	3	0	1	6
OG0007434	2	1	2	1	6
OG0007435	1	3	1	1	6
OG0007436	1	1	2	2	6
OG0007437	2	2	1	1	6
OG0007438	2	1	1	2	6
OG0007439	3	1	1	1	6
OG0007440	2	2	1	1	6
OG0007441	6	0	0	0	6
OG0007442	2	1	2	1	6
OG0007443	1	1	2	2	6
OG0007444	2	1	1	2	6
OG0007445	1	1	1	3	6
OG0007446	1	1	2	2	6
OG0007447	2	1	1	2	6
OG0007448	3	1	1	1	6
OG0007449	3	1	1	1	6
OG0007450	1	1	3	1	6
OG0007451	1	1	2	2	6
OG0007452	1	1	1	3	6
OG0007453	1	1	3	1	6
OG0007454	1	2	1	2	6
OG0007455	1	1	3	1	6
OG0007456	1	1	2	2	6
OG0007457	2	1	1	2	6
OG0007458	1	1	2	2	6
OG0007459	1	1	1	3	6
OG0007460	2	1	1	2	6
OG0007461	1	1	2	2	6
OG0007462	2	2	1	1	6
OG0007463	1	1	2	2	6
OG0007464	1	1	2	2	6
OG0007465	1	1	3	1	6
OG0007466	3	2	0	1	6
OG0007467	1	1	2	2	6
OG0007468	1	1	1	3	6
OG0007469	1	2	2	1	6
OG0007470	1	1	2	2	6
OG0007471	2	1	1	2	6
OG0007472	1	1	2	2	6
OG0007473	1	1	1	3	6
OG0007474	2	2	1	1	6
OG0007475	2	2	1	1	6
OG0007476	2	2	1	1	6
OG0007477	1	1	2	2	6
OG0007478	1	1	1	3	6
OG0007479	1	1	3	1	6
OG0007480	1	1	2	2	6
OG0007481	1	2	2	1	6
OG0007482	1	3	1	1	6
OG0007483	4	2	0	0	6
OG0007484	1	1	3	1	6
OG0007485	1	1	1	3	6
OG0007486	1	1	2	2	6
OG0007487	1	1	3	1	6
OG0007488	1	1	2	2	6
OG0007489	1	5	0	0	6
OG0007490	3	3	0	0	6
OG0007491	2	1	1	2	6
OG0007492	2	1	2	1	6
OG0007493	1	1	3	1	6
OG0007494	2	1	1	2	6
OG0007495	1	1	2	2	6
OG0007496	1	1	2	2	6
OG0007497	1	1	1	3	6
OG0007498	1	1	3	1	6
OG0007499	2	1	1	2	6
OG0007500	1	1	2	2	6
OG0007501	1	1	2	2	6
OG0007502	1	1	2	2	6
OG0007503	2	1	2	1	6
OG0007504	1	5	0	0	6
OG0007505	1	1	1	3	6
OG0007506	1	1	2	2	6
OG0007507	2	1	1	2	6
OG0007508	1	1	2	2	6
OG0007509	2	1	1	2	6
OG0007510	1	0	3	2	6
OG0007511	1	1	1	3	6
OG0007512	1	1	2	2	6
OG0007513	2	1	1	2	6
OG0007514	1	1	2	2	6
OG0007515	2	1	1	2	6
OG0007516	1	3	1	1	6
OG0007517	1	1	2	2	6
OG0007518	1	2	1	2	6
OG0007519	1	3	1	1	6
OG0007520	1	1	2	2	6
OG0007521	1	1	2	2	6
OG0007522	1	1	2	2	6
OG0007523	1	1	2	2	6
OG0007524	1	1	2	2	6
OG0007525	1	1	2	2	6
OG0007526	2	1	2	1	6
OG0007527	1	1	2	2	6
OG0007528	3	1	1	1	6
OG0007529	1	1	3	1	6
OG0007530	2	2	1	1	6
OG0007531	1	1	2	2	6
OG0007532	1	1	3	1	6
OG0007533	1	1	1	3	6
OG0007534	1	1	1	3	6
OG0007535	2	2	1	1	6
OG0007536	1	1	3	1	6
OG0007537	1	1	2	2	6
OG0007538	1	0	3	2	6
OG0007539	1	2	1	2	6
OG0007540	1	1	1	3	6
OG0007541	1	1	3	1	6
OG0007542	3	1	1	1	6
OG0007543	1	1	2	2	6
OG0007544	3	0	1	2	6
OG0007545	1	1	1	3	6
OG0007546	1	1	2	2	6
OG0007547	2	1	1	2	6
OG0007548	1	1	2	2	6
OG0007549	1	0	2	3	6
OG0007550	1	1	2	2	6
OG0007551	1	1	1	3	6
OG0007552	1	2	1	2	6
OG0007553	1	1	2	2	6
OG0007554	1	1	1	3	6
OG0007555	1	0	2	3	6
OG0007556	1	1	3	1	6
OG0007557	1	1	2	2	6
OG0007558	1	1	2	2	6
OG0007559	3	1	1	1	6
OG0007560	1	1	1	3	6
OG0007561	1	1	1	3	6
OG0007562	1	1	2	2	6
OG0007563	2	0	1	3	6
OG0007564	2	1	2	1	6
OG0007565	1	1	2	2	6
OG0007566	1	1	3	1	6
OG0007567	3	2	1	0	6
OG0007568	1	1	1	3	6
OG0007569	2	2	1	1	6
OG0007570	1	1	1	3	6
OG0007571	1	1	3	1	6
OG0007572	1	1	2	2	6
OG0007573	1	1	3	1	6
OG0007574	1	1	3	1	6
OG0007575	1	1	2	2	6
OG0007576	1	1	2	2	6
OG0007577	1	1	2	2	6
OG0007578	1	1	2	2	6
OG0007579	1	2	1	2	6
OG0007580	1	1	2	2	6
OG0007581	1	1	3	1	6
OG0007582	2	1	2	1	6
OG0007583	1	1	2	2	6
OG0007584	1	1	2	2	6
OG0007585	1	1	1	3	6
OG0007586	1	1	2	2	6
OG0007587	1	4	1	0	6
OG0007588	2	1	1	2	6
OG0007589	1	5	0	0	6
OG0007590	1	1	2	2	6
OG0007591	1	1	3	1	6
OG0007592	1	1	2	2	6
OG0007593	1	1	1	3	6
OG0007594	1	1	2	2	6
OG0007595	1	1	2	2	6
OG0007596	1	1	3	1	6
OG0007597	1	1	1	3	6
OG0007598	1	1	3	1	6
OG0007599	1	1	2	2	6
OG0007600	2	1	2	1	6
OG0007601	1	1	1	3	6
OG0007602	2	2	1	1	6
OG0007603	2	1	2	1	6
OG0007604	2	2	1	1	6
OG0007605	2	1	2	1	6
OG0007606	4	2	0	0	6
OG0007607	1	1	2	2	6
OG0007608	4	2	0	0	6
OG0007609	1	1	2	2	6
OG0007610	1	1	2	2	6
OG0007611	3	1	1	1	6
OG0007612	1	1	2	2	6
OG0007613	2	2	1	1	6
OG0007614	1	1	1	3	6
OG0007615	1	1	3	1	6
OG0007616	2	0	2	2	6
OG0007617	1	1	3	1	6
OG0007618	1	1	2	2	6
OG0007619	1	1	1	3	6
OG0007620	1	0	1	4	6
OG0007621	1	5	0	0	6
OG0007622	2	1	1	2	6
OG0007623	1	1	2	2	6
OG0007624	1	1	1	3	6
OG0007625	1	1	2	2	6
OG0007626	1	1	2	2	6
OG0007627	1	1	2	2	6
OG0007628	1	1	2	2	6
OG0007629	2	2	1	1	6
OG0007630	3	1	1	1	6
OG0007631	1	1	2	2	6
OG0007632	1	1	2	2	6
OG0007633	1	1	2	2	6
OG0007634	1	1	2	2	6
OG0007635	1	1	2	2	6
OG0007636	1	1	2	2	6
OG0007637	1	1	3	1	6
OG0007638	1	1	2	2	6
OG0007639	1	1	3	1	6
OG0007640	1	1	2	2	6
OG0007641	1	1	1	3	6
OG0007642	1	1	1	3	6
OG0007643	1	1	2	2	6
OG0007644	1	1	3	1	6
OG0007645	1	1	1	3	6
OG0007646	1	1	3	1	6
OG0007647	1	1	2	2	6
OG0007648	1	1	2	2	6
OG0007649	1	1	1	3	6
OG0007650	2	2	1	1	6
OG0007651	1	1	2	2	6
OG0007652	1	0	2	3	6
OG0007653	2	1	1	2	6
OG0007654	1	1	3	1	6
OG0007655	1	1	2	2	6
OG0007656	2	2	1	1	6
OG0007657	3	1	1	1	6
OG0007658	2	1	1	2	6
OG0007659	1	1	2	2	6
OG0007660	2	1	2	1	6
OG0007661	1	1	2	2	6
OG0007662	2	1	1	2	6
OG0007663	1	1	3	1	6
OG0007664	1	1	3	1	6
OG0007665	2	1	2	1	6
OG0007666	1	1	2	2	6
OG0007667	1	1	1	3	6
OG0007668	1	1	2	2	6
OG0007669	1	5	0	0	6
OG0007670	2	2	1	1	6
OG0007671	1	1	1	3	6
OG0007672	2	1	1	2	6
OG0007673	1	1	2	2	6
OG0007674	1	1	2	2	6
OG0007675	1	1	3	1	6
OG0007676	2	1	2	1	6
OG0007677	1	1	3	1	6
OG0007678	1	1	3	1	6
OG0007679	1	1	2	2	6
OG0007680	1	1	2	2	6
OG0007681	1	1	3	1	6
OG0007682	3	1	1	1	6
OG0007683	1	1	1	3	6
OG0007684	1	1	2	2	6
OG0007685	2	1	1	2	6
OG0007686	1	1	3	1	6
OG0007687	3	1	1	1	6
OG0007688	3	1	1	1	6
OG0007689	2	1	2	1	6
OG0007690	1	3	1	1	6
OG0007691	1	1	3	1	6
OG0007692	1	2	1	2	6
OG0007693	1	1	2	2	6
OG0007694	1	1	1	3	6
OG0007695	1	1	2	2	6
OG0007696	1	1	0	4	6
OG0007697	1	0	3	2	6
OG0007698	3	1	1	1	6
OG0007699	1	1	1	3	6
OG0007700	1	1	2	2	6
OG0007701	1	1	2	2	6
OG0007702	1	0	3	2	6
OG0007703	1	1	2	2	6
OG0007704	2	1	1	2	6
OG0007705	2	1	2	1	6
OG0007706	1	1	2	2	6
OG0007707	1	1	1	3	6
OG0007708	2	1	1	2	6
OG0007709	1	1	2	2	6
OG0007710	1	1	1	3	6
OG0007711	2	2	1	1	6
OG0007712	1	1	2	2	6
OG0007713	1	1	2	2	6
OG0007714	1	1	1	3	6
OG0007715	2	2	1	1	6
OG0007716	3	1	1	1	6
OG0007717	1	1	2	2	6
OG0007718	1	1	2	2	6
OG0007719	1	1	2	2	6
OG0007720	1	2	1	2	6
OG0007721	1	0	1	4	6
OG0007722	1	1	2	2	6
OG0007723	2	1	1	2	6
OG0007724	1	1	2	2	6
OG0007725	2	1	1	2	6
OG0007726	1	1	1	3	6
OG0007727	2	1	2	1	6
OG0007728	1	3	1	1	6
OG0007729	2	1	1	2	6
OG0007730	2	2	1	1	6
OG0007731	1	0	3	2	6
OG0007732	2	1	2	1	6
OG0007733	3	1	1	1	6
OG0007734	1	1	2	2	6
OG0007735	1	1	1	3	6
OG0007736	1	1	2	2	6
OG0007737	2	1	2	1	6
OG0007738	1	1	2	2	6
OG0007739	1	1	2	2	6
OG0007740	1	1	3	1	6
OG0007741	1	1	2	2	6
OG0007742	2	1	1	2	6
OG0007743	1	1	2	2	6
OG0007744	1	1	3	1	6
OG0007745	1	0	1	4	6
OG0007746	1	1	1	3	6
OG0007747	1	1	1	3	6
OG0007748	1	1	3	1	6
OG0007749	1	1	2	2	6
OG0007750	2	2	1	1	6
OG0007751	1	1	2	2	6
OG0007752	1	1	2	2	6
OG0007753	1	1	2	2	6
OG0007754	1	1	2	2	6
OG0007755	1	1	2	2	6
OG0007756	1	1	2	2	6
OG0007757	2	2	1	1	6
OG0007758	1	1	2	2	6
OG0007759	1	1	2	2	6
OG0007760	2	1	2	1	6
OG0007761	1	1	0	4	6
OG0007762	1	1	2	2	6
OG0007763	1	1	3	1	6
OG0007764	2	1	1	2	6
OG0007765	1	1	1	3	6
OG0007766	1	1	2	2	6
OG0007767	1	1	2	2	6
OG0007768	1	2	1	2	6
OG0007769	1	1	2	2	6
OG0007770	1	1	2	2	6
OG0007771	1	1	1	3	6
OG0007772	1	1	2	2	6
OG0007773	1	1	1	3	6
OG0007774	2	1	1	2	6
OG0007775	1	1	1	3	6
OG0007776	1	1	2	2	6
OG0007777	1	1	1	3	6
OG0007778	1	0	2	3	6
OG0007779	2	2	1	1	6
OG0007780	2	1	1	2	6
OG0007781	2	2	1	1	6
OG0007782	3	2	0	1	6
OG0007783	1	2	1	2	6
OG0007784	2	1	1	2	6
OG0007785	1	1	1	3	6
OG0007786	5	1	0	0	6
OG0007787	2	2	1	1	6
OG0007788	2	3	0	1	6
OG0007789	2	1	1	2	6
OG0007790	2	4	0	0	6
OG0007791	2	1	2	1	6
OG0007792	2	1	1	2	6
OG0007793	1	1	1	3	6
OG0007794	1	1	2	2	6
OG0007795	1	1	2	2	6
OG0007796	1	1	2	2	6
OG0007797	1	1	2	2	6
OG0007798	1	1	2	2	6
OG0007799	1	1	3	1	6
OG0007800	1	0	2	3	6
OG0007801	1	1	1	3	6
OG0007802	4	1	1	0	6
OG0007803	1	1	1	3	6
OG0007804	3	1	1	1	6
OG0007805	1	1	2	2	6
OG0007806	1	1	1	3	6
OG0007807	1	1	3	1	6
OG0007808	2	1	2	1	6
OG0007809	1	1	1	3	6
OG0007810	1	1	2	2	6
OG0007811	2	1	2	1	6
OG0007812	2	1	1	2	6
OG0007813	2	2	1	1	6
OG0007814	1	1	2	2	6
OG0007815	1	1	3	1	6
OG0007816	2	2	1	1	6
OG0007817	1	1	1	3	6
OG0007818	3	1	1	1	6
OG0007819	2	1	1	2	6
OG0007820	2	1	1	2	6
OG0007821	1	1	1	3	6
OG0007822	1	1	3	1	6
OG0007823	1	1	1	3	6
OG0007824	3	1	2	0	6
OG0007825	1	1	2	2	6
OG0007826	1	1	2	2	6
OG0007827	2	2	1	1	6
OG0007828	2	1	1	2	6
OG0007829	1	1	3	1	6
OG0007830	2	1	0	3	6
OG0007831	1	0	3	2	6
OG0007832	1	1	1	3	6
OG0007833	1	1	2	2	6
OG0007834	1	1	1	3	6
OG0007835	1	1	2	2	6
OG0007836	1	1	3	1	6
OG0007837	1	1	2	2	6
OG0007838	2	1	1	2	6
OG0007839	1	1	2	2	6
OG0007840	3	1	1	1	6
OG0007841	1	1	3	1	6
OG0007842	1	1	2	2	6
OG0007843	2	1	1	2	6
OG0007844	1	1	2	2	6
OG0007845	1	1	2	2	6
OG0007846	1	1	2	2	6
OG0007847	1	3	1	1	6
OG0007848	1	1	2	2	6
OG0007849	1	1	2	2	6
OG0007850	2	1	2	1	6
OG0007851	1	1	2	2	6
OG0007852	1	1	3	1	6
OG0007853	1	1	1	3	6
OG0007854	2	1	2	1	6
OG0007855	1	1	3	1	6
OG0007856	1	1	2	2	6
OG0007857	1	1	2	2	6
OG0007858	1	1	2	2	6
OG0007859	1	1	3	1	6
OG0007860	1	1	2	2	6
OG0007861	2	2	1	1	6
OG0007862	1	1	2	2	6
OG0007863	1	1	2	2	6
OG0007864	3	1	1	1	6
OG0007865	1	1	2	2	6
OG0007866	1	1	2	2	6
OG0007867	2	2	1	1	6
OG0007868	1	1	2	2	6
OG0007869	1	1	2	2	6
OG0007870	1	1	2	2	6
OG0007871	1	1	3	1	6
OG0007872	1	1	3	1	6
OG0007873	1	1	3	1	6
OG0007874	1	5	0	0	6
OG0007875	1	1	2	2	6
OG0007876	1	1	2	2	6
OG0007877	2	1	1	2	6
OG0007878	1	1	2	2	6
OG0007879	1	1	1	3	6
OG0007880	1	1	2	2	6
OG0007881	1	1	1	3	6
OG0007882	1	1	2	2	6
OG0007883	1	1	3	1	6
OG0007884	1	1	1	3	6
OG0007885	1	1	2	2	6
OG0007886	2	1	1	2	6
OG0007887	1	1	1	3	6
OG0007888	2	1	2	1	6
OG0007889	2	1	2	1	6
OG0007890	2	2	1	1	6
OG0007891	2	2	1	1	6
OG0007892	1	1	1	3	6
OG0007893	1	1	3	1	6
OG0007894	1	2	3	0	6
OG0007895	1	1	2	2	6
OG0007896	1	1	3	1	6
OG0007897	2	1	1	2	6
OG0007898	1	1	1	3	6
OG0007899	1	1	3	1	6
OG0007900	1	1	2	2	6
OG0007901	1	1	3	1	6
OG0007902	2	1	2	1	6
OG0007903	2	2	1	1	6
OG0007904	2	1	2	1	6
OG0007905	1	0	1	4	6
OG0007906	1	1	1	3	6
OG0007907	1	0	3	2	6
OG0007908	1	1	1	3	6
OG0007909	2	1	2	1	6
OG0007910	1	1	2	2	6
OG0007911	2	1	1	2	6
OG0007912	2	2	1	1	6
OG0007913	1	1	2	2	6
OG0007914	1	1	2	2	6
OG0007915	1	1	1	3	6
OG0007916	2	1	1	2	6
OG0007917	2	2	1	1	6
OG0007918	1	1	1	3	6
OG0007919	1	1	1	3	6
OG0007920	1	1	1	3	6
OG0007921	1	1	1	3	6
OG0007922	1	2	2	1	6
OG0007923	1	1	2	2	6
OG0007924	1	1	3	1	6
OG0007925	1	1	2	2	6
OG0007926	2	1	2	1	6
OG0007927	2	1	1	2	6
OG0007928	1	1	2	2	6
OG0007929	1	1	2	2	6
OG0007930	3	1	1	1	6
OG0007931	5	1	0	0	6
OG0007932	2	1	2	1	6
OG0007933	1	1	3	1	6
OG0007934	1	1	1	3	6
OG0007935	1	1	2	2	6
OG0007936	3	1	1	1	6
OG0007937	3	1	1	1	6
OG0007938	1	1	2	2	6
OG0007939	1	1	2	2	6
OG0007940	1	1	2	2	6
OG0007941	1	1	2	2	6
OG0007942	1	1	2	2	6
OG0007943	1	1	2	2	6
OG0007944	2	0	2	2	6
OG0007945	1	1	2	2	6
OG0007946	1	2	2	1	6
OG0007947	1	1	1	3	6
OG0007948	1	1	2	2	6
OG0007949	2	1	1	2	6
OG0007950	1	0	1	4	6
OG0007951	2	1	1	2	6
OG0007952	1	1	2	2	6
OG0007953	1	1	1	3	6
OG0007954	2	1	2	1	6
OG0007955	1	1	3	1	6
OG0007956	1	1	3	1	6
OG0007957	1	1	0	4	6
OG0007958	1	1	2	2	6
OG0007959	1	1	1	3	6
OG0007960	2	1	1	2	6
OG0007961	1	1	1	3	6
OG0007962	1	1	3	1	6
OG0007963	1	1	1	3	6
OG0007964	1	1	1	3	6
OG0007965	2	1	2	1	6
OG0007966	1	1	2	2	6
OG0007967	1	1	2	2	6
OG0007968	1	1	1	3	6
OG0007969	1	1	2	2	6
OG0007970	1	1	2	2	6
OG0007971	1	1	3	1	6
OG0007972	1	1	2	2	6
OG0007973	1	1	2	2	6
OG0007974	2	2	1	1	6
OG0007975	2	3	0	1	6
OG0007976	1	1	2	2	6
OG0007977	1	1	2	2	6
OG0007978	2	2	1	1	6
OG0007979	1	1	1	3	6
OG0007980	1	1	3	1	6
OG0007981	1	1	1	3	6
OG0007982	1	1	1	3	6
OG0007983	1	1	2	2	6
OG0007984	1	2	1	2	6
OG0007985	2	2	1	1	6
OG0007986	1	1	2	2	6
OG0007987	1	1	2	2	6
OG0007988	1	1	1	3	6
OG0007989	2	2	1	1	6
OG0007990	1	1	2	2	6
OG0007991	1	1	2	2	6
OG0007992	2	1	2	1	6
OG0007993	2	2	1	1	6
OG0007994	1	1	1	3	6
OG0007995	1	1	2	2	6
OG0007996	1	1	1	3	6
OG0007997	1	3	1	1	6
OG0007998	1	1	2	2	6
OG0007999	3	1	1	1	6
OG0008000	2	1	1	2	6
OG0008001	1	1	2	2	6
OG0008002	1	1	2	2	6
OG0008003	1	1	2	2	6
OG0008004	1	1	2	2	6
OG0008005	1	1	3	1	6
OG0008006	2	1	1	2	6
OG0008007	2	1	1	2	6
OG0008008	2	1	1	2	6
OG0008009	1	5	0	0	6
OG0008010	1	1	2	2	6
OG0008011	2	1	2	1	6
OG0008012	1	1	2	2	6
OG0008013	1	1	3	1	6
OG0008014	3	1	1	1	6
OG0008015	2	2	1	1	6
OG0008016	3	1	1	1	6
OG0008017	1	1	2	2	6
OG0008018	1	1	2	2	6
OG0008019	1	5	0	0	6
OG0008020	1	1	1	3	6
OG0008021	3	1	1	1	6
OG0008022	4	2	0	0	6
OG0008023	1	1	2	2	6
OG0008024	2	2	1	1	6
OG0008025	1	1	3	1	6
OG0008026	1	2	1	2	6
OG0008027	1	3	1	1	6
OG0008028	1	1	3	1	6
OG0008029	1	1	1	3	6
OG0008030	2	1	1	2	6
OG0008031	1	1	3	1	6
OG0008032	1	1	2	2	6
OG0008033	1	1	2	2	6
OG0008034	1	2	2	1	6
OG0008035	1	3	1	1	6
OG0008036	1	2	2	1	6
OG0008037	1	1	2	2	6
OG0008038	1	1	1	3	6
OG0008039	1	1	2	2	6
OG0008040	1	1	2	2	6
OG0008041	1	2	1	2	6
OG0008042	1	1	2	2	6
OG0008043	1	1	2	2	6
OG0008044	1	1	3	1	6
OG0008045	1	1	1	3	6
OG0008046	1	0	2	3	6
OG0008047	2	1	1	2	6
OG0008048	1	1	3	1	6
OG0008049	1	1	1	3	6
OG0008050	1	1	3	1	6
OG0008051	1	1	2	2	6
OG0008052	1	2	1	2	6
OG0008053	1	1	2	2	6
OG0008054	2	0	3	1	6
OG0008055	1	0	2	3	6
OG0008056	1	0	2	3	6
OG0008057	2	1	1	2	6
OG0008058	2	1	2	1	6
OG0008059	1	1	1	3	6
OG0008060	1	1	2	2	6
OG0008061	2	2	1	1	6
OG0008062	1	1	2	2	6
OG0008063	1	1	1	3	6
OG0008064	3	1	1	1	6
OG0008065	1	1	2	2	6
OG0008066	3	1	1	1	6
OG0008067	1	1	1	3	6
OG0008068	1	1	1	3	6
OG0008069	1	2	2	1	6
OG0008070	2	2	1	1	6
OG0008071	1	1	2	2	6
OG0008072	1	1	2	2	6
OG0008073	1	1	2	2	6
OG0008074	1	1	1	3	6
OG0008075	1	1	2	2	6
OG0008076	1	0	3	2	6
OG0008077	1	1	2	2	6
OG0008078	1	1	2	2	6
OG0008079	1	1	2	2	6
OG0008080	1	1	2	2	6
OG0008081	2	1	2	1	6
OG0008082	1	1	2	2	6
OG0008083	1	1	1	3	6
OG0008084	1	1	2	2	6
OG0008085	1	1	2	2	6
OG0008086	1	1	2	2	6
OG0008087	1	1	2	2	6
OG0008088	2	1	1	2	6
OG0008089	1	1	3	1	6
OG0008090	2	1	1	2	6
OG0008091	2	1	1	2	6
OG0008092	1	1	2	2	6
OG0008093	1	1	3	1	6
OG0008094	1	0	1	4	6
OG0008095	1	1	2	2	6
OG0008096	1	1	2	2	6
OG0008097	2	1	1	2	6
OG0008098	1	1	2	2	6
OG0008099	1	1	2	2	6
OG0008100	1	1	2	2	6
OG0008101	1	1	2	2	6
OG0008102	1	1	3	1	6
OG0008103	1	1	2	2	6
OG0008104	2	1	1	2	6
OG0008105	1	1	2	2	6
OG0008106	1	1	2	2	6
OG0008107	1	1	2	2	6
OG0008108	1	1	1	3	6
OG0008109	1	1	3	1	6
OG0008110	1	0	3	2	6
OG0008111	1	5	0	0	6
OG0008112	1	1	2	2	6
OG0008113	1	1	2	2	6
OG0008114	1	2	1	2	6
OG0008115	1	1	2	2	6
OG0008116	1	1	1	3	6
OG0008117	1	1	2	2	6
OG0008118	2	1	2	1	6
OG0008119	1	1	1	3	6
OG0008120	1	1	2	2	6
OG0008121	1	1	1	3	6
OG0008122	1	1	2	2	6
OG0008123	1	0	2	3	6
OG0008124	1	1	2	2	6
OG0008125	1	1	3	1	6
OG0008126	1	1	2	2	6
OG0008127	1	5	0	0	6
OG0008128	1	2	2	1	6
OG0008129	2	1	1	2	6
OG0008130	1	1	2	2	6
OG0008131	1	1	1	3	6
OG0008132	1	1	1	3	6
OG0008133	2	1	1	2	6
OG0008134	1	1	1	3	6
OG0008135	1	1	2	2	6
OG0008136	1	1	1	3	6
OG0008137	2	1	1	2	6
OG0008138	1	1	3	1	6
OG0008139	1	2	2	1	6
OG0008140	1	1	2	2	6
OG0008141	1	2	1	2	6
OG0008142	3	2	1	0	6
OG0008143	1	1	1	3	6
OG0008144	1	1	2	2	6
OG0008145	2	2	1	1	6
OG0008146	1	5	0	0	6
OG0008147	1	1	1	3	6
OG0008148	2	1	2	1	6
OG0008149	1	1	2	2	6
OG0008150	1	1	2	2	6
OG0008151	1	5	0	0	6
OG0008152	1	1	2	2	6
OG0008153	1	1	3	1	6
OG0008154	1	1	1	3	6
OG0008155	1	3	1	1	6
OG0008156	6	0	0	0	6
OG0008157	2	1	2	1	6
OG0008158	2	1	2	1	6
OG0008159	1	1	2	2	6
OG0008160	1	1	2	2	6
OG0008161	1	1	3	1	6
OG0008162	1	1	2	2	6
OG0008163	1	1	2	2	6
OG0008164	1	1	3	1	6
OG0008165	1	2	1	2	6
OG0008166	1	1	1	3	6
OG0008167	2	2	1	1	6
OG0008168	1	1	2	2	6
OG0008169	1	5	0	0	6
OG0008170	1	1	2	2	6
OG0008171	1	1	3	1	6
OG0008172	1	1	2	2	6
OG0008173	1	1	3	1	6
OG0008174	1	1	3	1	6
OG0008175	1	1	3	1	6
OG0008176	1	0	5	0	6
OG0008177	6	0	0	0	6
OG0008178	2	1	1	2	6
OG0008179	1	1	3	1	6
OG0008180	2	1	1	2	6
OG0008181	1	1	2	2	6
OG0008182	1	1	3	1	6
OG0008183	2	2	1	1	6
OG0008184	1	1	1	3	6
OG0008185	1	1	3	1	6
OG0008186	6	0	0	0	6
OG0008187	1	1	1	3	6
OG0008188	1	5	0	0	6
OG0008189	1	1	2	2	6
OG0008190	1	1	2	2	6
OG0008191	1	1	1	3	6
OG0008192	1	0	3	2	6
OG0008193	1	1	3	1	6
OG0008194	1	2	1	2	6
OG0008195	1	1	2	2	6
OG0008196	2	1	2	1	6
OG0008197	1	1	2	2	6
OG0008198	1	1	2	2	6
OG0008199	0	6	0	0	6
OG0008200	0	6	0	0	6
OG0008201	0	6	0	0	6
OG0008202	0	6	0	0	6
OG0008203	0	6	0	0	6
OG0008204	0	6	0	0	6
OG0008205	0	6	0	0	6
OG0008206	0	6	0	0	6
OG0008207	0	6	0	0	6
OG0008208	0	6	0	0	6
OG0008209	0	6	0	0	6
OG0008210	0	6	0	0	6
OG0008211	0	6	0	0	6
OG0008212	0	6	0	0	6
OG0008213	0	6	0	0	6
OG0008214	0	5	0	1	6
OG0008215	0	6	0	0	6
OG0008216	0	6	0	0	6
OG0008217	0	6	0	0	6
OG0008218	0	2	3	1	6
OG0008219	0	6	0	0	6
OG0008220	0	6	0	0	6
OG0008221	0	6	0	0	6
OG0008222	0	1	5	0	6
OG0008223	0	6	0	0	6
OG0008224	0	6	0	0	6
OG0008225	0	6	0	0	6
OG0008226	0	6	0	0	6
OG0008227	0	4	1	1	6
OG0008228	0	4	2	0	6
OG0008229	0	5	1	0	6
OG0008230	0	6	0	0	6
OG0008231	0	4	0	2	6
OG0008232	0	6	0	0	6
OG0008233	0	1	2	3	6
OG0008234	0	1	0	5	6
OG0008235	0	1	2	3	6
OG0008236	0	1	2	3	6
OG0008237	0	6	0	0	6
OG0008238	0	6	0	0	6
OG0008239	0	1	4	1	6
OG0008240	0	4	1	1	6
OG0008241	0	6	0	0	6
OG0008242	0	6	0	0	6
OG0008243	0	6	0	0	6
OG0008244	0	6	0	0	6
OG0008245	0	6	0	0	6
OG0008246	0	1	0	5	6
OG0008247	0	6	0	0	6
OG0008248	0	6	0	0	6
OG0008249	0	6	0	0	6
OG0008250	0	2	1	3	6
OG0008251	0	4	2	0	6
OG0008252	0	6	0	0	6
OG0008253	0	6	0	0	6
OG0008254	0	6	0	0	6
OG0008255	0	6	0	0	6
OG0008256	0	1	4	1	6
OG0008257	0	6	0	0	6
OG0008258	0	6	0	0	6
OG0008259	0	6	0	0	6
OG0008260	0	6	0	0	6
OG0008261	0	6	0	0	6
OG0008262	0	6	0	0	6
OG0008263	0	6	0	0	6
OG0008264	0	5	0	1	6
OG0008265	0	1	3	2	6
OG0008266	0	6	0	0	6
OG0008267	0	6	0	0	6
OG0008268	0	6	0	0	6
OG0008269	0	3	3	0	6
OG0008270	0	6	0	0	6
OG0008271	0	2	2	2	6
OG0008272	0	2	3	1	6
OG0008273	0	1	4	1	6
OG0008274	0	6	0	0	6
OG0008275	0	1	2	3	6
OG0008276	0	6	0	0	6
OG0008277	0	6	0	0	6
OG0008278	0	6	0	0	6
OG0008279	0	6	0	0	6
OG0008280	0	6	0	0	6
OG0008281	0	6	0	0	6
OG0008282	0	2	1	3	6
OG0008283	0	6	0	0	6
OG0008284	0	6	0	0	6
OG0008285	0	6	0	0	6
OG0008286	0	6	0	0	6
OG0008287	0	2	4	0	6
OG0008288	0	1	3	2	6
OG0008289	0	6	0	0	6
OG0008290	0	6	0	0	6
OG0008291	0	6	0	0	6
OG0008292	0	1	3	2	6
OG0008293	0	1	1	4	6
OG0008294	0	2	2	2	6
OG0008295	0	6	0	0	6
OG0008296	0	1	1	4	6
OG0008297	0	6	0	0	6
OG0008298	0	6	0	0	6
OG0008299	0	1	3	2	6
OG0008300	0	1	3	2	6
OG0008301	0	4	1	1	6
OG0008302	0	6	0	0	6
OG0008303	0	2	4	0	6
OG0008304	0	6	0	0	6
OG0008305	0	2	3	1	6
OG0008306	0	6	0	0	6
OG0008307	0	2	2	2	6
OG0008308	0	1	2	3	6
OG0008309	0	2	2	2	6
OG0008310	0	1	4	1	6
OG0008311	0	1	2	3	6
OG0008312	0	6	0	0	6
OG0008313	0	4	1	1	6
OG0008314	0	2	3	1	6
OG0008315	0	1	2	3	6
OG0008316	0	6	0	0	6
OG0008317	0	6	0	0	6
OG0008318	0	2	2	2	6
OG0008319	0	2	2	2	6
OG0008320	0	2	1	3	6
OG0008321	0	2	2	2	6
OG0008322	0	1	0	5	6
OG0008323	0	1	3	2	6
OG0008324	0	1	4	1	6
OG0008325	0	6	0	0	6
OG0008326	0	0	5	1	6
OG0008327	0	0	6	0	6
OG0008328	0	0	4	2	6
OG0008329	0	0	2	4	6
OG0008330	0	0	6	0	6
OG0008331	0	0	3	3	6
OG0008332	0	0	6	0	6
OG0008333	0	0	6	0	6
OG0008334	0	0	5	1	6
OG0008335	0	0	4	2	6
OG0008336	0	0	4	2	6
OG0008337	0	0	1	5	6
OG0008338	0	0	6	0	6
OG0008339	0	0	6	0	6
OG0008340	0	0	1	5	6
OG0008341	0	0	1	5	6
OG0008342	0	0	3	3	6
OG0008343	0	0	3	3	6
OG0008344	0	0	5	1	6
OG0008345	0	0	2	4	6
OG0008346	0	0	4	2	6
OG0008347	0	0	1	5	6
OG0008348	0	0	1	5	6
OG0008349	0	0	2	4	6
OG0008350	0	0	2	4	6
OG0008351	0	0	3	3	6
OG0008352	0	0	4	2	6
OG0008353	0	0	4	2	6
OG0008354	0	0	2	4	6
OG0008355	0	0	1	5	6
OG0008356	0	0	4	2	6
OG0008357	0	0	3	3	6
OG0008358	0	0	4	2	6
OG0008359	0	0	2	4	6
OG0008360	0	0	4	2	6
OG0008361	0	0	3	3	6
OG0008362	0	0	1	5	6
OG0008363	0	0	5	1	6
OG0008364	0	0	2	4	6
OG0008365	0	0	1	5	6
OG0008366	0	0	1	5	6
OG0008367	0	0	4	2	6
OG0008368	0	0	1	5	6
OG0008369	0	0	4	2	6
OG0008370	0	0	2	4	6
OG0008371	0	0	2	4	6
OG0008372	0	0	6	0	6
OG0008373	0	0	4	2	6
OG0008374	0	0	1	5	6
OG0008375	0	0	3	3	6
OG0008376	0	0	1	5	6
OG0008377	0	0	3	3	6
OG0008378	0	0	3	3	6
OG0008379	0	0	3	3	6
OG0008380	0	0	1	5	6
OG0008381	0	0	1	5	6
OG0008382	0	0	1	5	6
OG0008383	0	0	4	2	6
OG0008384	0	0	4	2	6
OG0008385	0	0	2	4	6
OG0008386	0	0	3	3	6
OG0008387	0	0	3	3	6
OG0008388	0	0	1	5	6
OG0008389	0	0	2	4	6
OG0008390	0	0	3	3	6
OG0008391	0	0	6	0	6
OG0008392	0	0	1	5	6
OG0008393	0	0	2	4	6
OG0008394	0	0	1	5	6
OG0008395	0	0	4	2	6
OG0008396	0	0	5	1	6
OG0008397	0	0	2	4	6
OG0008398	0	0	1	5	6
OG0008399	0	0	1	5	6
OG0008400	0	0	2	4	6
OG0008401	0	0	4	2	6
OG0008402	0	0	1	5	6
OG0008403	0	0	2	4	6
OG0008404	0	0	3	3	6
OG0008405	0	0	3	3	6
OG0008406	0	0	2	4	6
OG0008407	0	0	1	5	6
OG0008408	0	0	3	3	6
OG0008409	0	0	1	5	6
OG0008410	0	0	6	0	6
OG0008411	0	0	3	3	6
OG0008412	0	0	2	4	6
OG0008413	0	0	2	4	6
OG0008414	0	0	1	5	6
OG0008415	0	0	3	3	6
OG0008416	0	0	3	3	6
OG0008417	0	0	0	6	6
OG0008418	0	0	0	6	6
OG0008419	0	0	0	6	6
OG0008420	0	0	0	6	6
OG0008421	0	0	0	6	6
OG0008422	0	0	0	6	6
OG0008423	0	0	0	6	6
OG0008424	0	0	0	6	6
OG0008425	0	0	0	6	6
OG0008426	0	0	0	6	6
OG0008427	0	0	0	6	6
OG0008428	0	0	0	6	6
OG0008429	0	0	0	6	6
OG0008430	0	0	0	6	6
OG0008431	0	0	0	6	6
OG0008432	0	0	0	6	6
OG0008433	0	0	0	6	6
OG0008434	0	0	0	6	6
OG0008435	0	0	0	6	6
OG0008436	0	0	0	6	6
OG0008437	0	0	0	6	6
OG0008438	0	0	0	6	6
OG0008439	0	0	0	6	6
OG0008440	1	2	1	1	5
OG0008441	2	1	1	1	5
OG0008442	2	3	0	0	5
OG0008443	5	0	0	0	5
OG0008444	1	0	2	2	5
OG0008445	1	1	1	2	5
OG0008446	1	1	1	2	5
OG0008447	2	1	1	1	5
OG0008448	1	2	1	1	5
OG0008449	1	2	1	1	5
OG0008450	1	0	2	2	5
OG0008451	2	1	1	1	5
OG0008452	4	1	0	0	5
OG0008453	1	1	1	2	5
OG0008454	1	1	1	2	5
OG0008455	1	1	1	2	5
OG0008456	4	1	0	0	5
OG0008457	1	1	1	2	5
OG0008458	4	1	0	0	5
OG0008459	2	1	1	1	5
OG0008460	2	1	1	1	5
OG0008461	4	1	0	0	5
OG0008462	2	1	1	1	5
OG0008463	2	3	0	0	5
OG0008464	1	1	1	2	5
OG0008465	1	1	1	2	5
OG0008466	2	3	0	0	5
OG0008467	3	2	0	0	5
OG0008468	4	1	0	0	5
OG0008469	5	0	0	0	5
OG0008470	1	1	1	2	5
OG0008471	1	1	1	2	5
OG0008472	2	1	1	1	5
OG0008473	1	2	1	1	5
OG0008474	2	3	0	0	5
OG0008475	1	1	1	2	5
OG0008476	1	1	2	1	5
OG0008477	4	1	0	0	5
OG0008478	2	1	1	1	5
OG0008479	1	1	1	2	5
OG0008480	4	1	0	0	5
OG0008481	3	2	0	0	5
OG0008482	2	1	1	1	5
OG0008483	1	4	0	0	5
OG0008484	1	1	1	2	5
OG0008485	3	0	1	1	5
OG0008486	1	1	2	1	5
OG0008487	1	0	0	4	5
OG0008488	1	2	1	1	5
OG0008489	2	1	1	1	5
OG0008490	4	1	0	0	5
OG0008491	1	1	2	1	5
OG0008492	1	4	0	0	5
OG0008493	2	1	1	1	5
OG0008494	1	1	1	2	5
OG0008495	5	0	0	0	5
OG0008496	2	3	0	0	5
OG0008497	2	1	1	1	5
OG0008498	5	0	0	0	5
OG0008499	2	1	1	1	5
OG0008500	2	0	1	2	5
OG0008501	1	1	1	2	5
OG0008502	1	1	1	2	5
OG0008503	1	1	1	2	5
OG0008504	2	1	1	1	5
OG0008505	2	1	1	1	5
OG0008506	1	4	0	0	5
OG0008507	2	3	0	0	5
OG0008508	2	1	1	1	5
OG0008509	2	1	1	1	5
OG0008510	2	1	1	1	5
OG0008511	1	4	0	0	5
OG0008512	1	1	1	2	5
OG0008513	2	1	1	1	5
OG0008514	2	3	0	0	5
OG0008515	1	1	1	2	5
OG0008516	1	1	1	2	5
OG0008517	2	1	1	1	5
OG0008518	1	1	1	2	5
OG0008519	3	2	0	0	5
OG0008520	2	1	1	1	5
OG0008521	1	1	2	1	5
OG0008522	1	4	0	0	5
OG0008523	1	1	2	1	5
OG0008524	1	1	1	2	5
OG0008525	1	1	1	2	5
OG0008526	1	1	1	2	5
OG0008527	1	1	1	2	5
OG0008528	2	3	0	0	5
OG0008529	3	0	1	1	5
OG0008530	1	1	2	1	5
OG0008531	2	3	0	0	5
OG0008532	2	1	0	2	5
OG0008533	1	1	1	2	5
OG0008534	2	3	0	0	5
OG0008535	1	2	1	1	5
OG0008536	2	1	1	1	5
OG0008537	1	1	1	2	5
OG0008538	1	1	1	2	5
OG0008539	2	1	1	1	5
OG0008540	1	1	1	2	5
OG0008541	2	1	1	1	5
OG0008542	2	1	1	1	5
OG0008543	2	3	0	0	5
OG0008544	1	0	3	1	5
OG0008545	2	3	0	0	5
OG0008546	2	1	1	1	5
OG0008547	1	1	2	1	5
OG0008548	1	1	1	2	5
OG0008549	2	0	1	2	5
OG0008550	1	1	2	1	5
OG0008551	1	1	1	2	5
OG0008552	1	3	1	0	5
OG0008553	5	0	0	0	5
OG0008554	1	1	1	2	5
OG0008555	1	1	1	2	5
OG0008556	1	2	1	1	5
OG0008557	1	1	2	1	5
OG0008558	1	1	2	1	5
OG0008559	1	1	1	2	5
OG0008560	4	1	0	0	5
OG0008561	1	0	2	2	5
OG0008562	1	1	1	2	5
OG0008563	2	2	1	0	5
OG0008564	1	1	2	1	5
OG0008565	1	1	1	2	5
OG0008566	1	1	2	1	5
OG0008567	1	1	1	2	5
OG0008568	2	1	1	1	5
OG0008569	2	1	1	1	5
OG0008570	2	1	1	1	5
OG0008571	1	1	2	1	5
OG0008572	1	1	2	1	5
OG0008573	1	1	2	1	5
OG0008574	1	1	1	2	5
OG0008575	2	1	1	1	5
OG0008576	1	1	1	2	5
OG0008577	1	1	2	1	5
OG0008578	1	1	2	1	5
OG0008579	1	1	1	2	5
OG0008580	2	1	1	1	5
OG0008581	3	2	0	0	5
OG0008582	5	0	0	0	5
OG0008583	1	1	1	2	5
OG0008584	1	1	2	1	5
OG0008585	2	1	1	1	5
OG0008586	3	2	0	0	5
OG0008587	1	4	0	0	5
OG0008588	1	2	1	1	5
OG0008589	1	1	2	1	5
OG0008590	1	1	2	1	5
OG0008591	1	1	1	2	5
OG0008592	1	0	3	1	5
OG0008593	1	1	1	2	5
OG0008594	1	1	2	1	5
OG0008595	1	1	1	2	5
OG0008596	2	1	1	1	5
OG0008597	2	1	1	1	5
OG0008598	4	1	0	0	5
OG0008599	2	1	1	1	5
OG0008600	2	1	1	1	5
OG0008601	1	1	2	1	5
OG0008602	1	1	1	2	5
OG0008603	1	1	1	2	5
OG0008604	1	1	1	2	5
OG0008605	1	0	1	3	5
OG0008606	1	0	2	2	5
OG0008607	1	1	2	1	5
OG0008608	2	1	1	1	5
OG0008609	1	1	2	1	5
OG0008610	1	1	1	2	5
OG0008611	1	1	1	2	5
OG0008612	2	1	1	1	5
OG0008613	2	1	1	1	5
OG0008614	1	1	2	1	5
OG0008615	1	1	2	1	5
OG0008616	1	1	1	2	5
OG0008617	1	1	2	1	5
OG0008618	1	1	2	1	5
OG0008619	1	1	1	2	5
OG0008620	1	1	2	1	5
OG0008621	1	1	2	1	5
OG0008622	4	1	0	0	5
OG0008623	1	1	2	1	5
OG0008624	2	1	1	1	5
OG0008625	1	1	2	1	5
OG0008626	1	1	2	1	5
OG0008627	2	1	1	1	5
OG0008628	1	1	1	2	5
OG0008629	1	1	2	1	5
OG0008630	1	1	1	2	5
OG0008631	2	1	1	1	5
OG0008632	1	1	1	2	5
OG0008633	1	1	1	2	5
OG0008634	1	1	2	1	5
OG0008635	1	1	1	2	5
OG0008636	1	1	1	2	5
OG0008637	2	1	1	1	5
OG0008638	1	1	2	1	5
OG0008639	1	1	1	2	5
OG0008640	1	1	1	2	5
OG0008641	1	1	1	2	5
OG0008642	1	1	2	1	5
OG0008643	1	1	2	1	5
OG0008644	1	2	1	1	5
OG0008645	1	1	1	2	5
OG0008646	1	1	2	1	5
OG0008647	1	1	1	2	5
OG0008648	1	1	1	2	5
OG0008649	2	1	1	1	5
OG0008650	2	1	1	1	5
OG0008651	1	1	1	2	5
OG0008652	2	1	1	1	5
OG0008653	2	1	1	1	5
OG0008654	1	1	1	2	5
OG0008655	2	1	1	1	5
OG0008656	1	2	1	1	5
OG0008657	1	1	2	1	5
OG0008658	1	1	1	2	5
OG0008659	2	1	1	1	5
OG0008660	1	1	2	1	5
OG0008661	2	1	1	1	5
OG0008662	2	1	1	1	5
OG0008663	1	1	2	1	5
OG0008664	1	1	1	2	5
OG0008665	1	1	1	2	5
OG0008666	1	1	1	2	5
OG0008667	2	1	1	1	5
OG0008668	1	1	2	1	5
OG0008669	4	1	0	0	5
OG0008670	1	1	2	1	5
OG0008671	1	1	2	1	5
OG0008672	1	1	2	1	5
OG0008673	2	1	1	1	5
OG0008674	1	1	1	2	5
OG0008675	2	1	1	1	5
OG0008676	1	1	1	2	5
OG0008677	1	1	1	2	5
OG0008678	2	2	1	0	5
OG0008679	1	2	1	1	5
OG0008680	1	1	1	2	5
OG0008681	1	1	1	2	5
OG0008682	2	1	1	1	5
OG0008683	1	1	1	2	5
OG0008684	2	1	1	1	5
OG0008685	2	1	1	1	5
OG0008686	1	2	1	1	5
OG0008687	1	1	2	1	5
OG0008688	2	1	1	1	5
OG0008689	1	1	1	2	5
OG0008690	1	1	1	2	5
OG0008691	1	1	1	2	5
OG0008692	1	1	2	1	5
OG0008693	1	1	2	1	5
OG0008694	1	0	2	2	5
OG0008695	1	0	2	2	5
OG0008696	1	1	1	2	5
OG0008697	1	1	2	1	5
OG0008698	1	1	1	2	5
OG0008699	1	1	1	2	5
OG0008700	2	1	1	1	5
OG0008701	2	1	1	1	5
OG0008702	1	1	1	2	5
OG0008703	1	1	1	2	5
OG0008704	1	1	2	1	5
OG0008705	2	1	1	1	5
OG0008706	1	1	1	2	5
OG0008707	1	1	1	2	5
OG0008708	1	1	2	1	5
OG0008709	1	1	2	1	5
OG0008710	1	1	2	1	5
OG0008711	1	1	1	2	5
OG0008712	1	1	2	1	5
OG0008713	1	1	2	1	5
OG0008714	1	1	1	2	5
OG0008715	1	1	2	1	5
OG0008716	4	1	0	0	5
OG0008717	4	1	0	0	5
OG0008718	1	2	1	1	5
OG0008719	1	1	1	2	5
OG0008720	1	1	2	1	5
OG0008721	1	1	2	1	5
OG0008722	1	1	2	1	5
OG0008723	1	1	2	1	5
OG0008724	1	1	2	1	5
OG0008725	1	1	1	2	5
OG0008726	1	1	1	2	5
OG0008727	1	1	2	1	5
OG0008728	1	1	1	2	5
OG0008729	1	1	2	1	5
OG0008730	1	1	1	2	5
OG0008731	1	1	1	2	5
OG0008732	1	1	2	1	5
OG0008733	1	1	2	1	5
OG0008734	2	1	1	1	5
OG0008735	1	1	1	2	5
OG0008736	1	1	1	2	5
OG0008737	1	1	1	2	5
OG0008738	1	1	1	2	5
OG0008739	1	1	1	2	5
OG0008740	1	1	1	2	5
OG0008741	1	1	2	1	5
OG0008742	1	0	2	2	5
OG0008743	1	1	2	1	5
OG0008744	1	1	2	1	5
OG0008745	1	1	2	1	5
OG0008746	1	1	2	1	5
OG0008747	1	1	2	1	5
OG0008748	1	1	1	2	5
OG0008749	2	1	1	1	5
OG0008750	1	1	2	1	5
OG0008751	1	1	1	2	5
OG0008752	1	0	2	2	5
OG0008753	2	0	2	1	5
OG0008754	1	1	2	1	5
OG0008755	1	1	1	2	5
OG0008756	1	1	1	2	5
OG0008757	1	1	1	2	5
OG0008758	1	1	2	1	5
OG0008759	1	1	1	2	5
OG0008760	1	2	1	1	5
OG0008761	1	1	2	1	5
OG0008762	2	1	1	1	5
OG0008763	1	1	2	1	5
OG0008764	2	1	1	1	5
OG0008765	1	2	1	1	5
OG0008766	1	1	2	1	5
OG0008767	1	1	1	2	5
OG0008768	1	1	1	2	5
OG0008769	1	1	1	2	5
OG0008770	1	1	2	1	5
OG0008771	1	2	1	1	5
OG0008772	2	1	1	1	5
OG0008773	2	1	1	1	5
OG0008774	1	1	1	2	5
OG0008775	1	1	2	1	5
OG0008776	1	1	2	1	5
OG0008777	1	1	1	2	5
OG0008778	3	0	1	1	5
OG0008779	1	1	2	1	5
OG0008780	1	1	1	2	5
OG0008781	1	1	1	2	5
OG0008782	1	1	2	1	5
OG0008783	2	1	1	1	5
OG0008784	1	1	2	1	5
OG0008785	1	1	1	2	5
OG0008786	2	1	1	1	5
OG0008787	1	2	1	1	5
OG0008788	1	1	2	1	5
OG0008789	1	1	1	2	5
OG0008790	1	2	1	1	5
OG0008791	2	1	1	1	5
OG0008792	1	1	2	1	5
OG0008793	1	1	2	1	5
OG0008794	2	1	2	0	5
OG0008795	1	1	2	1	5
OG0008796	1	1	2	1	5
OG0008797	1	1	1	2	5
OG0008798	1	1	2	1	5
OG0008799	1	1	2	1	5
OG0008800	1	1	1	2	5
OG0008801	2	1	1	1	5
OG0008802	1	2	1	1	5
OG0008803	1	1	1	2	5
OG0008804	2	1	1	1	5
OG0008805	1	1	1	2	5
OG0008806	1	1	1	2	5
OG0008807	1	1	1	2	5
OG0008808	1	4	0	0	5
OG0008809	1	1	2	1	5
OG0008810	2	1	1	1	5
OG0008811	1	0	1	3	5
OG0008812	1	2	1	1	5
OG0008813	1	1	2	1	5
OG0008814	2	1	1	1	5
OG0008815	1	1	1	2	5
OG0008816	1	1	2	1	5
OG0008817	1	1	2	1	5
OG0008818	1	1	1	2	5
OG0008819	1	1	2	1	5
OG0008820	1	1	2	1	5
OG0008821	1	1	2	1	5
OG0008822	1	1	2	1	5
OG0008823	1	1	1	2	5
OG0008824	2	1	1	1	5
OG0008825	1	3	0	1	5
OG0008826	1	1	1	2	5
OG0008827	2	1	1	1	5
OG0008828	1	1	1	2	5
OG0008829	1	1	2	1	5
OG0008830	1	1	2	1	5
OG0008831	1	1	2	1	5
OG0008832	1	2	1	1	5
OG0008833	1	1	1	2	5
OG0008834	2	1	1	1	5
OG0008835	1	1	1	2	5
OG0008836	1	1	2	1	5
OG0008837	2	1	1	1	5
OG0008838	1	1	1	2	5
OG0008839	1	1	1	2	5
OG0008840	3	2	0	0	5
OG0008841	2	1	1	1	5
OG0008842	1	1	1	2	5
OG0008843	2	1	1	1	5
OG0008844	1	1	2	1	5
OG0008845	1	1	1	2	5
OG0008846	1	1	2	1	5
OG0008847	1	1	2	1	5
OG0008848	1	1	1	2	5
OG0008849	1	1	2	1	5
OG0008850	1	1	2	1	5
OG0008851	2	1	1	1	5
OG0008852	1	1	2	1	5
OG0008853	2	1	1	1	5
OG0008854	1	1	1	2	5
OG0008855	1	1	2	1	5
OG0008856	1	1	1	2	5
OG0008857	2	3	0	0	5
OG0008858	1	1	1	2	5
OG0008859	2	1	1	1	5
OG0008860	2	1	1	1	5
OG0008861	1	1	1	2	5
OG0008862	1	1	2	1	5
OG0008863	1	1	2	1	5
OG0008864	1	1	1	2	5
OG0008865	2	1	1	1	5
OG0008866	2	1	1	1	5
OG0008867	2	1	1	1	5
OG0008868	2	1	1	1	5
OG0008869	2	1	1	1	5
OG0008870	1	1	1	2	5
OG0008871	1	1	2	1	5
OG0008872	1	1	1	2	5
OG0008873	1	1	2	1	5
OG0008874	1	1	1	2	5
OG0008875	1	1	1	2	5
OG0008876	2	1	1	1	5
OG0008877	1	1	1	2	5
OG0008878	1	1	2	1	5
OG0008879	1	1	2	1	5
OG0008880	2	1	1	1	5
OG0008881	1	1	1	2	5
OG0008882	1	1	1	2	5
OG0008883	1	1	1	2	5
OG0008884	1	1	2	1	5
OG0008885	2	2	1	0	5
OG0008886	1	1	2	1	5
OG0008887	1	1	1	2	5
OG0008888	2	1	1	1	5
OG0008889	1	1	1	2	5
OG0008890	1	1	1	2	5
OG0008891	1	0	1	3	5
OG0008892	3	2	0	0	5
OG0008893	1	2	1	1	5
OG0008894	2	1	1	1	5
OG0008895	1	1	2	1	5
OG0008896	1	1	2	1	5
OG0008897	1	1	2	1	5
OG0008898	2	1	1	1	5
OG0008899	1	1	2	1	5
OG0008900	1	2	1	1	5
OG0008901	1	1	1	2	5
OG0008902	2	3	0	0	5
OG0008903	1	1	2	1	5
OG0008904	1	1	2	1	5
OG0008905	2	1	1	1	5
OG0008906	2	1	1	1	5
OG0008907	1	1	1	2	5
OG0008908	1	1	1	2	5
OG0008909	1	1	2	1	5
OG0008910	1	1	1	2	5
OG0008911	1	1	2	1	5
OG0008912	2	1	1	1	5
OG0008913	1	1	2	1	5
OG0008914	1	1	2	1	5
OG0008915	2	1	1	1	5
OG0008916	2	2	0	1	5
OG0008917	4	1	0	0	5
OG0008918	1	0	4	0	5
OG0008919	2	0	1	2	5
OG0008920	1	1	1	2	5
OG0008921	1	1	1	2	5
OG0008922	2	1	1	1	5
OG0008923	2	1	1	1	5
OG0008924	1	1	1	2	5
OG0008925	2	1	1	1	5
OG0008926	1	1	2	1	5
OG0008927	1	1	2	1	5
OG0008928	1	1	1	2	5
OG0008929	1	1	1	2	5
OG0008930	3	2	0	0	5
OG0008931	1	1	2	1	5
OG0008932	2	1	1	1	5
OG0008933	1	1	1	2	5
OG0008934	1	1	1	2	5
OG0008935	4	1	0	0	5
OG0008936	1	1	1	2	5
OG0008937	2	1	1	1	5
OG0008938	2	1	1	1	5
OG0008939	4	1	0	0	5
OG0008940	1	2	1	1	5
OG0008941	4	1	0	0	5
OG0008942	5	0	0	0	5
OG0008943	2	1	1	1	5
OG0008944	2	1	1	1	5
OG0008945	2	1	1	1	5
OG0008946	1	1	2	1	5
OG0008947	3	2	0	0	5
OG0008948	1	1	2	1	5
OG0008949	2	1	1	1	5
OG0008950	2	1	1	1	5
OG0008951	4	1	0	0	5
OG0008952	2	1	0	2	5
OG0008953	2	0	3	0	5
OG0008954	2	1	1	1	5
OG0008955	1	1	2	1	5
OG0008956	1	1	1	2	5
OG0008957	1	2	1	1	5
OG0008958	2	1	1	1	5
OG0008959	2	1	1	1	5
OG0008960	5	0	0	0	5
OG0008961	2	1	1	1	5
OG0008962	2	1	1	1	5
OG0008963	1	1	1	2	5
OG0008964	1	1	1	2	5
OG0008965	5	0	0	0	5
OG0008966	1	1	2	1	5
OG0008967	1	4	0	0	5
OG0008968	1	2	1	1	5
OG0008969	1	3	1	0	5
OG0008970	4	1	0	0	5
OG0008971	1	1	1	2	5
OG0008972	2	1	1	1	5
OG0008973	4	1	0	0	5
OG0008974	4	1	0	0	5
OG0008975	1	1	2	1	5
OG0008976	1	1	1	2	5
OG0008977	2	1	1	1	5
OG0008978	1	1	2	1	5
OG0008979	2	3	0	0	5
OG0008980	1	1	1	2	5
OG0008981	1	1	1	2	5
OG0008982	1	1	2	1	5
OG0008983	1	1	2	1	5
OG0008984	2	3	0	0	5
OG0008985	1	2	1	1	5
OG0008986	4	1	0	0	5
OG0008987	4	0	1	0	5
OG0008988	2	1	1	1	5
OG0008989	1	1	1	2	5
OG0008990	2	1	1	1	5
OG0008991	1	1	2	1	5
OG0008992	2	1	1	1	5
OG0008993	1	1	2	1	5
OG0008994	1	1	1	2	5
OG0008995	3	2	0	0	5
OG0008996	1	1	1	2	5
OG0008997	1	1	1	2	5
OG0008998	1	1	2	1	5
OG0008999	2	1	1	1	5
OG0009000	2	1	1	1	5
OG0009001	1	1	1	2	5
OG0009002	2	1	1	1	5
OG0009003	4	1	0	0	5
OG0009004	4	1	0	0	5
OG0009005	3	0	1	1	5
OG0009006	4	1	0	0	5
OG0009007	2	2	1	0	5
OG0009008	4	1	0	0	5
OG0009009	2	1	1	1	5
OG0009010	2	1	1	1	5
OG0009011	1	1	2	1	5
OG0009012	5	0	0	0	5
OG0009013	2	0	2	1	5
OG0009014	4	1	0	0	5
OG0009015	2	3	0	0	5
OG0009016	5	0	0	0	5
OG0009017	1	1	1	2	5
OG0009018	1	1	2	1	5
OG0009019	1	1	1	2	5
OG0009020	1	1	1	2	5
OG0009021	1	1	2	1	5
OG0009022	1	1	2	1	5
OG0009023	1	1	2	1	5
OG0009024	1	1	2	1	5
OG0009025	1	1	1	2	5
OG0009026	1	1	2	1	5
OG0009027	1	1	1	2	5
OG0009028	1	1	2	1	5
OG0009029	1	1	2	1	5
OG0009030	2	1	1	1	5
OG0009031	1	1	2	1	5
OG0009032	1	1	2	1	5
OG0009033	2	1	1	1	5
OG0009034	1	0	2	2	5
OG0009035	1	1	1	2	5
OG0009036	1	1	2	1	5
OG0009037	1	2	1	1	5
OG0009038	1	1	2	1	5
OG0009039	1	1	2	1	5
OG0009040	1	1	2	1	5
OG0009041	1	1	2	1	5
OG0009042	2	1	1	1	5
OG0009043	1	1	1	2	5
OG0009044	1	1	1	2	5
OG0009045	2	1	1	1	5
OG0009046	1	1	1	2	5
OG0009047	1	1	1	2	5
OG0009048	1	1	1	2	5
OG0009049	1	1	1	2	5
OG0009050	1	0	2	2	5
OG0009051	1	1	1	2	5
OG0009052	1	1	1	2	5
OG0009053	1	1	1	2	5
OG0009054	1	1	1	2	5
OG0009055	1	1	2	1	5
OG0009056	2	0	2	1	5
OG0009057	1	1	2	1	5
OG0009058	1	1	1	2	5
OG0009059	1	1	2	1	5
OG0009060	1	1	2	1	5
OG0009061	1	2	1	1	5
OG0009062	1	1	3	0	5
OG0009063	1	1	1	2	5
OG0009064	1	1	2	1	5
OG0009065	2	1	1	1	5
OG0009066	1	2	1	1	5
OG0009067	2	1	1	1	5
OG0009068	2	1	1	1	5
OG0009069	1	2	1	1	5
OG0009070	1	2	1	1	5
OG0009071	1	1	2	1	5
OG0009072	1	1	1	2	5
OG0009073	1	1	1	2	5
OG0009074	1	1	1	2	5
OG0009075	1	1	2	1	5
OG0009076	1	1	1	2	5
OG0009077	2	1	1	1	5
OG0009078	1	1	1	2	5
OG0009079	1	1	2	1	5
OG0009080	2	1	1	1	5
OG0009081	1	1	3	0	5
OG0009082	1	1	2	1	5
OG0009083	1	1	2	1	5
OG0009084	1	1	2	1	5
OG0009085	2	1	1	1	5
OG0009086	1	1	1	2	5
OG0009087	1	1	1	2	5
OG0009088	1	1	1	2	5
OG0009089	1	1	2	1	5
OG0009090	2	1	1	1	5
OG0009091	1	1	2	1	5
OG0009092	1	2	1	1	5
OG0009093	2	1	1	1	5
OG0009094	1	1	1	2	5
OG0009095	1	1	2	1	5
OG0009096	1	1	2	1	5
OG0009097	1	1	2	1	5
OG0009098	2	1	1	1	5
OG0009099	1	1	2	1	5
OG0009100	3	2	0	0	5
OG0009101	1	1	1	2	5
OG0009102	1	1	2	1	5
OG0009103	1	1	1	2	5
OG0009104	2	1	1	1	5
OG0009105	1	1	1	2	5
OG0009106	2	0	3	0	5
OG0009107	2	1	1	1	5
OG0009108	1	1	2	1	5
OG0009109	1	1	2	1	5
OG0009110	1	1	2	1	5
OG0009111	1	1	2	1	5
OG0009112	1	1	1	2	5
OG0009113	2	1	1	1	5
OG0009114	1	1	2	1	5
OG0009115	1	2	1	1	5
OG0009116	2	1	1	1	5
OG0009117	4	1	0	0	5
OG0009118	2	0	1	2	5
OG0009119	2	1	1	1	5
OG0009120	2	1	1	1	5
OG0009121	2	0	2	1	5
OG0009122	1	1	1	2	5
OG0009123	1	1	1	2	5
OG0009124	1	1	2	1	5
OG0009125	1	1	1	2	5
OG0009126	2	1	1	1	5
OG0009127	2	1	1	1	5
OG0009128	1	1	2	1	5
OG0009129	1	1	2	1	5
OG0009130	1	1	2	1	5
OG0009131	1	1	1	2	5
OG0009132	1	1	2	1	5
OG0009133	1	1	2	1	5
OG0009134	1	1	2	1	5
OG0009135	1	1	2	1	5
OG0009136	1	1	1	2	5
OG0009137	1	1	2	1	5
OG0009138	1	1	2	1	5
OG0009139	2	1	1	1	5
OG0009140	1	0	1	3	5
OG0009141	2	1	1	1	5
OG0009142	1	1	2	1	5
OG0009143	1	1	1	2	5
OG0009144	1	1	1	2	5
OG0009145	1	1	2	1	5
OG0009146	1	1	1	2	5
OG0009147	1	1	1	2	5
OG0009148	2	1	1	1	5
OG0009149	1	1	2	1	5
OG0009150	2	1	1	1	5
OG0009151	1	1	2	1	5
OG0009152	1	2	1	1	5
OG0009153	1	1	1	2	5
OG0009154	1	1	2	1	5
OG0009155	2	1	1	1	5
OG0009156	2	1	1	1	5
OG0009157	1	1	2	1	5
OG0009158	1	1	2	1	5
OG0009159	1	1	1	2	5
OG0009160	1	1	1	2	5
OG0009161	2	1	1	1	5
OG0009162	1	1	1	2	5
OG0009163	1	1	2	1	5
OG0009164	1	1	2	1	5
OG0009165	1	1	1	2	5
OG0009166	2	1	1	1	5
OG0009167	1	1	1	2	5
OG0009168	1	1	2	1	5
OG0009169	1	1	2	1	5
OG0009170	1	1	1	2	5
OG0009171	1	1	1	2	5
OG0009172	1	1	2	1	5
OG0009173	4	1	0	0	5
OG0009174	2	1	1	1	5
OG0009175	2	1	1	1	5
OG0009176	1	1	1	2	5
OG0009177	1	1	2	1	5
OG0009178	1	1	1	2	5
OG0009179	2	1	1	1	5
OG0009180	1	1	1	2	5
OG0009181	1	1	1	2	5
OG0009182	1	1	2	1	5
OG0009183	1	1	1	2	5
OG0009184	1	1	2	1	5
OG0009185	1	1	2	1	5
OG0009186	1	1	1	2	5
OG0009187	1	1	2	1	5
OG0009188	1	1	2	1	5
OG0009189	2	3	0	0	5
OG0009190	1	1	2	1	5
OG0009191	2	1	1	1	5
OG0009192	1	1	2	1	5
OG0009193	1	1	1	2	5
OG0009194	1	1	2	1	5
OG0009195	1	1	1	2	5
OG0009196	1	1	1	2	5
OG0009197	1	1	2	1	5
OG0009198	2	1	1	1	5
OG0009199	1	1	2	1	5
OG0009200	1	1	2	1	5
OG0009201	1	1	2	1	5
OG0009202	1	1	1	2	5
OG0009203	1	1	2	1	5
OG0009204	1	1	1	2	5
OG0009205	1	2	1	1	5
OG0009206	2	1	1	1	5
OG0009207	1	1	1	2	5
OG0009208	3	1	0	1	5
OG0009209	1	1	2	1	5
OG0009210	1	1	1	2	5
OG0009211	1	1	1	2	5
OG0009212	1	1	1	2	5
OG0009213	1	1	2	1	5
OG0009214	3	2	0	0	5
OG0009215	4	1	0	0	5
OG0009216	1	1	1	2	5
OG0009217	2	1	1	1	5
OG0009218	1	1	2	1	5
OG0009219	2	1	1	1	5
OG0009220	1	1	1	2	5
OG0009221	3	1	1	0	5
OG0009222	1	1	2	1	5
OG0009223	1	1	2	1	5
OG0009224	1	1	2	1	5
OG0009225	1	1	2	1	5
OG0009226	1	1	2	1	5
OG0009227	1	1	1	2	5
OG0009228	1	1	2	1	5
OG0009229	2	1	1	1	5
OG0009230	2	1	1	1	5
OG0009231	1	1	1	2	5
OG0009232	2	1	1	1	5
OG0009233	1	1	2	1	5
OG0009234	1	1	1	2	5
OG0009235	1	1	1	2	5
OG0009236	2	1	1	1	5
OG0009237	1	1	1	2	5
OG0009238	4	1	0	0	5
OG0009239	2	3	0	0	5
OG0009240	1	1	1	2	5
OG0009241	1	1	1	2	5
OG0009242	1	1	2	1	5
OG0009243	1	1	1	2	5
OG0009244	2	1	1	1	5
OG0009245	5	0	0	0	5
OG0009246	3	0	2	0	5
OG0009247	5	0	0	0	5
OG0009248	1	2	1	1	5
OG0009249	2	1	1	1	5
OG0009250	4	1	0	0	5
OG0009251	1	2	1	1	5
OG0009252	4	1	0	0	5
OG0009253	2	1	1	1	5
OG0009254	1	1	1	2	5
OG0009255	3	2	0	0	5
OG0009256	3	2	0	0	5
OG0009257	1	1	2	1	5
OG0009258	5	0	0	0	5
OG0009259	1	1	2	1	5
OG0009260	1	1	2	1	5
OG0009261	2	1	1	1	5
OG0009262	3	0	1	1	5
OG0009263	4	1	0	0	5
OG0009264	1	4	0	0	5
OG0009265	1	1	2	1	5
OG0009266	3	0	1	1	5
OG0009267	5	0	0	0	5
OG0009268	2	1	1	1	5
OG0009269	1	1	2	1	5
OG0009270	1	1	1	2	5
OG0009271	1	1	1	2	5
OG0009272	2	1	1	1	5
OG0009273	1	1	1	2	5
OG0009274	4	1	0	0	5
OG0009275	2	1	1	1	5
OG0009276	1	4	0	0	5
OG0009277	1	1	1	2	5
OG0009278	1	1	2	1	5
OG0009279	2	2	1	0	5
OG0009280	4	1	0	0	5
OG0009281	1	1	1	2	5
OG0009282	1	0	1	3	5
OG0009283	1	1	2	1	5
OG0009284	1	1	1	2	5
OG0009285	1	1	1	2	5
OG0009286	3	0	2	0	5
OG0009287	1	1	1	2	5
OG0009288	2	1	1	1	5
OG0009289	3	1	0	1	5
OG0009290	2	1	2	0	5
OG0009291	1	1	1	2	5
OG0009292	2	1	1	1	5
OG0009293	1	1	1	2	5
OG0009294	1	2	1	1	5
OG0009295	1	1	2	1	5
OG0009296	4	1	0	0	5
OG0009297	2	1	1	1	5
OG0009298	1	1	1	2	5
OG0009299	1	1	2	1	5
OG0009300	1	1	2	1	5
OG0009301	1	1	2	1	5
OG0009302	1	1	1	2	5
OG0009303	2	1	1	1	5
OG0009304	1	2	1	1	5
OG0009305	1	1	1	2	5
OG0009306	1	1	2	1	5
OG0009307	1	1	2	1	5
OG0009308	1	1	1	2	5
OG0009309	2	1	1	1	5
OG0009310	1	1	1	2	5
OG0009311	1	1	2	1	5
OG0009312	1	1	1	2	5
OG0009313	1	1	2	1	5
OG0009314	2	1	1	1	5
OG0009315	1	1	1	2	5
OG0009316	1	1	1	2	5
OG0009317	2	1	1	1	5
OG0009318	2	1	1	1	5
OG0009319	2	1	1	1	5
OG0009320	1	1	1	2	5
OG0009321	2	1	1	1	5
OG0009322	2	1	1	1	5
OG0009323	2	1	1	1	5
OG0009324	1	1	1	2	5
OG0009325	1	1	1	2	5
OG0009326	1	1	2	1	5
OG0009327	2	1	1	1	5
OG0009328	1	1	1	2	5
OG0009329	1	1	2	1	5
OG0009330	1	1	2	1	5
OG0009331	2	1	1	1	5
OG0009332	1	1	1	2	5
OG0009333	1	2	1	1	5
OG0009334	2	1	1	1	5
OG0009335	1	1	1	2	5
OG0009336	1	1	2	1	5
OG0009337	1	2	1	1	5
OG0009338	2	1	1	1	5
OG0009339	1	1	2	1	5
OG0009340	1	1	1	2	5
OG0009341	2	1	1	1	5
OG0009342	1	1	1	2	5
OG0009343	1	1	1	2	5
OG0009344	1	1	2	1	5
OG0009345	1	1	1	2	5
OG0009346	2	1	1	1	5
OG0009347	1	1	2	1	5
OG0009348	1	2	1	1	5
OG0009349	1	1	1	2	5
OG0009350	1	1	1	2	5
OG0009351	2	1	1	1	5
OG0009352	1	1	1	2	5
OG0009353	1	1	2	1	5
OG0009354	1	2	1	1	5
OG0009355	3	1	0	1	5
OG0009356	1	1	2	1	5
OG0009357	1	1	2	1	5
OG0009358	1	1	2	1	5
OG0009359	1	1	2	1	5
OG0009360	1	1	2	1	5
OG0009361	1	1	2	1	5
OG0009362	1	2	1	1	5
OG0009363	2	1	1	1	5
OG0009364	1	1	2	1	5
OG0009365	1	2	1	1	5
OG0009366	1	1	2	1	5
OG0009367	1	1	1	2	5
OG0009368	1	1	1	2	5
OG0009369	1	1	1	2	5
OG0009370	1	1	1	2	5
OG0009371	2	1	1	1	5
OG0009372	3	0	1	1	5
OG0009373	2	1	1	1	5
OG0009374	1	1	2	1	5
OG0009375	2	1	1	1	5
OG0009376	1	1	2	1	5
OG0009377	2	3	0	0	5
OG0009378	1	1	2	1	5
OG0009379	2	1	1	1	5
OG0009380	1	1	2	1	5
OG0009381	1	1	2	1	5
OG0009382	2	1	1	1	5
OG0009383	1	1	2	1	5
OG0009384	1	1	1	2	5
OG0009385	1	2	1	1	5
OG0009386	1	2	1	1	5
OG0009387	2	1	1	1	5
OG0009388	1	1	1	2	5
OG0009389	1	1	1	2	5
OG0009390	1	1	2	1	5
OG0009391	1	1	1	2	5
OG0009392	1	1	1	2	5
OG0009393	1	1	1	2	5
OG0009394	1	1	2	1	5
OG0009395	2	1	1	1	5
OG0009396	1	1	2	1	5
OG0009397	1	1	1	2	5
OG0009398	2	3	0	0	5
OG0009399	1	1	1	2	5
OG0009400	1	1	2	1	5
OG0009401	1	1	1	2	5
OG0009402	2	1	1	1	5
OG0009403	1	2	1	1	5
OG0009404	2	2	1	0	5
OG0009405	1	1	2	1	5
OG0009406	1	0	2	2	5
OG0009407	1	1	1	2	5
OG0009408	1	1	1	2	5
OG0009409	2	1	1	1	5
OG0009410	4	1	0	0	5
OG0009411	2	1	1	1	5
OG0009412	1	1	2	1	5
OG0009413	2	1	1	1	5
OG0009414	2	3	0	0	5
OG0009415	1	0	2	2	5
OG0009416	1	1	1	2	5
OG0009417	4	0	0	1	5
OG0009418	1	1	1	2	5
OG0009419	2	1	1	1	5
OG0009420	2	1	1	1	5
OG0009421	2	1	1	1	5
OG0009422	1	1	2	1	5
OG0009423	4	1	0	0	5
OG0009424	5	0	0	0	5
OG0009425	1	1	2	1	5
OG0009426	1	2	1	1	5
OG0009427	1	1	1	2	5
OG0009428	1	1	1	2	5
OG0009429	1	1	1	2	5
OG0009430	1	2	1	1	5
OG0009431	1	4	0	0	5
OG0009432	1	1	2	1	5
OG0009433	2	3	0	0	5
OG0009434	1	1	2	1	5
OG0009435	1	2	1	1	5
OG0009436	1	1	1	2	5
OG0009437	3	0	1	1	5
OG0009438	1	1	1	2	5
OG0009439	2	1	1	1	5
OG0009440	1	3	0	1	5
OG0009441	1	1	1	2	5
OG0009442	2	1	1	1	5
OG0009443	2	1	1	1	5
OG0009444	1	1	1	2	5
OG0009445	1	1	1	2	5
OG0009446	1	1	2	1	5
OG0009447	1	1	1	2	5
OG0009448	1	1	1	2	5
OG0009449	2	1	1	1	5
OG0009450	2	1	1	1	5
OG0009451	2	1	0	2	5
OG0009452	1	1	2	1	5
OG0009453	1	1	1	2	5
OG0009454	4	1	0	0	5
OG0009455	3	2	0	0	5
OG0009456	4	1	0	0	5
OG0009457	2	1	1	1	5
OG0009458	2	0	1	2	5
OG0009459	2	1	1	1	5
OG0009460	2	1	1	1	5
OG0009461	2	1	1	1	5
OG0009462	2	1	1	1	5
OG0009463	1	1	1	2	5
OG0009464	1	1	2	1	5
OG0009465	1	1	2	1	5
OG0009466	1	1	1	2	5
OG0009467	1	1	1	2	5
OG0009468	3	2	0	0	5
OG0009469	3	2	0	0	5
OG0009470	1	1	2	1	5
OG0009471	2	3	0	0	5
OG0009472	1	1	1	2	5
OG0009473	1	1	1	2	5
OG0009474	2	1	1	1	5
OG0009475	1	1	2	1	5
OG0009476	2	1	1	1	5
OG0009477	1	1	1	2	5
OG0009478	1	1	2	1	5
OG0009479	1	1	2	1	5
OG0009480	1	2	1	1	5
OG0009481	1	1	2	1	5
OG0009482	1	1	1	2	5
OG0009483	2	1	1	1	5
OG0009484	2	1	1	1	5
OG0009485	1	1	1	2	5
OG0009486	3	2	0	0	5
OG0009487	2	2	1	0	5
OG0009488	5	0	0	0	5
OG0009489	2	1	1	1	5
OG0009490	2	3	0	0	5
OG0009491	1	1	1	2	5
OG0009492	4	1	0	0	5
OG0009493	1	1	2	1	5
OG0009494	2	1	1	1	5
OG0009495	3	1	0	1	5
OG0009496	1	1	2	1	5
OG0009497	2	1	1	1	5
OG0009498	1	1	1	2	5
OG0009499	1	1	1	2	5
OG0009500	1	1	2	1	5
OG0009501	1	1	2	1	5
OG0009502	3	2	0	0	5
OG0009503	1	1	1	2	5
OG0009504	5	0	0	0	5
OG0009505	5	0	0	0	5
OG0009506	1	1	2	1	5
OG0009507	1	1	1	2	5
OG0009508	1	4	0	0	5
OG0009509	1	1	2	1	5
OG0009510	1	1	2	1	5
OG0009511	2	1	1	1	5
OG0009512	1	4	0	0	5
OG0009513	2	1	1	1	5
OG0009514	2	1	1	1	5
OG0009515	2	2	1	0	5
OG0009516	1	1	2	1	5
OG0009517	1	1	1	2	5
OG0009518	1	1	1	2	5
OG0009519	3	2	0	0	5
OG0009520	2	2	0	1	5
OG0009521	1	1	2	1	5
OG0009522	1	1	1	2	5
OG0009523	2	1	1	1	5
OG0009524	1	2	1	1	5
OG0009525	1	1	2	1	5
OG0009526	5	0	0	0	5
OG0009527	5	0	0	0	5
OG0009528	1	1	2	1	5
OG0009529	4	1	0	0	5
OG0009530	1	1	2	1	5
OG0009531	2	1	1	1	5
OG0009532	1	1	2	1	5
OG0009533	5	0	0	0	5
OG0009534	2	1	1	1	5
OG0009535	1	2	1	1	5
OG0009536	1	2	1	1	5
OG0009537	4	1	0	0	5
OG0009538	2	3	0	0	5
OG0009539	1	1	2	1	5
OG0009540	1	1	2	1	5
OG0009541	1	1	2	1	5
OG0009542	3	2	0	0	5
OG0009543	2	1	1	1	5
OG0009544	2	1	1	1	5
OG0009545	2	1	1	1	5
OG0009546	2	2	0	1	5
OG0009547	1	1	1	2	5
OG0009548	1	1	1	2	5
OG0009549	3	2	0	0	5
OG0009550	2	1	1	1	5
OG0009551	1	1	2	1	5
OG0009552	1	1	2	1	5
OG0009553	1	1	1	2	5
OG0009554	1	2	1	1	5
OG0009555	1	1	1	2	5
OG0009556	1	1	1	2	5
OG0009557	1	1	2	1	5
OG0009558	3	0	1	1	5
OG0009559	1	1	1	2	5
OG0009560	1	1	1	2	5
OG0009561	1	1	1	2	5
OG0009562	1	1	2	1	5
OG0009563	2	0	1	2	5
OG0009564	1	1	1	2	5
OG0009565	1	1	1	2	5
OG0009566	2	1	1	1	5
OG0009567	1	1	2	1	5
OG0009568	1	1	2	1	5
OG0009569	1	1	1	2	5
OG0009570	1	1	1	2	5
OG0009571	2	1	1	1	5
OG0009572	4	1	0	0	5
OG0009573	2	3	0	0	5
OG0009574	1	1	1	2	5
OG0009575	1	1	1	2	5
OG0009576	2	1	1	1	5
OG0009577	1	1	2	1	5
OG0009578	1	1	1	2	5
OG0009579	1	1	2	1	5
OG0009580	1	1	1	2	5
OG0009581	2	1	1	1	5
OG0009582	1	1	2	1	5
OG0009583	1	2	1	1	5
OG0009584	2	1	1	1	5
OG0009585	2	1	1	1	5
OG0009586	1	1	1	2	5
OG0009587	1	1	1	2	5
OG0009588	1	1	2	1	5
OG0009589	2	1	1	1	5
OG0009590	1	1	1	2	5
OG0009591	1	1	1	2	5
OG0009592	1	1	1	2	5
OG0009593	1	1	2	1	5
OG0009594	1	1	1	2	5
OG0009595	1	1	1	2	5
OG0009596	2	1	1	1	5
OG0009597	1	1	1	2	5
OG0009598	2	1	1	1	5
OG0009599	2	1	1	1	5
OG0009600	1	1	2	1	5
OG0009601	1	1	2	1	5
OG0009602	1	0	2	2	5
OG0009603	1	1	1	2	5
OG0009604	1	1	1	2	5
OG0009605	1	2	1	1	5
OG0009606	1	1	2	1	5
OG0009607	1	2	1	1	5
OG0009608	2	1	1	1	5
OG0009609	1	1	2	1	5
OG0009610	1	1	2	1	5
OG0009611	1	1	1	2	5
OG0009612	1	1	2	1	5
OG0009613	1	1	1	2	5
OG0009614	1	1	1	2	5
OG0009615	1	1	1	2	5
OG0009616	1	1	2	1	5
OG0009617	1	1	2	1	5
OG0009618	1	2	1	1	5
OG0009619	1	1	1	2	5
OG0009620	1	1	2	1	5
OG0009621	1	1	2	1	5
OG0009622	1	1	2	1	5
OG0009623	1	1	2	1	5
OG0009624	1	1	1	2	5
OG0009625	1	1	1	2	5
OG0009626	1	1	2	1	5
OG0009627	5	0	0	0	5
OG0009628	2	1	1	1	5
OG0009629	1	1	1	2	5
OG0009630	1	1	1	2	5
OG0009631	1	1	1	2	5
OG0009632	1	1	2	1	5
OG0009633	2	1	1	1	5
OG0009634	1	1	2	1	5
OG0009635	1	1	1	2	5
OG0009636	1	1	1	2	5
OG0009637	1	1	1	2	5
OG0009638	1	0	2	2	5
OG0009639	1	1	1	2	5
OG0009640	1	1	1	2	5
OG0009641	1	1	2	1	5
OG0009642	1	1	2	1	5
OG0009643	1	1	1	2	5
OG0009644	2	1	1	1	5
OG0009645	1	1	1	2	5
OG0009646	1	1	2	1	5
OG0009647	1	1	1	2	5
OG0009648	1	1	1	2	5
OG0009649	2	1	1	1	5
OG0009650	1	1	1	2	5
OG0009651	1	1	1	2	5
OG0009652	1	1	2	1	5
OG0009653	1	1	2	1	5
OG0009654	2	1	1	1	5
OG0009655	1	0	3	1	5
OG0009656	2	1	1	1	5
OG0009657	1	1	1	2	5
OG0009658	1	1	2	1	5
OG0009659	1	1	2	1	5
OG0009660	2	1	1	1	5
OG0009661	1	2	1	1	5
OG0009662	2	1	1	1	5
OG0009663	1	1	2	1	5
OG0009664	1	1	2	1	5
OG0009665	1	1	2	1	5
OG0009666	2	1	1	1	5
OG0009667	1	1	1	2	5
OG0009668	1	1	2	1	5
OG0009669	1	1	1	2	5
OG0009670	2	1	1	1	5
OG0009671	1	1	1	2	5
OG0009672	1	2	1	1	5
OG0009673	1	2	1	1	5
OG0009674	1	1	2	1	5
OG0009675	1	1	1	2	5
OG0009676	2	1	1	1	5
OG0009677	1	1	1	2	5
OG0009678	1	1	2	1	5
OG0009679	1	1	1	2	5
OG0009680	1	1	1	2	5
OG0009681	2	1	1	1	5
OG0009682	1	1	1	2	5
OG0009683	1	1	2	1	5
OG0009684	1	1	1	2	5
OG0009685	1	1	1	2	5
OG0009686	1	1	2	1	5
OG0009687	2	1	1	1	5
OG0009688	1	0	2	2	5
OG0009689	2	1	1	1	5
OG0009690	1	1	2	1	5
OG0009691	1	1	2	1	5
OG0009692	1	1	1	2	5
OG0009693	2	1	0	2	5
OG0009694	1	1	2	1	5
OG0009695	2	1	1	1	5
OG0009696	1	1	1	2	5
OG0009697	1	1	1	2	5
OG0009698	2	1	1	1	5
OG0009699	1	1	2	1	5
OG0009700	1	1	2	1	5
OG0009701	1	1	1	2	5
OG0009702	1	1	2	1	5
OG0009703	1	2	1	1	5
OG0009704	1	1	1	2	5
OG0009705	1	2	1	1	5
OG0009706	2	1	1	1	5
OG0009707	2	1	0	2	5
OG0009708	1	1	2	1	5
OG0009709	2	1	1	1	5
OG0009710	1	1	2	1	5
OG0009711	1	1	1	2	5
OG0009712	1	1	2	1	5
OG0009713	1	1	1	2	5
OG0009714	1	1	2	1	5
OG0009715	1	1	1	2	5
OG0009716	1	1	2	1	5
OG0009717	1	0	2	2	5
OG0009718	1	1	1	2	5
OG0009719	1	1	2	1	5
OG0009720	1	1	2	1	5
OG0009721	2	1	1	1	5
OG0009722	1	1	1	2	5
OG0009723	1	1	1	2	5
OG0009724	2	1	1	1	5
OG0009725	1	2	1	1	5
OG0009726	1	1	2	1	5
OG0009727	1	1	1	2	5
OG0009728	1	1	1	2	5
OG0009729	1	1	2	1	5
OG0009730	1	1	1	2	5
OG0009731	4	1	0	0	5
OG0009732	1	1	2	1	5
OG0009733	1	1	1	2	5
OG0009734	1	1	2	1	5
OG0009735	1	1	2	1	5
OG0009736	2	1	1	1	5
OG0009737	1	1	2	1	5
OG0009738	1	1	2	1	5
OG0009739	1	1	2	1	5
OG0009740	1	1	1	2	5
OG0009741	2	1	1	1	5
OG0009742	1	1	2	1	5
OG0009743	1	1	2	1	5
OG0009744	1	0	2	2	5
OG0009745	1	1	1	2	5
OG0009746	1	1	2	1	5
OG0009747	1	1	2	1	5
OG0009748	1	1	1	2	5
OG0009749	1	1	1	2	5
OG0009750	2	1	1	1	5
OG0009751	1	1	2	1	5
OG0009752	1	1	2	1	5
OG0009753	1	1	1	2	5
OG0009754	1	1	2	1	5
OG0009755	2	1	2	0	5
OG0009756	1	1	2	1	5
OG0009757	2	1	1	1	5
OG0009758	1	2	1	1	5
OG0009759	2	1	1	1	5
OG0009760	1	1	2	1	5
OG0009761	1	1	1	2	5
OG0009762	2	1	1	1	5
OG0009763	1	1	2	1	5
OG0009764	1	1	2	1	5
OG0009765	1	1	2	1	5
OG0009766	1	1	2	1	5
OG0009767	2	1	1	1	5
OG0009768	2	3	0	0	5
OG0009769	2	1	1	1	5
OG0009770	1	1	2	1	5
OG0009771	2	1	1	1	5
OG0009772	2	1	1	1	5
OG0009773	1	1	0	3	5
OG0009774	1	2	1	1	5
OG0009775	2	1	1	1	5
OG0009776	2	0	2	1	5
OG0009777	2	1	1	1	5
OG0009778	1	1	1	2	5
OG0009779	1	1	1	2	5
OG0009780	2	1	1	1	5
OG0009781	1	2	1	1	5
OG0009782	1	1	2	1	5
OG0009783	2	1	1	1	5
OG0009784	1	1	1	2	5
OG0009785	1	1	2	1	5
OG0009786	3	0	1	1	5
OG0009787	1	2	1	1	5
OG0009788	2	1	1	1	5
OG0009789	1	1	1	2	5
OG0009790	1	1	1	2	5
OG0009791	2	1	1	1	5
OG0009792	2	1	1	1	5
OG0009793	4	1	0	0	5
OG0009794	2	1	1	1	5
OG0009795	1	1	2	1	5
OG0009796	1	1	2	1	5
OG0009797	2	0	1	2	5
OG0009798	2	1	1	1	5
OG0009799	1	1	1	2	5
OG0009800	1	1	1	2	5
OG0009801	1	1	1	2	5
OG0009802	1	1	1	2	5
OG0009803	1	4	0	0	5
OG0009804	1	1	1	2	5
OG0009805	2	1	1	1	5
OG0009806	1	1	2	1	5
OG0009807	1	1	2	1	5
OG0009808	2	1	1	1	5
OG0009809	1	1	1	2	5
OG0009810	1	0	2	2	5
OG0009811	1	2	1	1	5
OG0009812	2	1	1	1	5
OG0009813	2	1	1	1	5
OG0009814	1	1	1	2	5
OG0009815	1	1	1	2	5
OG0009816	3	0	1	1	5
OG0009817	1	1	1	2	5
OG0009818	2	0	1	2	5
OG0009819	1	2	1	1	5
OG0009820	1	0	1	3	5
OG0009821	1	1	1	2	5
OG0009822	2	1	1	1	5
OG0009823	2	1	1	1	5
OG0009824	1	1	2	1	5
OG0009825	1	1	1	2	5
OG0009826	1	3	1	0	5
OG0009827	1	1	1	2	5
OG0009828	1	1	1	2	5
OG0009829	1	1	2	1	5
OG0009830	1	1	2	1	5
OG0009831	2	1	1	1	5
OG0009832	1	1	1	2	5
OG0009833	5	0	0	0	5
OG0009834	1	1	1	2	5
OG0009835	1	1	1	2	5
OG0009836	1	1	1	2	5
OG0009837	1	1	2	1	5
OG0009838	1	1	1	2	5
OG0009839	1	0	1	3	5
OG0009840	1	1	2	1	5
OG0009841	1	1	1	2	5
OG0009842	1	1	1	2	5
OG0009843	1	1	1	2	5
OG0009844	2	1	1	1	5
OG0009845	2	3	0	0	5
OG0009846	2	1	1	1	5
OG0009847	3	2	0	0	5
OG0009848	1	4	0	0	5
OG0009849	1	1	1	2	5
OG0009850	1	2	1	1	5
OG0009851	3	2	0	0	5
OG0009852	1	1	2	1	5
OG0009853	1	1	1	2	5
OG0009854	4	1	0	0	5
OG0009855	1	1	1	2	5
OG0009856	1	1	1	2	5
OG0009857	1	1	1	2	5
OG0009858	3	2	0	0	5
OG0009859	5	0	0	0	5
OG0009860	1	1	1	2	5
OG0009861	1	0	3	1	5
OG0009862	2	1	1	1	5
OG0009863	1	2	1	1	5
OG0009864	3	2	0	0	5
OG0009865	2	1	1	1	5
OG0009866	1	1	2	1	5
OG0009867	1	1	1	2	5
OG0009868	4	1	0	0	5
OG0009869	1	2	1	1	5
OG0009870	1	1	1	2	5
OG0009871	1	1	1	2	5
OG0009872	1	1	1	2	5
OG0009873	2	1	1	1	5
OG0009874	1	4	0	0	5
OG0009875	1	1	1	2	5
OG0009876	2	1	1	1	5
OG0009877	3	2	0	0	5
OG0009878	5	0	0	0	5
OG0009879	1	2	1	1	5
OG0009880	2	1	1	1	5
OG0009881	4	1	0	0	5
OG0009882	3	2	0	0	5
OG0009883	2	1	1	1	5
OG0009884	1	1	3	0	5
OG0009885	1	1	2	1	5
OG0009886	1	1	3	0	5
OG0009887	1	1	2	1	5
OG0009888	1	4	0	0	5
OG0009889	3	1	1	0	5
OG0009890	1	2	1	1	5
OG0009891	2	1	1	1	5
OG0009892	4	1	0	0	5
OG0009893	1	1	1	2	5
OG0009894	2	1	1	1	5
OG0009895	2	1	1	1	5
OG0009896	2	2	0	1	5
OG0009897	2	1	1	1	5
OG0009898	3	2	0	0	5
OG0009899	1	2	1	1	5
OG0009900	2	3	0	0	5
OG0009901	3	2	0	0	5
OG0009902	1	4	0	0	5
OG0009903	1	1	1	2	5
OG0009904	1	1	1	2	5
OG0009905	2	3	0	0	5
OG0009906	1	1	1	2	5
OG0009907	1	1	1	2	5
OG0009908	1	1	1	2	5
OG0009909	2	1	1	1	5
OG0009910	4	0	0	1	5
OG0009911	1	1	2	1	5
OG0009912	4	1	0	0	5
OG0009913	2	0	2	1	5
OG0009914	2	1	1	1	5
OG0009915	2	1	1	1	5
OG0009916	1	4	0	0	5
OG0009917	2	1	1	1	5
OG0009918	2	1	1	1	5
OG0009919	4	1	0	0	5
OG0009920	1	1	1	2	5
OG0009921	1	1	2	1	5
OG0009922	2	3	0	0	5
OG0009923	4	1	0	0	5
OG0009924	1	1	1	2	5
OG0009925	5	0	0	0	5
OG0009926	3	2	0	0	5
OG0009927	1	1	2	1	5
OG0009928	2	1	1	1	5
OG0009929	1	0	2	2	5
OG0009930	1	3	1	0	5
OG0009931	1	1	1	2	5
OG0009932	2	1	1	1	5
OG0009933	1	1	1	2	5
OG0009934	1	1	2	1	5
OG0009935	1	0	1	3	5
OG0009936	1	1	1	2	5
OG0009937	1	1	2	1	5
OG0009938	1	1	1	2	5
OG0009939	4	1	0	0	5
OG0009940	1	1	2	1	5
OG0009941	1	1	2	1	5
OG0009942	2	1	1	1	5
OG0009943	1	1	1	2	5
OG0009944	1	1	1	2	5
OG0009945	1	0	2	2	5
OG0009946	1	2	1	1	5
OG0009947	2	1	1	1	5
OG0009948	2	1	1	1	5
OG0009949	1	1	1	2	5
OG0009950	2	0	2	1	5
OG0009951	1	2	1	1	5
OG0009952	1	1	1	2	5
OG0009953	1	1	2	1	5
OG0009954	2	1	1	1	5
OG0009955	1	1	1	2	5
OG0009956	1	1	1	2	5
OG0009957	1	2	1	1	5
OG0009958	1	2	1	1	5
OG0009959	1	1	1	2	5
OG0009960	1	1	1	2	5
OG0009961	1	2	1	1	5
OG0009962	1	1	0	3	5
OG0009963	1	1	2	1	5
OG0009964	1	1	1	2	5
OG0009965	1	1	1	2	5
OG0009966	1	0	3	1	5
OG0009967	1	1	1	2	5
OG0009968	1	1	2	1	5
OG0009969	2	1	1	1	5
OG0009970	1	1	2	1	5
OG0009971	2	1	1	1	5
OG0009972	1	1	2	1	5
OG0009973	1	1	1	2	5
OG0009974	1	1	2	1	5
OG0009975	1	1	1	2	5
OG0009976	1	1	2	1	5
OG0009977	2	1	1	1	5
OG0009978	3	2	0	0	5
OG0009979	2	1	1	1	5
OG0009980	2	1	1	1	5
OG0009981	1	1	2	1	5
OG0009982	1	1	2	1	5
OG0009983	1	1	2	1	5
OG0009984	1	1	1	2	5
OG0009985	2	1	1	1	5
OG0009986	1	2	0	2	5
OG0009987	2	1	1	1	5
OG0009988	1	1	1	2	5
OG0009989	2	1	1	1	5
OG0009990	1	1	2	1	5
OG0009991	1	1	2	1	5
OG0009992	1	1	2	1	5
OG0009993	1	1	1	2	5
OG0009994	1	0	2	2	5
OG0009995	2	1	1	1	5
OG0009996	1	1	1	2	5
OG0009997	2	1	1	1	5
OG0009998	1	1	1	2	5
OG0009999	1	1	1	2	5
OG0010000	1	4	0	0	5
OG0010001	1	1	2	1	5
OG0010002	1	1	2	1	5
OG0010003	2	3	0	0	5
OG0010004	2	1	1	1	5
OG0010005	1	1	1	2	5
OG0010006	5	0	0	0	5
OG0010007	1	1	1	2	5
OG0010008	1	1	1	2	5
OG0010009	2	1	1	1	5
OG0010010	1	2	1	1	5
OG0010011	1	1	2	1	5
OG0010012	1	1	2	1	5
OG0010013	1	1	1	2	5
OG0010014	1	1	2	1	5
OG0010015	2	3	0	0	5
OG0010016	1	4	0	0	5
OG0010017	2	1	1	1	5
OG0010018	1	1	2	1	5
OG0010019	1	1	1	2	5
OG0010020	2	1	1	1	5
OG0010021	1	1	2	1	5
OG0010022	1	1	2	1	5
OG0010023	2	1	1	1	5
OG0010024	1	1	1	2	5
OG0010025	2	1	1	1	5
OG0010026	2	1	1	1	5
OG0010027	2	1	1	1	5
OG0010028	1	1	1	2	5
OG0010029	1	1	2	1	5
OG0010030	1	1	2	1	5
OG0010031	2	3	0	0	5
OG0010032	1	1	2	1	5
OG0010033	1	1	2	1	5
OG0010034	2	1	1	1	5
OG0010035	5	0	0	0	5
OG0010036	1	1	2	1	5
OG0010037	1	1	2	1	5
OG0010038	1	1	1	2	5
OG0010039	2	3	0	0	5
OG0010040	2	1	1	1	5
OG0010041	1	1	1	2	5
OG0010042	1	1	1	2	5
OG0010043	1	1	2	1	5
OG0010044	2	1	1	1	5
OG0010045	1	1	2	1	5
OG0010046	2	3	0	0	5
OG0010047	1	1	2	1	5
OG0010048	1	1	2	1	5
OG0010049	1	1	1	2	5
OG0010050	4	1	0	0	5
OG0010051	1	2	1	1	5
OG0010052	5	0	0	0	5
OG0010053	1	3	1	0	5
OG0010054	1	3	1	0	5
OG0010055	1	1	1	2	5
OG0010056	2	1	1	1	5
OG0010057	3	2	0	0	5
OG0010058	1	1	1	2	5
OG0010059	5	0	0	0	5
OG0010060	3	0	1	1	5
OG0010061	2	3	0	0	5
OG0010062	2	3	0	0	5
OG0010063	1	1	1	2	5
OG0010064	1	1	2	1	5
OG0010065	2	1	1	1	5
OG0010066	1	1	2	1	5
OG0010067	1	1	2	1	5
OG0010068	1	1	1	2	5
OG0010069	1	1	2	1	5
OG0010070	2	1	1	1	5
OG0010071	2	3	0	0	5
OG0010072	5	0	0	0	5
OG0010073	2	1	1	1	5
OG0010074	1	1	2	1	5
OG0010075	1	1	1	2	5
OG0010076	1	0	0	4	5
OG0010077	1	1	1	2	5
OG0010078	1	1	2	1	5
OG0010079	1	1	2	1	5
OG0010080	2	1	1	1	5
OG0010081	1	1	1	2	5
OG0010082	1	1	2	1	5
OG0010083	1	1	1	2	5
OG0010084	2	1	1	1	5
OG0010085	1	0	1	3	5
OG0010086	2	2	0	1	5
OG0010087	1	1	2	1	5
OG0010088	1	1	1	2	5
OG0010089	1	1	2	1	5
OG0010090	2	1	1	1	5
OG0010091	1	1	1	2	5
OG0010092	1	1	1	2	5
OG0010093	1	1	1	2	5
OG0010094	1	1	1	2	5
OG0010095	1	1	1	2	5
OG0010096	1	1	2	1	5
OG0010097	2	1	1	1	5
OG0010098	1	1	2	1	5
OG0010099	2	1	1	1	5
OG0010100	1	1	2	1	5
OG0010101	2	1	1	1	5
OG0010102	1	1	1	2	5
OG0010103	1	0	2	2	5
OG0010104	1	1	1	2	5
OG0010105	1	1	1	2	5
OG0010106	1	1	1	2	5
OG0010107	2	1	1	1	5
OG0010108	1	1	1	2	5
OG0010109	1	1	1	2	5
OG0010110	1	1	0	3	5
OG0010111	2	1	1	1	5
OG0010112	1	2	1	1	5
OG0010113	2	1	1	1	5
OG0010114	1	1	1	2	5
OG0010115	1	1	1	2	5
OG0010116	2	1	1	1	5
OG0010117	1	1	1	2	5
OG0010118	2	1	1	1	5
OG0010119	1	1	1	2	5
OG0010120	2	1	1	1	5
OG0010121	1	1	1	2	5
OG0010122	4	1	0	0	5
OG0010123	1	1	1	2	5
OG0010124	1	1	1	2	5
OG0010125	1	1	1	2	5
OG0010126	2	1	1	1	5
OG0010127	2	1	1	1	5
OG0010128	2	1	1	1	5
OG0010129	2	1	1	1	5
OG0010130	1	1	1	2	5
OG0010131	1	0	2	2	5
OG0010132	2	1	1	1	5
OG0010133	1	1	1	2	5
OG0010134	1	1	1	2	5
OG0010135	1	2	1	1	5
OG0010136	1	1	1	2	5
OG0010137	1	1	2	1	5
OG0010138	1	2	1	1	5
OG0010139	1	1	2	1	5
OG0010140	1	1	1	2	5
OG0010141	1	1	2	1	5
OG0010142	1	1	1	2	5
OG0010143	1	1	1	2	5
OG0010144	2	1	1	1	5
OG0010145	2	2	1	0	5
OG0010146	1	1	1	2	5
OG0010147	2	1	1	1	5
OG0010148	1	1	2	1	5
OG0010149	1	1	1	2	5
OG0010150	1	1	1	2	5
OG0010151	1	1	1	2	5
OG0010152	1	1	1	2	5
OG0010153	1	1	1	2	5
OG0010154	1	1	0	3	5
OG0010155	1	1	1	2	5
OG0010156	1	1	1	2	5
OG0010157	2	1	1	1	5
OG0010158	2	1	1	1	5
OG0010159	1	1	2	1	5
OG0010160	1	1	1	2	5
OG0010161	1	1	1	2	5
OG0010162	1	1	1	2	5
OG0010163	1	0	3	1	5
OG0010164	1	1	1	2	5
OG0010165	1	1	1	2	5
OG0010166	1	1	2	1	5
OG0010167	2	1	1	1	5
OG0010168	1	1	1	2	5
OG0010169	1	1	1	2	5
OG0010170	2	1	1	1	5
OG0010171	1	1	1	2	5
OG0010172	1	1	1	2	5
OG0010173	1	1	2	1	5
OG0010174	1	1	2	1	5
OG0010175	2	1	1	1	5
OG0010176	1	1	1	2	5
OG0010177	1	1	2	1	5
OG0010178	1	1	1	2	5
OG0010179	1	1	2	1	5
OG0010180	1	1	1	2	5
OG0010181	1	0	1	3	5
OG0010182	1	1	2	1	5
OG0010183	1	1	2	1	5
OG0010184	1	1	2	1	5
OG0010185	1	1	1	2	5
OG0010186	1	1	1	2	5
OG0010187	1	0	2	2	5
OG0010188	1	1	1	2	5
OG0010189	1	1	1	2	5
OG0010190	1	1	2	1	5
OG0010191	2	1	1	1	5
OG0010192	1	1	1	2	5
OG0010193	1	1	1	2	5
OG0010194	1	1	1	2	5
OG0010195	1	0	2	2	5
OG0010196	1	1	2	1	5
OG0010197	1	1	1	2	5
OG0010198	2	1	1	1	5
OG0010199	1	1	1	2	5
OG0010200	1	1	1	2	5
OG0010201	1	1	2	1	5
OG0010202	2	0	1	2	5
OG0010203	1	1	2	1	5
OG0010204	1	1	1	2	5
OG0010205	1	1	1	2	5
OG0010206	1	1	2	1	5
OG0010207	2	1	1	1	5
OG0010208	1	2	1	1	5
OG0010209	2	1	1	1	5
OG0010210	1	1	1	2	5
OG0010211	2	1	1	1	5
OG0010212	2	1	1	1	5
OG0010213	1	1	1	2	5
OG0010214	1	1	2	1	5
OG0010215	1	1	1	2	5
OG0010216	1	1	3	0	5
OG0010217	2	1	1	1	5
OG0010218	1	1	2	1	5
OG0010219	1	1	2	1	5
OG0010220	1	1	1	2	5
OG0010221	1	1	1	2	5
OG0010222	1	2	1	1	5
OG0010223	1	1	2	1	5
OG0010224	1	1	1	2	5
OG0010225	1	1	1	2	5
OG0010226	1	1	2	1	5
OG0010227	1	1	1	2	5
OG0010228	1	1	2	1	5
OG0010229	1	1	1	2	5
OG0010230	1	1	2	1	5
OG0010231	1	1	1	2	5
OG0010232	1	1	1	2	5
OG0010233	1	1	2	1	5
OG0010234	2	1	1	1	5
OG0010235	2	1	1	1	5
OG0010236	1	1	1	2	5
OG0010237	1	1	2	1	5
OG0010238	1	1	1	2	5
OG0010239	1	1	1	2	5
OG0010240	1	1	1	2	5
OG0010241	1	1	2	1	5
OG0010242	1	1	1	2	5
OG0010243	1	1	1	2	5
OG0010244	1	1	1	2	5
OG0010245	1	1	1	2	5
OG0010246	2	1	1	1	5
OG0010247	1	1	1	2	5
OG0010248	1	1	2	1	5
OG0010249	1	1	1	2	5
OG0010250	1	1	2	1	5
OG0010251	1	1	2	1	5
OG0010252	1	1	2	1	5
OG0010253	2	1	1	1	5
OG0010254	2	1	1	1	5
OG0010255	1	2	2	0	5
OG0010256	1	1	2	1	5
OG0010257	1	1	1	2	5
OG0010258	1	1	1	2	5
OG0010259	1	1	2	1	5
OG0010260	1	2	1	1	5
OG0010261	2	1	1	1	5
OG0010262	1	1	1	2	5
OG0010263	1	1	1	2	5
OG0010264	1	1	2	1	5
OG0010265	1	1	1	2	5
OG0010266	2	1	1	1	5
OG0010267	2	1	1	1	5
OG0010268	1	1	2	1	5
OG0010269	1	1	1	2	5
OG0010270	1	1	1	2	5
OG0010271	2	1	1	1	5
OG0010272	1	1	2	1	5
OG0010273	1	1	2	1	5
OG0010274	2	1	1	1	5
OG0010275	2	1	1	1	5
OG0010276	1	1	2	1	5
OG0010277	1	1	2	1	5
OG0010278	1	1	2	1	5
OG0010279	1	1	1	2	5
OG0010280	1	1	2	1	5
OG0010281	1	1	2	1	5
OG0010282	2	1	1	1	5
OG0010283	1	1	2	1	5
OG0010284	2	1	1	1	5
OG0010285	1	1	2	1	5
OG0010286	1	1	1	2	5
OG0010287	2	1	1	1	5
OG0010288	2	1	1	1	5
OG0010289	1	1	1	2	5
OG0010290	1	1	1	2	5
OG0010291	1	1	2	1	5
OG0010292	2	1	1	1	5
OG0010293	1	1	2	1	5
OG0010294	1	2	1	1	5
OG0010295	1	1	1	2	5
OG0010296	1	1	1	2	5
OG0010297	1	1	1	2	5
OG0010298	1	1	2	1	5
OG0010299	1	1	2	1	5
OG0010300	1	1	2	1	5
OG0010301	1	1	2	1	5
OG0010302	1	1	1	2	5
OG0010303	1	1	1	2	5
OG0010304	1	1	1	2	5
OG0010305	1	1	1	2	5
OG0010306	1	1	2	1	5
OG0010307	2	1	1	1	5
OG0010308	1	1	2	1	5
OG0010309	1	1	1	2	5
OG0010310	1	1	1	2	5
OG0010311	2	1	1	1	5
OG0010312	1	1	1	2	5
OG0010313	1	1	1	2	5
OG0010314	2	1	1	1	5
OG0010315	1	1	2	1	5
OG0010316	1	2	1	1	5
OG0010317	1	1	1	2	5
OG0010318	1	1	0	3	5
OG0010319	2	1	1	1	5
OG0010320	1	1	2	1	5
OG0010321	1	1	2	1	5
OG0010322	1	1	2	1	5
OG0010323	1	1	2	1	5
OG0010324	1	1	2	1	5
OG0010325	1	1	1	2	5
OG0010326	2	1	1	1	5
OG0010327	1	1	1	2	5
OG0010328	1	1	1	2	5
OG0010329	1	1	1	2	5
OG0010330	1	1	2	1	5
OG0010331	1	1	2	1	5
OG0010332	1	1	2	1	5
OG0010333	1	1	2	1	5
OG0010334	2	1	1	1	5
OG0010335	2	1	1	1	5
OG0010336	1	1	1	2	5
OG0010337	1	1	2	1	5
OG0010338	1	1	1	2	5
OG0010339	1	1	2	1	5
OG0010340	2	1	1	1	5
OG0010341	1	1	1	2	5
OG0010342	1	1	1	2	5
OG0010343	1	1	2	1	5
OG0010344	1	2	1	1	5
OG0010345	1	1	2	1	5
OG0010346	2	1	1	1	5
OG0010347	2	1	1	1	5
OG0010348	1	1	2	1	5
OG0010349	1	1	2	1	5
OG0010350	1	1	1	2	5
OG0010351	1	1	1	2	5
OG0010352	1	1	1	2	5
OG0010353	1	1	2	1	5
OG0010354	2	1	1	1	5
OG0010355	1	1	1	2	5
OG0010356	1	1	2	1	5
OG0010357	1	1	1	2	5
OG0010358	1	1	1	2	5
OG0010359	1	1	2	1	5
OG0010360	1	1	1	2	5
OG0010361	2	1	1	1	5
OG0010362	1	1	2	1	5
OG0010363	1	1	2	1	5
OG0010364	1	1	2	1	5
OG0010365	1	1	1	2	5
OG0010366	1	1	1	2	5
OG0010367	1	1	2	1	5
OG0010368	2	1	1	1	5
OG0010369	1	1	2	1	5
OG0010370	1	1	1	2	5
OG0010371	1	1	2	1	5
OG0010372	1	2	1	1	5
OG0010373	1	1	1	2	5
OG0010374	1	1	2	1	5
OG0010375	1	0	2	2	5
OG0010376	1	1	0	3	5
OG0010377	1	1	1	2	5
OG0010378	1	1	1	2	5
OG0010379	1	1	2	1	5
OG0010380	1	2	1	1	5
OG0010381	1	1	1	2	5
OG0010382	1	0	1	3	5
OG0010383	1	1	2	1	5
OG0010384	1	1	2	1	5
OG0010385	1	1	2	1	5
OG0010386	2	1	1	1	5
OG0010387	1	3	1	0	5
OG0010388	2	1	1	1	5
OG0010389	1	1	1	2	5
OG0010390	1	1	2	1	5
OG0010391	1	1	2	1	5
OG0010392	1	1	1	2	5
OG0010393	1	1	2	1	5
OG0010394	2	1	0	2	5
OG0010395	1	1	2	1	5
OG0010396	1	1	2	1	5
OG0010397	1	1	2	1	5
OG0010398	1	1	2	1	5
OG0010399	2	1	1	1	5
OG0010400	1	1	1	2	5
OG0010401	1	0	3	1	5
OG0010402	1	1	1	2	5
OG0010403	1	1	1	2	5
OG0010404	1	1	1	2	5
OG0010405	1	1	2	1	5
OG0010406	2	1	1	1	5
OG0010407	1	1	1	2	5
OG0010408	2	1	1	1	5
OG0010409	1	1	2	1	5
OG0010410	2	1	1	1	5
OG0010411	1	1	2	1	5
OG0010412	1	1	2	1	5
OG0010413	2	1	1	1	5
OG0010414	1	1	2	1	5
OG0010415	1	1	2	1	5
OG0010416	1	1	2	1	5
OG0010417	1	1	1	2	5
OG0010418	1	1	2	1	5
OG0010419	2	1	1	1	5
OG0010420	1	0	1	3	5
OG0010421	1	1	1	2	5
OG0010422	1	0	2	2	5
OG0010423	1	1	1	2	5
OG0010424	1	1	1	2	5
OG0010425	1	1	2	1	5
OG0010426	1	1	2	1	5
OG0010427	2	0	2	1	5
OG0010428	1	0	1	3	5
OG0010429	1	1	1	2	5
OG0010430	1	1	1	2	5
OG0010431	2	0	2	1	5
OG0010432	4	1	0	0	5
OG0010433	1	1	1	2	5
OG0010434	1	1	1	2	5
OG0010435	1	1	1	2	5
OG0010436	1	1	1	2	5
OG0010437	1	1	2	1	5
OG0010438	1	1	2	1	5
OG0010439	1	1	3	0	5
OG0010440	1	1	2	1	5
OG0010441	1	1	2	1	5
OG0010442	1	1	1	2	5
OG0010443	1	2	1	1	5
OG0010444	1	1	2	1	5
OG0010445	1	1	1	2	5
OG0010446	1	1	1	2	5
OG0010447	2	1	1	1	5
OG0010448	1	1	1	2	5
OG0010449	1	1	2	1	5
OG0010450	1	1	2	1	5
OG0010451	1	1	1	2	5
OG0010452	1	1	2	1	5
OG0010453	1	2	1	1	5
OG0010454	1	1	2	1	5
OG0010455	1	2	1	1	5
OG0010456	1	1	1	2	5
OG0010457	2	1	1	1	5
OG0010458	1	1	2	1	5
OG0010459	1	1	2	1	5
OG0010460	1	1	1	2	5
OG0010461	2	1	0	2	5
OG0010462	1	1	1	2	5
OG0010463	1	1	2	1	5
OG0010464	1	1	2	1	5
OG0010465	2	1	1	1	5
OG0010466	1	1	1	2	5
OG0010467	2	3	0	0	5
OG0010468	1	1	1	2	5
OG0010469	1	1	2	1	5
OG0010470	1	1	1	2	5
OG0010471	1	1	2	1	5
OG0010472	1	1	1	2	5
OG0010473	1	1	2	1	5
OG0010474	1	1	2	1	5
OG0010475	1	1	2	1	5
OG0010476	1	1	1	2	5
OG0010477	1	1	1	2	5
OG0010478	1	1	1	2	5
OG0010479	2	1	1	1	5
OG0010480	2	3	0	0	5
OG0010481	2	2	0	1	5
OG0010482	1	1	1	2	5
OG0010483	2	3	0	0	5
OG0010484	5	0	0	0	5
OG0010485	1	1	2	1	5
OG0010486	1	1	1	2	5
OG0010487	3	1	1	0	5
OG0010488	1	1	1	2	5
OG0010489	2	1	1	1	5
OG0010490	2	1	1	1	5
OG0010491	1	1	2	1	5
OG0010492	1	1	1	2	5
OG0010493	2	1	1	1	5
OG0010494	1	1	1	2	5
OG0010495	2	1	1	1	5
OG0010496	2	3	0	0	5
OG0010497	1	1	2	1	5
OG0010498	1	1	2	1	5
OG0010499	2	3	0	0	5
OG0010500	2	2	0	1	5
OG0010501	1	1	2	1	5
OG0010502	2	1	1	1	5
OG0010503	1	1	1	2	5
OG0010504	1	1	2	1	5
OG0010505	1	1	1	2	5
OG0010506	2	3	0	0	5
OG0010507	1	1	2	1	5
OG0010508	1	2	1	1	5
OG0010509	2	3	0	0	5
OG0010510	1	1	1	2	5
OG0010511	3	1	1	0	5
OG0010512	1	0	2	2	5
OG0010513	1	1	2	1	5
OG0010514	1	4	0	0	5
OG0010515	2	1	1	1	5
OG0010516	1	4	0	0	5
OG0010517	1	2	2	0	5
OG0010518	1	1	2	1	5
OG0010519	1	1	1	2	5
OG0010520	1	4	0	0	5
OG0010521	1	1	2	1	5
OG0010522	2	3	0	0	5
OG0010523	1	1	1	2	5
OG0010524	1	2	1	1	5
OG0010525	4	0	1	0	5
OG0010526	2	1	0	2	5
OG0010527	1	1	1	2	5
OG0010528	1	1	1	2	5
OG0010529	2	1	1	1	5
OG0010530	5	0	0	0	5
OG0010531	1	1	2	1	5
OG0010532	2	1	1	1	5
OG0010533	1	1	1	2	5
OG0010534	1	1	1	2	5
OG0010535	1	2	1	1	5
OG0010536	1	1	2	1	5
OG0010537	1	1	2	1	5
OG0010538	1	1	2	1	5
OG0010539	1	1	1	2	5
OG0010540	1	1	1	2	5
OG0010541	1	0	0	4	5
OG0010542	1	3	0	1	5
OG0010543	1	1	2	1	5
OG0010544	2	1	1	1	5
OG0010545	1	1	2	1	5
OG0010546	2	1	1	1	5
OG0010547	1	1	1	2	5
OG0010548	1	1	2	1	5
OG0010549	1	1	2	1	5
OG0010550	3	2	0	0	5
OG0010551	1	1	1	2	5
OG0010552	1	2	1	1	5
OG0010553	1	1	1	2	5
OG0010554	1	1	2	1	5
OG0010555	1	1	2	1	5
OG0010556	1	1	1	2	5
OG0010557	1	1	1	2	5
OG0010558	1	1	2	1	5
OG0010559	1	1	2	1	5
OG0010560	1	1	1	2	5
OG0010561	1	1	2	1	5
OG0010562	1	1	1	2	5
OG0010563	1	4	0	0	5
OG0010564	1	1	2	1	5
OG0010565	3	0	1	1	5
OG0010566	2	1	1	1	5
OG0010567	1	1	2	1	5
OG0010568	2	1	1	1	5
OG0010569	1	1	1	2	5
OG0010570	1	1	1	2	5
OG0010571	1	1	1	2	5
OG0010572	1	1	1	2	5
OG0010573	1	1	2	1	5
OG0010574	1	1	2	1	5
OG0010575	1	1	1	2	5
OG0010576	2	1	1	1	5
OG0010577	3	1	0	1	5
OG0010578	1	1	1	2	5
OG0010579	1	1	1	2	5
OG0010580	1	1	2	1	5
OG0010581	1	1	2	1	5
OG0010582	1	1	1	2	5
OG0010583	1	1	2	1	5
OG0010584	1	1	1	2	5
OG0010585	1	1	3	0	5
OG0010586	1	1	2	1	5
OG0010587	1	2	1	1	5
OG0010588	2	1	1	1	5
OG0010589	1	1	2	1	5
OG0010590	1	1	2	1	5
OG0010591	2	1	1	1	5
OG0010592	1	1	1	2	5
OG0010593	1	1	1	2	5
OG0010594	1	1	2	1	5
OG0010595	1	1	1	2	5
OG0010596	1	1	2	1	5
OG0010597	3	2	0	0	5
OG0010598	1	2	1	1	5
OG0010599	1	2	1	1	5
OG0010600	1	1	1	2	5
OG0010601	1	1	2	1	5
OG0010602	1	1	1	2	5
OG0010603	1	1	2	1	5
OG0010604	2	1	1	1	5
OG0010605	1	1	2	1	5
OG0010606	1	1	2	1	5
OG0010607	1	1	2	1	5
OG0010608	1	1	1	2	5
OG0010609	1	1	2	1	5
OG0010610	1	1	2	1	5
OG0010611	1	0	2	2	5
OG0010612	2	1	1	1	5
OG0010613	1	1	1	2	5
OG0010614	2	1	1	1	5
OG0010615	1	2	1	1	5
OG0010616	2	1	1	1	5
OG0010617	1	1	1	2	5
OG0010618	2	1	1	1	5
OG0010619	1	2	1	1	5
OG0010620	1	1	1	2	5
OG0010621	2	1	1	1	5
OG0010622	2	1	1	1	5
OG0010623	1	1	2	1	5
OG0010624	1	1	1	2	5
OG0010625	1	1	2	1	5
OG0010626	1	1	2	1	5
OG0010627	2	1	1	1	5
OG0010628	1	1	2	1	5
OG0010629	1	1	2	1	5
OG0010630	1	1	1	2	5
OG0010631	1	1	2	1	5
OG0010632	1	1	2	1	5
OG0010633	1	1	2	1	5
OG0010634	1	1	1	2	5
OG0010635	4	1	0	0	5
OG0010636	1	1	1	2	5
OG0010637	1	1	2	1	5
OG0010638	1	1	2	1	5
OG0010639	1	1	1	2	5
OG0010640	1	1	2	1	5
OG0010641	1	1	2	1	5
OG0010642	1	1	1	2	5
OG0010643	2	1	1	1	5
OG0010644	1	1	1	2	5
OG0010645	1	1	1	2	5
OG0010646	2	1	1	1	5
OG0010647	1	1	2	1	5
OG0010648	1	1	1	2	5
OG0010649	1	1	1	2	5
OG0010650	2	0	1	2	5
OG0010651	1	1	2	1	5
OG0010652	2	1	1	1	5
OG0010653	1	1	1	2	5
OG0010654	1	2	1	1	5
OG0010655	1	2	1	1	5
OG0010656	1	1	1	2	5
OG0010657	1	0	2	2	5
OG0010658	1	0	3	1	5
OG0010659	1	1	1	2	5
OG0010660	2	1	1	1	5
OG0010661	1	1	1	2	5
OG0010662	1	1	1	2	5
OG0010663	1	1	2	1	5
OG0010664	1	1	1	2	5
OG0010665	3	2	0	0	5
OG0010666	1	2	1	1	5
OG0010667	1	1	2	1	5
OG0010668	1	1	1	2	5
OG0010669	1	1	1	2	5
OG0010670	1	4	0	0	5
OG0010671	1	1	1	2	5
OG0010672	1	1	2	1	5
OG0010673	1	1	1	2	5
OG0010674	1	1	1	2	5
OG0010675	1	1	1	2	5
OG0010676	2	1	1	1	5
OG0010677	1	1	1	2	5
OG0010678	2	1	1	1	5
OG0010679	1	1	2	1	5
OG0010680	1	1	1	2	5
OG0010681	2	1	1	1	5
OG0010682	1	1	2	1	5
OG0010683	1	1	2	1	5
OG0010684	2	1	1	1	5
OG0010685	1	1	1	2	5
OG0010686	1	1	2	1	5
OG0010687	1	1	2	1	5
OG0010688	1	0	2	2	5
OG0010689	1	1	2	1	5
OG0010690	1	1	2	1	5
OG0010691	1	1	1	2	5
OG0010692	1	1	1	2	5
OG0010693	1	1	1	2	5
OG0010694	2	2	1	0	5
OG0010695	1	1	1	2	5
OG0010696	1	1	1	2	5
OG0010697	1	1	1	2	5
OG0010698	1	1	2	1	5
OG0010699	1	1	1	2	5
OG0010700	1	1	1	2	5
OG0010701	2	1	1	1	5
OG0010702	2	1	1	1	5
OG0010703	1	1	2	1	5
OG0010704	1	1	1	2	5
OG0010705	2	3	0	0	5
OG0010706	1	2	1	1	5
OG0010707	1	1	1	2	5
OG0010708	1	1	2	1	5
OG0010709	2	1	1	1	5
OG0010710	2	3	0	0	5
OG0010711	1	1	1	2	5
OG0010712	1	1	2	1	5
OG0010713	1	1	1	2	5
OG0010714	1	1	1	2	5
OG0010715	1	1	1	2	5
OG0010716	1	1	1	2	5
OG0010717	2	1	1	1	5
OG0010718	2	1	1	1	5
OG0010719	2	1	1	1	5
OG0010720	2	1	1	1	5
OG0010721	1	1	2	1	5
OG0010722	1	1	2	1	5
OG0010723	1	2	1	1	5
OG0010724	1	1	2	1	5
OG0010725	1	1	2	1	5
OG0010726	1	1	2	1	5
OG0010727	1	1	2	1	5
OG0010728	1	1	1	2	5
OG0010729	1	1	2	1	5
OG0010730	1	1	2	1	5
OG0010731	1	1	2	1	5
OG0010732	1	1	1	2	5
OG0010733	1	1	2	1	5
OG0010734	1	1	1	2	5
OG0010735	1	1	2	1	5
OG0010736	1	1	1	2	5
OG0010737	1	1	2	1	5
OG0010738	1	1	1	2	5
OG0010739	1	1	2	1	5
OG0010740	1	1	2	1	5
OG0010741	1	2	1	1	5
OG0010742	1	2	1	1	5
OG0010743	1	2	1	1	5
OG0010744	1	1	2	1	5
OG0010745	1	1	1	2	5
OG0010746	2	3	0	0	5
OG0010747	1	1	1	2	5
OG0010748	1	1	2	1	5
OG0010749	1	1	1	2	5
OG0010750	2	1	1	1	5
OG0010751	2	1	1	1	5
OG0010752	1	1	2	1	5
OG0010753	1	0	3	1	5
OG0010754	1	1	2	1	5
OG0010755	1	2	1	1	5
OG0010756	2	1	1	1	5
OG0010757	1	1	1	2	5
OG0010758	1	1	2	1	5
OG0010759	2	1	1	1	5
OG0010760	1	1	2	1	5
OG0010761	1	1	1	2	5
OG0010762	2	0	1	2	5
OG0010763	3	2	0	0	5
OG0010764	2	1	1	1	5
OG0010765	1	1	1	2	5
OG0010766	1	1	1	2	5
OG0010767	1	1	2	1	5
OG0010768	1	1	1	2	5
OG0010769	1	1	2	1	5
OG0010770	1	1	2	1	5
OG0010771	1	0	2	2	5
OG0010772	2	1	1	1	5
OG0010773	1	1	2	1	5
OG0010774	2	1	1	1	5
OG0010775	1	3	1	0	5
OG0010776	1	1	1	2	5
OG0010777	1	0	2	2	5
OG0010778	2	1	1	1	5
OG0010779	2	1	1	1	5
OG0010780	1	2	1	1	5
OG0010781	1	1	2	1	5
OG0010782	1	1	2	1	5
OG0010783	1	1	1	2	5
OG0010784	1	1	1	2	5
OG0010785	1	1	2	1	5
OG0010786	1	1	1	2	5
OG0010787	1	1	2	1	5
OG0010788	2	1	1	1	5
OG0010789	1	1	2	1	5
OG0010790	1	1	1	2	5
OG0010791	1	1	2	1	5
OG0010792	1	1	1	2	5
OG0010793	1	1	2	1	5
OG0010794	1	1	2	1	5
OG0010795	1	1	1	2	5
OG0010796	1	1	2	1	5
OG0010797	1	1	1	2	5
OG0010798	2	1	1	1	5
OG0010799	1	1	2	1	5
OG0010800	1	1	1	2	5
OG0010801	2	1	1	1	5
OG0010802	1	1	2	1	5
OG0010803	1	1	2	1	5
OG0010804	1	1	2	1	5
OG0010805	1	1	1	2	5
OG0010806	1	1	1	2	5
OG0010807	1	1	2	1	5
OG0010808	2	1	1	1	5
OG0010809	1	1	1	2	5
OG0010810	1	1	1	2	5
OG0010811	1	1	1	2	5
OG0010812	1	3	1	0	5
OG0010813	1	1	2	1	5
OG0010814	1	1	2	1	5
OG0010815	1	0	2	2	5
OG0010816	2	1	1	1	5
OG0010817	1	1	1	2	5
OG0010818	1	0	1	3	5
OG0010819	1	1	1	2	5
OG0010820	1	1	1	2	5
OG0010821	1	1	2	1	5
OG0010822	1	1	1	2	5
OG0010823	1	1	2	1	5
OG0010824	2	1	1	1	5
OG0010825	1	1	2	1	5
OG0010826	2	1	1	1	5
OG0010827	1	1	1	2	5
OG0010828	1	1	1	2	5
OG0010829	1	1	1	2	5
OG0010830	1	1	2	1	5
OG0010831	1	1	1	2	5
OG0010832	1	1	2	1	5
OG0010833	1	1	1	2	5
OG0010834	2	1	1	1	5
OG0010835	1	1	1	2	5
OG0010836	1	1	1	2	5
OG0010837	1	1	1	2	5
OG0010838	1	1	2	1	5
OG0010839	1	1	1	2	5
OG0010840	1	1	2	1	5
OG0010841	1	1	2	1	5
OG0010842	1	1	1	2	5
OG0010843	2	1	1	1	5
OG0010844	2	1	1	1	5
OG0010845	1	2	1	1	5
OG0010846	4	1	0	0	5
OG0010847	4	1	0	0	5
OG0010848	1	1	1	2	5
OG0010849	2	1	1	1	5
OG0010850	1	1	1	2	5
OG0010851	1	1	2	1	5
OG0010852	1	1	2	1	5
OG0010853	2	1	1	1	5
OG0010854	2	1	1	1	5
OG0010855	1	1	1	2	5
OG0010856	1	1	1	2	5
OG0010857	1	1	2	1	5
OG0010858	1	1	2	1	5
OG0010859	1	1	1	2	5
OG0010860	2	1	1	1	5
OG0010861	1	1	1	2	5
OG0010862	2	1	1	1	5
OG0010863	1	1	2	1	5
OG0010864	1	1	2	1	5
OG0010865	2	1	1	1	5
OG0010866	2	1	1	1	5
OG0010867	1	2	1	1	5
OG0010868	2	1	1	1	5
OG0010869	1	1	1	2	5
OG0010870	2	2	0	1	5
OG0010871	1	1	2	1	5
OG0010872	3	1	1	0	5
OG0010873	1	1	1	2	5
OG0010874	1	4	0	0	5
OG0010875	2	0	1	2	5
OG0010876	1	1	1	2	5
OG0010877	1	1	2	1	5
OG0010878	1	1	1	2	5
OG0010879	1	1	2	1	5
OG0010880	1	1	2	1	5
OG0010881	1	1	1	2	5
OG0010882	2	1	1	1	5
OG0010883	1	3	1	0	5
OG0010884	1	1	2	1	5
OG0010885	2	3	0	0	5
OG0010886	1	1	1	2	5
OG0010887	1	1	1	2	5
OG0010888	1	1	1	2	5
OG0010889	1	1	1	2	5
OG0010890	1	1	1	2	5
OG0010891	2	1	1	1	5
OG0010892	1	1	3	0	5
OG0010893	1	1	1	2	5
OG0010894	1	1	1	2	5
OG0010895	1	1	2	1	5
OG0010896	1	1	2	1	5
OG0010897	1	1	2	1	5
OG0010898	1	1	1	2	5
OG0010899	1	1	2	1	5
OG0010900	1	1	1	2	5
OG0010901	1	1	2	1	5
OG0010902	1	1	2	1	5
OG0010903	1	1	2	1	5
OG0010904	1	0	2	2	5
OG0010905	1	1	2	1	5
OG0010906	1	1	2	1	5
OG0010907	1	1	2	1	5
OG0010908	1	1	2	1	5
OG0010909	1	1	1	2	5
OG0010910	2	1	1	1	5
OG0010911	2	1	1	1	5
OG0010912	1	1	1	2	5
OG0010913	1	1	2	1	5
OG0010914	1	1	1	2	5
OG0010915	1	1	1	2	5
OG0010916	1	1	1	2	5
OG0010917	1	2	1	1	5
OG0010918	1	1	1	2	5
OG0010919	1	1	1	2	5
OG0010920	1	0	2	2	5
OG0010921	2	3	0	0	5
OG0010922	1	2	1	1	5
OG0010923	1	1	2	1	5
OG0010924	1	1	2	1	5
OG0010925	1	1	2	1	5
OG0010926	1	1	1	2	5
OG0010927	1	1	2	1	5
OG0010928	2	1	1	1	5
OG0010929	1	1	1	2	5
OG0010930	2	1	1	1	5
OG0010931	1	1	2	1	5
OG0010932	1	1	1	2	5
OG0010933	1	1	1	2	5
OG0010934	1	0	2	2	5
OG0010935	1	1	2	1	5
OG0010936	1	1	2	1	5
OG0010937	1	0	1	3	5
OG0010938	1	1	2	1	5
OG0010939	1	1	2	1	5
OG0010940	1	1	2	1	5
OG0010941	1	1	1	2	5
OG0010942	2	1	1	1	5
OG0010943	1	1	1	2	5
OG0010944	1	1	2	1	5
OG0010945	1	1	1	2	5
OG0010946	1	1	2	1	5
OG0010947	1	1	1	2	5
OG0010948	1	1	2	1	5
OG0010949	1	1	2	1	5
OG0010950	1	1	1	2	5
OG0010951	1	1	1	2	5
OG0010952	1	1	2	1	5
OG0010953	1	1	1	2	5
OG0010954	1	1	1	2	5
OG0010955	2	1	1	1	5
OG0010956	1	1	2	1	5
OG0010957	1	1	1	2	5
OG0010958	1	1	2	1	5
OG0010959	1	1	2	1	5
OG0010960	1	1	2	1	5
OG0010961	1	1	2	1	5
OG0010962	1	1	2	1	5
OG0010963	2	1	1	1	5
OG0010964	1	1	2	1	5
OG0010965	1	1	2	1	5
OG0010966	1	1	2	1	5
OG0010967	1	1	1	2	5
OG0010968	1	2	1	1	5
OG0010969	1	1	1	2	5
OG0010970	1	1	1	2	5
OG0010971	1	1	2	1	5
OG0010972	1	1	1	2	5
OG0010973	2	1	1	1	5
OG0010974	1	1	1	2	5
OG0010975	1	1	1	2	5
OG0010976	1	1	1	2	5
OG0010977	1	1	2	1	5
OG0010978	2	1	1	1	5
OG0010979	1	1	2	1	5
OG0010980	1	1	1	2	5
OG0010981	2	0	1	2	5
OG0010982	1	1	1	2	5
OG0010983	1	1	1	2	5
OG0010984	2	1	1	1	5
OG0010985	1	1	2	1	5
OG0010986	1	1	2	1	5
OG0010987	1	1	1	2	5
OG0010988	1	1	1	2	5
OG0010989	1	1	1	2	5
OG0010990	1	1	1	2	5
OG0010991	1	1	1	2	5
OG0010992	2	1	1	1	5
OG0010993	1	1	2	1	5
OG0010994	1	1	1	2	5
OG0010995	1	1	2	1	5
OG0010996	1	1	2	1	5
OG0010997	2	1	1	1	5
OG0010998	1	1	2	1	5
OG0010999	1	1	2	1	5
OG0011000	1	1	1	2	5
OG0011001	1	1	2	1	5
OG0011002	1	1	1	2	5
OG0011003	1	1	2	1	5
OG0011004	1	1	2	1	5
OG0011005	1	1	1	2	5
OG0011006	1	1	1	2	5
OG0011007	1	1	1	2	5
OG0011008	2	1	1	1	5
OG0011009	2	1	1	1	5
OG0011010	1	1	2	1	5
OG0011011	1	1	2	1	5
OG0011012	2	1	1	1	5
OG0011013	1	1	2	1	5
OG0011014	2	1	1	1	5
OG0011015	1	1	1	2	5
OG0011016	1	1	1	2	5
OG0011017	1	1	2	1	5
OG0011018	1	1	1	2	5
OG0011019	1	1	2	1	5
OG0011020	2	1	1	1	5
OG0011021	1	1	1	2	5
OG0011022	1	1	1	2	5
OG0011023	1	2	1	1	5
OG0011024	1	1	2	1	5
OG0011025	1	1	1	2	5
OG0011026	1	1	2	1	5
OG0011027	1	1	1	2	5
OG0011028	1	1	2	1	5
OG0011029	2	1	1	1	5
OG0011030	1	1	1	2	5
OG0011031	1	1	1	2	5
OG0011032	1	1	1	2	5
OG0011033	1	1	1	2	5
OG0011034	1	1	2	1	5
OG0011035	2	1	1	1	5
OG0011036	1	1	1	2	5
OG0011037	2	1	1	1	5
OG0011038	1	1	1	2	5
OG0011039	1	1	1	2	5
OG0011040	1	1	1	2	5
OG0011041	1	1	1	2	5
OG0011042	1	1	1	2	5
OG0011043	1	2	1	1	5
OG0011044	1	1	2	1	5
OG0011045	1	2	1	1	5
OG0011046	1	0	3	1	5
OG0011047	2	1	1	1	5
OG0011048	1	1	2	1	5
OG0011049	1	1	2	1	5
OG0011050	1	1	1	2	5
OG0011051	1	2	1	1	5
OG0011052	2	1	1	1	5
OG0011053	1	1	1	2	5
OG0011054	2	1	1	1	5
OG0011055	1	1	1	2	5
OG0011056	1	1	1	2	5
OG0011057	1	1	1	2	5
OG0011058	1	1	1	2	5
OG0011059	1	1	2	1	5
OG0011060	1	1	1	2	5
OG0011061	1	1	2	1	5
OG0011062	1	1	1	2	5
OG0011063	2	1	1	1	5
OG0011064	1	1	1	2	5
OG0011065	1	1	2	1	5
OG0011066	2	1	1	1	5
OG0011067	1	1	2	1	5
OG0011068	1	1	0	3	5
OG0011069	2	0	2	1	5
OG0011070	2	1	1	1	5
OG0011071	1	1	2	1	5
OG0011072	1	1	1	2	5
OG0011073	1	1	1	2	5
OG0011074	1	1	1	2	5
OG0011075	1	1	1	2	5
OG0011076	1	1	2	1	5
OG0011077	1	1	2	1	5
OG0011078	2	1	1	1	5
OG0011079	1	1	2	1	5
OG0011080	1	1	2	1	5
OG0011081	1	1	2	1	5
OG0011082	1	1	2	1	5
OG0011083	2	1	1	1	5
OG0011084	2	1	1	1	5
OG0011085	1	1	2	1	5
OG0011086	2	1	1	1	5
OG0011087	1	1	1	2	5
OG0011088	1	1	2	1	5
OG0011089	2	1	1	1	5
OG0011090	1	1	1	2	5
OG0011091	1	1	2	1	5
OG0011092	1	1	2	1	5
OG0011093	2	1	1	1	5
OG0011094	1	1	2	1	5
OG0011095	1	1	2	1	5
OG0011096	1	1	2	1	5
OG0011097	1	1	2	1	5
OG0011098	1	1	1	2	5
OG0011099	1	1	1	2	5
OG0011100	2	1	1	1	5
OG0011101	1	1	1	2	5
OG0011102	1	1	2	1	5
OG0011103	1	2	1	1	5
OG0011104	1	1	0	3	5
OG0011105	1	1	1	2	5
OG0011106	1	1	2	1	5
OG0011107	2	1	1	1	5
OG0011108	2	1	1	1	5
OG0011109	1	1	2	1	5
OG0011110	2	1	1	1	5
OG0011111	1	1	2	1	5
OG0011112	2	1	1	1	5
OG0011113	1	1	1	2	5
OG0011114	2	1	1	1	5
OG0011115	1	1	2	1	5
OG0011116	1	1	1	2	5
OG0011117	1	1	2	1	5
OG0011118	1	1	1	2	5
OG0011119	2	1	1	1	5
OG0011120	1	1	2	1	5
OG0011121	1	1	1	2	5
OG0011122	2	1	1	1	5
OG0011123	1	1	2	1	5
OG0011124	1	1	1	2	5
OG0011125	1	1	1	2	5
OG0011126	2	1	1	1	5
OG0011127	2	1	1	1	5
OG0011128	1	1	2	1	5
OG0011129	1	1	1	2	5
OG0011130	2	1	1	1	5
OG0011131	1	1	1	2	5
OG0011132	1	1	1	2	5
OG0011133	1	1	1	2	5
OG0011134	1	1	1	2	5
OG0011135	1	1	1	2	5
OG0011136	1	1	1	2	5
OG0011137	1	1	1	2	5
OG0011138	1	2	1	1	5
OG0011139	1	1	2	1	5
OG0011140	1	1	2	1	5
OG0011141	2	1	1	1	5
OG0011142	1	1	2	1	5
OG0011143	1	0	0	4	5
OG0011144	1	1	1	2	5
OG0011145	1	1	2	1	5
OG0011146	1	1	1	2	5
OG0011147	1	1	2	1	5
OG0011148	1	1	1	2	5
OG0011149	1	1	1	2	5
OG0011150	1	1	1	2	5
OG0011151	1	1	1	2	5
OG0011152	2	1	1	1	5
OG0011153	2	1	1	1	5
OG0011154	1	1	1	2	5
OG0011155	1	1	1	2	5
OG0011156	1	1	2	1	5
OG0011157	1	1	1	2	5
OG0011158	1	1	2	1	5
OG0011159	1	1	1	2	5
OG0011160	1	1	1	2	5
OG0011161	1	1	2	1	5
OG0011162	1	1	2	1	5
OG0011163	2	2	1	0	5
OG0011164	2	1	1	1	5
OG0011165	2	1	1	1	5
OG0011166	2	1	1	1	5
OG0011167	2	1	1	1	5
OG0011168	2	1	1	1	5
OG0011169	2	1	1	1	5
OG0011170	1	2	1	1	5
OG0011171	1	1	2	1	5
OG0011172	1	1	2	1	5
OG0011173	2	0	1	2	5
OG0011174	2	1	1	1	5
OG0011175	1	1	2	1	5
OG0011176	1	1	2	1	5
OG0011177	1	1	1	2	5
OG0011178	1	1	1	2	5
OG0011179	1	1	2	1	5
OG0011180	1	1	1	2	5
OG0011181	1	1	1	2	5
OG0011182	1	0	2	2	5
OG0011183	2	1	1	1	5
OG0011184	1	1	1	2	5
OG0011185	1	1	1	2	5
OG0011186	1	1	2	1	5
OG0011187	1	1	1	2	5
OG0011188	1	1	2	1	5
OG0011189	1	1	2	1	5
OG0011190	1	1	1	2	5
OG0011191	1	1	2	1	5
OG0011192	1	1	2	1	5
OG0011193	1	1	2	1	5
OG0011194	1	1	2	1	5
OG0011195	1	1	2	1	5
OG0011196	1	1	2	1	5
OG0011197	1	1	1	2	5
OG0011198	1	1	2	1	5
OG0011199	2	1	1	1	5
OG0011200	1	1	1	2	5
OG0011201	1	4	0	0	5
OG0011202	2	1	1	1	5
OG0011203	1	1	1	2	5
OG0011204	1	1	2	1	5
OG0011205	1	1	1	2	5
OG0011206	1	1	2	1	5
OG0011207	2	1	2	0	5
OG0011208	1	1	2	1	5
OG0011209	1	1	1	2	5
OG0011210	1	1	1	2	5
OG0011211	1	1	2	1	5
OG0011212	2	1	1	1	5
OG0011213	2	1	1	1	5
OG0011214	2	1	1	1	5
OG0011215	2	1	1	1	5
OG0011216	1	1	2	1	5
OG0011217	1	1	1	2	5
OG0011218	1	1	2	1	5
OG0011219	1	2	1	1	5
OG0011220	1	1	2	1	5
OG0011221	1	1	1	2	5
OG0011222	2	1	1	1	5
OG0011223	1	1	2	1	5
OG0011224	1	1	1	2	5
OG0011225	1	1	1	2	5
OG0011226	2	1	1	1	5
OG0011227	1	0	3	1	5
OG0011228	1	1	1	2	5
OG0011229	1	1	2	1	5
OG0011230	1	1	1	2	5
OG0011231	1	1	2	1	5
OG0011232	1	1	2	1	5
OG0011233	1	1	2	1	5
OG0011234	1	1	1	2	5
OG0011235	2	1	1	1	5
OG0011236	1	1	1	2	5
OG0011237	1	2	1	1	5
OG0011238	1	1	1	2	5
OG0011239	1	1	2	1	5
OG0011240	1	1	2	1	5
OG0011241	1	1	2	1	5
OG0011242	1	1	1	2	5
OG0011243	1	1	1	2	5
OG0011244	1	1	0	3	5
OG0011245	2	2	0	1	5
OG0011246	1	1	2	1	5
OG0011247	4	0	0	1	5
OG0011248	1	1	1	2	5
OG0011249	1	1	1	2	5
OG0011250	1	2	1	1	5
OG0011251	1	1	1	2	5
OG0011252	1	1	1	2	5
OG0011253	2	2	1	0	5
OG0011254	1	1	2	1	5
OG0011255	1	1	2	1	5
OG0011256	1	1	3	0	5
OG0011257	1	1	1	2	5
OG0011258	1	1	2	1	5
OG0011259	1	1	1	2	5
OG0011260	2	1	1	1	5
OG0011261	1	1	2	1	5
OG0011262	1	1	1	2	5
OG0011263	1	1	1	2	5
OG0011264	1	1	1	2	5
OG0011265	1	1	2	1	5
OG0011266	2	1	2	0	5
OG0011267	1	1	2	1	5
OG0011268	1	1	2	1	5
OG0011269	2	3	0	0	5
OG0011270	2	1	1	1	5
OG0011271	1	1	1	2	5
OG0011272	1	1	1	2	5
OG0011273	1	1	1	2	5
OG0011274	1	1	1	2	5
OG0011275	3	1	0	1	5
OG0011276	1	1	1	2	5
OG0011277	1	1	2	1	5
OG0011278	1	1	2	1	5
OG0011279	1	1	2	1	5
OG0011280	1	1	1	2	5
OG0011281	1	1	2	1	5
OG0011282	2	1	1	1	5
OG0011283	1	1	2	1	5
OG0011284	1	1	1	2	5
OG0011285	1	1	1	2	5
OG0011286	1	1	1	2	5
OG0011287	1	1	1	2	5
OG0011288	2	1	1	1	5
OG0011289	3	1	0	1	5
OG0011290	1	1	1	2	5
OG0011291	1	1	1	2	5
OG0011292	1	1	2	1	5
OG0011293	1	1	1	2	5
OG0011294	4	1	0	0	5
OG0011295	1	1	1	2	5
OG0011296	2	1	1	1	5
OG0011297	1	1	1	2	5
OG0011298	1	1	2	1	5
OG0011299	1	1	1	2	5
OG0011300	1	1	2	1	5
OG0011301	1	1	2	1	5
OG0011302	2	2	1	0	5
OG0011303	1	2	1	1	5
OG0011304	1	1	1	2	5
OG0011305	1	1	1	2	5
OG0011306	2	1	1	1	5
OG0011307	1	1	1	2	5
OG0011308	1	1	1	2	5
OG0011309	1	1	1	2	5
OG0011310	1	1	1	2	5
OG0011311	1	1	1	2	5
OG0011312	1	2	1	1	5
OG0011313	1	1	2	1	5
OG0011314	2	1	1	1	5
OG0011315	1	1	2	1	5
OG0011316	1	4	0	0	5
OG0011317	1	1	2	1	5
OG0011318	1	0	2	2	5
OG0011319	1	1	1	2	5
OG0011320	2	1	1	1	5
OG0011321	1	4	0	0	5
OG0011322	2	1	1	1	5
OG0011323	1	1	1	2	5
OG0011324	1	1	1	2	5
OG0011325	1	1	2	1	5
OG0011326	1	1	1	2	5
OG0011327	1	1	2	1	5
OG0011328	1	4	0	0	5
OG0011329	1	1	2	1	5
OG0011330	1	1	1	2	5
OG0011331	1	1	2	1	5
OG0011332	1	1	2	1	5
OG0011333	1	4	0	0	5
OG0011334	1	4	0	0	5
OG0011335	1	1	2	1	5
OG0011336	1	1	1	2	5
OG0011337	2	1	1	1	5
OG0011338	1	1	1	2	5
OG0011339	1	1	2	1	5
OG0011340	1	1	1	2	5
OG0011341	2	2	1	0	5
OG0011342	2	2	1	0	5
OG0011343	2	1	1	1	5
OG0011344	1	1	2	1	5
OG0011345	1	2	1	1	5
OG0011346	1	2	1	1	5
OG0011347	1	1	1	2	5
OG0011348	1	1	2	1	5
OG0011349	1	1	1	2	5
OG0011350	1	1	1	2	5
OG0011351	1	1	2	1	5
OG0011352	2	1	1	1	5
OG0011353	2	2	1	0	5
OG0011354	1	1	2	1	5
OG0011355	1	1	2	1	5
OG0011356	1	1	2	1	5
OG0011357	1	1	1	2	5
OG0011358	1	1	1	2	5
OG0011359	1	1	2	1	5
OG0011360	1	1	2	1	5
OG0011361	1	1	1	2	5
OG0011362	3	2	0	0	5
OG0011363	2	1	1	1	5
OG0011364	2	1	1	1	5
OG0011365	1	1	1	2	5
OG0011366	1	1	1	2	5
OG0011367	1	2	1	1	5
OG0011368	2	1	0	2	5
OG0011369	1	1	1	2	5
OG0011370	1	2	1	1	5
OG0011371	1	1	1	2	5
OG0011372	1	1	1	2	5
OG0011373	1	1	1	2	5
OG0011374	1	1	1	2	5
OG0011375	1	1	2	1	5
OG0011376	1	1	1	2	5
OG0011377	1	1	2	1	5
OG0011378	2	1	1	1	5
OG0011379	1	1	2	1	5
OG0011380	1	1	1	2	5
OG0011381	1	2	1	1	5
OG0011382	1	2	1	1	5
OG0011383	1	1	1	2	5
OG0011384	1	1	1	2	5
OG0011385	1	1	1	2	5
OG0011386	1	1	1	2	5
OG0011387	1	1	2	1	5
OG0011388	1	1	2	1	5
OG0011389	1	1	2	1	5
OG0011390	2	1	1	1	5
OG0011391	1	4	0	0	5
OG0011392	1	1	1	2	5
OG0011393	1	2	1	1	5
OG0011394	1	1	2	1	5
OG0011395	1	0	2	2	5
OG0011396	1	1	2	1	5
OG0011397	2	1	1	1	5
OG0011398	1	1	2	1	5
OG0011399	1	1	1	2	5
OG0011400	1	1	1	2	5
OG0011401	1	1	1	2	5
OG0011402	1	1	2	1	5
OG0011403	1	1	2	1	5
OG0011404	1	1	1	2	5
OG0011405	1	1	2	1	5
OG0011406	1	2	2	0	5
OG0011407	1	1	1	2	5
OG0011408	1	1	2	1	5
OG0011409	1	1	2	1	5
OG0011410	1	1	2	1	5
OG0011411	1	1	2	1	5
OG0011412	1	1	2	1	5
OG0011413	1	1	1	2	5
OG0011414	1	1	1	2	5
OG0011415	1	1	2	1	5
OG0011416	1	1	2	1	5
OG0011417	1	1	2	1	5
OG0011418	1	1	1	2	5
OG0011419	2	1	1	1	5
OG0011420	1	1	2	1	5
OG0011421	1	2	1	1	5
OG0011422	1	1	1	2	5
OG0011423	1	1	1	2	5
OG0011424	1	1	2	1	5
OG0011425	1	1	1	2	5
OG0011426	1	1	2	1	5
OG0011427	1	1	1	2	5
OG0011428	1	1	1	2	5
OG0011429	1	1	2	1	5
OG0011430	1	1	2	1	5
OG0011431	2	1	1	1	5
OG0011432	1	1	1	2	5
OG0011433	1	2	1	1	5
OG0011434	1	1	2	1	5
OG0011435	1	1	1	2	5
OG0011436	1	1	2	1	5
OG0011437	2	1	1	1	5
OG0011438	2	1	1	1	5
OG0011439	1	1	2	1	5
OG0011440	1	1	2	1	5
OG0011441	2	1	1	1	5
OG0011442	1	1	2	1	5
OG0011443	1	1	2	1	5
OG0011444	1	1	1	2	5
OG0011445	1	1	2	1	5
OG0011446	1	1	2	1	5
OG0011447	1	1	1	2	5
OG0011448	2	1	1	1	5
OG0011449	1	0	3	1	5
OG0011450	1	1	2	1	5
OG0011451	2	1	1	1	5
OG0011452	2	1	1	1	5
OG0011453	2	1	1	1	5
OG0011454	2	1	1	1	5
OG0011455	1	1	1	2	5
OG0011456	1	1	2	1	5
OG0011457	2	1	1	1	5
OG0011458	1	1	2	1	5
OG0011459	2	2	1	0	5
OG0011460	1	1	1	2	5
OG0011461	1	1	1	2	5
OG0011462	1	1	1	2	5
OG0011463	1	1	1	2	5
OG0011464	2	1	1	1	5
OG0011465	1	1	1	2	5
OG0011466	1	1	1	2	5
OG0011467	2	1	1	1	5
OG0011468	1	2	1	1	5
OG0011469	1	1	1	2	5
OG0011470	1	2	1	1	5
OG0011471	1	2	1	1	5
OG0011472	1	1	1	2	5
OG0011473	1	1	1	2	5
OG0011474	1	1	2	1	5
OG0011475	2	1	1	1	5
OG0011476	1	1	2	1	5
OG0011477	1	1	1	2	5
OG0011478	1	1	2	1	5
OG0011479	1	1	1	2	5
OG0011480	5	0	0	0	5
OG0011481	2	1	1	1	5
OG0011482	1	0	1	3	5
OG0011483	1	1	2	1	5
OG0011484	1	1	1	2	5
OG0011485	1	1	2	1	5
OG0011486	2	1	1	1	5
OG0011487	1	1	2	1	5
OG0011488	1	1	2	1	5
OG0011489	1	1	1	2	5
OG0011490	1	1	2	1	5
OG0011491	1	1	2	1	5
OG0011492	1	1	2	1	5
OG0011493	1	1	1	2	5
OG0011494	1	1	1	2	5
OG0011495	2	1	1	1	5
OG0011496	1	2	1	1	5
OG0011497	1	1	1	2	5
OG0011498	1	1	1	2	5
OG0011499	1	1	1	2	5
OG0011500	1	1	1	2	5
OG0011501	1	1	2	1	5
OG0011502	3	0	1	1	5
OG0011503	2	1	1	1	5
OG0011504	2	1	1	1	5
OG0011505	1	2	1	1	5
OG0011506	1	1	1	2	5
OG0011507	2	0	2	1	5
OG0011508	2	2	0	1	5
OG0011509	1	1	2	1	5
OG0011510	1	2	1	1	5
OG0011511	2	1	1	1	5
OG0011512	1	1	2	1	5
OG0011513	1	1	1	2	5
OG0011514	1	1	1	2	5
OG0011515	1	1	2	1	5
OG0011516	1	1	2	1	5
OG0011517	1	1	2	1	5
OG0011518	2	1	1	1	5
OG0011519	2	1	1	1	5
OG0011520	1	1	1	2	5
OG0011521	1	1	1	2	5
OG0011522	2	2	0	1	5
OG0011523	1	1	1	2	5
OG0011524	1	0	2	2	5
OG0011525	1	1	2	1	5
OG0011526	1	1	2	1	5
OG0011527	2	1	1	1	5
OG0011528	1	1	1	2	5
OG0011529	1	1	1	2	5
OG0011530	1	1	2	1	5
OG0011531	1	1	2	1	5
OG0011532	1	1	2	1	5
OG0011533	2	1	1	1	5
OG0011534	1	1	1	2	5
OG0011535	1	1	2	1	5
OG0011536	1	1	2	1	5
OG0011537	1	2	1	1	5
OG0011538	1	0	1	3	5
OG0011539	1	1	1	2	5
OG0011540	1	1	2	1	5
OG0011541	2	1	1	1	5
OG0011542	1	1	2	1	5
OG0011543	1	1	1	2	5
OG0011544	1	1	2	1	5
OG0011545	1	2	0	2	5
OG0011546	1	1	1	2	5
OG0011547	2	1	1	1	5
OG0011548	1	2	1	1	5
OG0011549	1	1	2	1	5
OG0011550	1	1	1	2	5
OG0011551	1	1	3	0	5
OG0011552	1	1	1	2	5
OG0011553	1	1	0	3	5
OG0011554	2	1	1	1	5
OG0011555	2	1	1	1	5
OG0011556	2	1	1	1	5
OG0011557	1	1	1	2	5
OG0011558	2	1	1	1	5
OG0011559	1	1	1	2	5
OG0011560	1	1	1	2	5
OG0011561	1	2	1	1	5
OG0011562	1	1	1	2	5
OG0011563	1	1	1	2	5
OG0011564	1	1	1	2	5
OG0011565	1	1	1	2	5
OG0011566	1	1	2	1	5
OG0011567	1	2	1	1	5
OG0011568	2	1	1	1	5
OG0011569	2	1	1	1	5
OG0011570	1	1	1	2	5
OG0011571	1	1	2	1	5
OG0011572	2	1	1	1	5
OG0011573	1	1	2	1	5
OG0011574	1	1	1	2	5
OG0011575	1	1	1	2	5
OG0011576	1	1	2	1	5
OG0011577	1	1	1	2	5
OG0011578	1	1	2	1	5
OG0011579	1	1	1	2	5
OG0011580	1	1	1	2	5
OG0011581	1	1	1	2	5
OG0011582	1	1	1	2	5
OG0011583	1	2	1	1	5
OG0011584	1	1	2	1	5
OG0011585	1	1	1	2	5
OG0011586	1	1	2	1	5
OG0011587	2	1	0	2	5
OG0011588	1	1	2	1	5
OG0011589	1	1	2	1	5
OG0011590	1	1	1	2	5
OG0011591	1	1	3	0	5
OG0011592	1	1	2	1	5
OG0011593	1	1	2	1	5
OG0011594	1	1	1	2	5
OG0011595	1	1	2	1	5
OG0011596	2	1	2	0	5
OG0011597	1	1	1	2	5
OG0011598	1	0	2	2	5
OG0011599	1	1	2	1	5
OG0011600	1	1	2	1	5
OG0011601	2	1	1	1	5
OG0011602	1	1	1	2	5
OG0011603	1	1	1	2	5
OG0011604	1	1	1	2	5
OG0011605	1	1	1	2	5
OG0011606	1	1	2	1	5
OG0011607	1	1	1	2	5
OG0011608	2	1	1	1	5
OG0011609	1	1	2	1	5
OG0011610	2	1	1	1	5
OG0011611	1	1	1	2	5
OG0011612	1	1	2	1	5
OG0011613	1	1	2	1	5
OG0011614	1	1	2	1	5
OG0011615	1	0	2	2	5
OG0011616	1	1	2	1	5
OG0011617	1	1	1	2	5
OG0011618	1	1	1	2	5
OG0011619	2	1	1	1	5
OG0011620	2	1	1	1	5
OG0011621	1	1	2	1	5
OG0011622	1	1	1	2	5
OG0011623	1	1	2	1	5
OG0011624	2	1	1	1	5
OG0011625	1	0	2	2	5
OG0011626	2	1	1	1	5
OG0011627	1	1	2	1	5
OG0011628	1	1	1	2	5
OG0011629	2	1	1	1	5
OG0011630	1	1	2	1	5
OG0011631	1	1	1	2	5
OG0011632	1	1	2	1	5
OG0011633	1	1	2	1	5
OG0011634	1	1	1	2	5
OG0011635	1	1	2	1	5
OG0011636	1	1	2	1	5
OG0011637	4	0	1	0	5
OG0011638	1	1	2	1	5
OG0011639	1	1	1	2	5
OG0011640	1	1	1	2	5
OG0011641	1	1	2	1	5
OG0011642	1	1	1	2	5
OG0011643	2	1	1	1	5
OG0011644	1	1	2	1	5
OG0011645	1	1	1	2	5
OG0011646	2	1	1	1	5
OG0011647	1	1	1	2	5
OG0011648	1	1	2	1	5
OG0011649	1	1	1	2	5
OG0011650	1	1	2	1	5
OG0011651	1	1	2	1	5
OG0011652	1	2	1	1	5
OG0011653	1	1	1	2	5
OG0011654	2	1	1	1	5
OG0011655	1	1	1	2	5
OG0011656	1	3	0	1	5
OG0011657	1	1	2	1	5
OG0011658	1	1	1	2	5
OG0011659	1	1	1	2	5
OG0011660	1	1	1	2	5
OG0011661	1	1	1	2	5
OG0011662	1	1	1	2	5
OG0011663	1	1	1	2	5
OG0011664	2	1	1	1	5
OG0011665	1	1	1	2	5
OG0011666	1	1	1	2	5
OG0011667	1	1	1	2	5
OG0011668	1	1	1	2	5
OG0011669	1	1	2	1	5
OG0011670	1	1	1	2	5
OG0011671	3	2	0	0	5
OG0011672	1	1	2	1	5
OG0011673	1	1	1	2	5
OG0011674	1	1	1	2	5
OG0011675	1	1	1	2	5
OG0011676	1	1	2	1	5
OG0011677	2	1	1	1	5
OG0011678	1	1	1	2	5
OG0011679	1	1	1	2	5
OG0011680	1	1	1	2	5
OG0011681	1	1	2	1	5
OG0011682	1	0	1	3	5
OG0011683	1	1	2	1	5
OG0011684	1	1	1	2	5
OG0011685	1	1	2	1	5
OG0011686	1	1	2	1	5
OG0011687	1	1	1	2	5
OG0011688	1	1	2	1	5
OG0011689	1	1	2	1	5
OG0011690	1	1	1	2	5
OG0011691	1	1	1	2	5
OG0011692	1	1	1	2	5
OG0011693	1	1	1	2	5
OG0011694	2	1	1	1	5
OG0011695	1	1	1	2	5
OG0011696	1	1	1	2	5
OG0011697	1	1	1	2	5
OG0011698	1	1	2	1	5
OG0011699	1	1	2	1	5
OG0011700	1	1	1	2	5
OG0011701	1	1	2	1	5
OG0011702	1	1	1	2	5
OG0011703	1	1	2	1	5
OG0011704	2	1	1	1	5
OG0011705	2	2	1	0	5
OG0011706	1	1	1	2	5
OG0011707	1	1	1	2	5
OG0011708	1	1	1	2	5
OG0011709	1	1	1	2	5
OG0011710	1	1	2	1	5
OG0011711	1	1	1	2	5
OG0011712	1	1	1	2	5
OG0011713	1	1	1	2	5
OG0011714	1	1	1	2	5
OG0011715	1	1	1	2	5
OG0011716	1	1	1	2	5
OG0011717	1	1	2	1	5
OG0011718	1	1	1	2	5
OG0011719	1	1	2	1	5
OG0011720	1	1	2	1	5
OG0011721	2	1	1	1	5
OG0011722	1	1	1	2	5
OG0011723	1	2	1	1	5
OG0011724	1	1	1	2	5
OG0011725	2	1	1	1	5
OG0011726	1	0	2	2	5
OG0011727	1	0	1	3	5
OG0011728	1	1	1	2	5
OG0011729	1	1	2	1	5
OG0011730	1	1	1	2	5
OG0011731	1	1	2	1	5
OG0011732	1	1	1	2	5
OG0011733	1	1	2	1	5
OG0011734	1	1	1	2	5
OG0011735	1	1	2	1	5
OG0011736	1	0	4	0	5
OG0011737	1	1	2	1	5
OG0011738	2	1	1	1	5
OG0011739	1	1	2	1	5
OG0011740	1	2	1	1	5
OG0011741	1	1	2	1	5
OG0011742	1	1	1	2	5
OG0011743	1	1	2	1	5
OG0011744	1	1	1	2	5
OG0011745	1	1	2	1	5
OG0011746	2	1	1	1	5
OG0011747	1	1	1	2	5
OG0011748	1	1	1	2	5
OG0011749	1	1	1	2	5
OG0011750	1	1	2	1	5
OG0011751	1	1	2	1	5
OG0011752	1	1	2	1	5
OG0011753	1	1	1	2	5
OG0011754	1	0	3	1	5
OG0011755	1	1	2	1	5
OG0011756	1	1	2	1	5
OG0011757	1	1	2	1	5
OG0011758	1	1	1	2	5
OG0011759	1	1	1	2	5
OG0011760	1	1	1	2	5
OG0011761	1	1	1	2	5
OG0011762	1	1	1	2	5
OG0011763	1	1	2	1	5
OG0011764	1	1	1	2	5
OG0011765	2	1	1	1	5
OG0011766	1	1	2	1	5
OG0011767	2	1	1	1	5
OG0011768	1	1	2	1	5
OG0011769	1	1	1	2	5
OG0011770	1	1	1	2	5
OG0011771	1	1	0	3	5
OG0011772	1	1	1	2	5
OG0011773	1	1	2	1	5
OG0011774	1	1	2	1	5
OG0011775	1	1	1	2	5
OG0011776	1	1	1	2	5
OG0011777	1	1	1	2	5
OG0011778	1	1	1	2	5
OG0011779	2	1	1	1	5
OG0011780	1	1	2	1	5
OG0011781	1	1	2	1	5
OG0011782	1	1	2	1	5
OG0011783	1	1	1	2	5
OG0011784	1	1	2	1	5
OG0011785	1	1	1	2	5
OG0011786	1	1	1	2	5
OG0011787	1	1	1	2	5
OG0011788	2	1	1	1	5
OG0011789	1	1	1	2	5
OG0011790	1	1	1	2	5
OG0011791	1	1	1	2	5
OG0011792	1	1	1	2	5
OG0011793	1	1	1	2	5
OG0011794	1	0	2	2	5
OG0011795	1	1	1	2	5
OG0011796	1	1	1	2	5
OG0011797	1	1	1	2	5
OG0011798	1	1	2	1	5
OG0011799	2	1	1	1	5
OG0011800	1	1	1	2	5
OG0011801	1	1	2	1	5
OG0011802	2	1	1	1	5
OG0011803	2	1	1	1	5
OG0011804	1	1	2	1	5
OG0011805	1	1	2	1	5
OG0011806	1	1	1	2	5
OG0011807	1	1	1	2	5
OG0011808	1	1	1	2	5
OG0011809	1	1	1	2	5
OG0011810	2	1	1	1	5
OG0011811	1	1	1	2	5
OG0011812	1	1	1	2	5
OG0011813	1	1	1	2	5
OG0011814	2	1	1	1	5
OG0011815	1	1	1	2	5
OG0011816	1	2	1	1	5
OG0011817	1	1	1	2	5
OG0011818	1	1	1	2	5
OG0011819	1	1	1	2	5
OG0011820	2	1	1	1	5
OG0011821	1	1	1	2	5
OG0011822	1	2	1	1	5
OG0011823	1	1	2	1	5
OG0011824	2	1	1	1	5
OG0011825	1	1	1	2	5
OG0011826	1	1	1	2	5
OG0011827	1	1	2	1	5
OG0011828	1	1	2	1	5
OG0011829	2	1	1	1	5
OG0011830	1	1	2	1	5
OG0011831	2	1	1	1	5
OG0011832	1	1	1	2	5
OG0011833	2	2	0	1	5
OG0011834	1	1	2	1	5
OG0011835	2	3	0	0	5
OG0011836	1	1	1	2	5
OG0011837	2	3	0	0	5
OG0011838	1	1	1	2	5
OG0011839	1	1	1	2	5
OG0011840	1	1	2	1	5
OG0011841	1	1	1	2	5
OG0011842	1	3	1	0	5
OG0011843	1	1	2	1	5
OG0011844	1	1	1	2	5
OG0011845	3	0	1	1	5
OG0011846	1	1	1	2	5
OG0011847	2	1	1	1	5
OG0011848	1	1	2	1	5
OG0011849	1	2	1	1	5
OG0011850	3	2	0	0	5
OG0011851	1	1	2	1	5
OG0011852	2	1	1	1	5
OG0011853	1	1	2	1	5
OG0011854	1	1	2	1	5
OG0011855	1	1	2	1	5
OG0011856	1	1	1	2	5
OG0011857	2	0	1	2	5
OG0011858	1	1	1	2	5
OG0011859	2	1	1	1	5
OG0011860	1	1	1	2	5
OG0011861	2	1	1	1	5
OG0011862	2	1	1	1	5
OG0011863	1	1	1	2	5
OG0011864	1	1	2	1	5
OG0011865	1	1	1	2	5
OG0011866	1	1	1	2	5
OG0011867	1	1	2	1	5
OG0011868	1	1	1	2	5
OG0011869	1	1	1	2	5
OG0011870	2	1	1	1	5
OG0011871	1	1	1	2	5
OG0011872	3	2	0	0	5
OG0011873	1	1	1	2	5
OG0011874	1	1	2	1	5
OG0011875	1	1	2	1	5
OG0011876	1	1	2	1	5
OG0011877	2	1	1	1	5
OG0011878	3	2	0	0	5
OG0011879	4	1	0	0	5
OG0011880	1	1	1	2	5
OG0011881	1	4	0	0	5
OG0011882	1	1	2	1	5
OG0011883	1	2	1	1	5
OG0011884	1	1	1	2	5
OG0011885	1	1	2	1	5
OG0011886	2	1	1	1	5
OG0011887	1	1	1	2	5
OG0011888	1	1	1	2	5
OG0011889	2	1	1	1	5
OG0011890	1	1	1	2	5
OG0011891	2	1	1	1	5
OG0011892	1	0	2	2	5
OG0011893	2	1	1	1	5
OG0011894	3	1	0	1	5
OG0011895	1	1	1	2	5
OG0011896	1	1	2	1	5
OG0011897	1	1	2	1	5
OG0011898	2	1	1	1	5
OG0011899	1	4	0	0	5
OG0011900	1	2	1	1	5
OG0011901	1	1	2	1	5
OG0011902	1	1	2	1	5
OG0011903	1	1	2	1	5
OG0011904	1	1	3	0	5
OG0011905	1	2	1	1	5
OG0011906	2	1	2	0	5
OG0011907	1	1	1	2	5
OG0011908	2	1	1	1	5
OG0011909	1	1	1	2	5
OG0011910	1	1	1	2	5
OG0011911	1	1	2	1	5
OG0011912	1	1	1	2	5
OG0011913	1	1	2	1	5
OG0011914	1	1	1	2	5
OG0011915	1	1	2	1	5
OG0011916	1	1	1	2	5
OG0011917	3	1	1	0	5
OG0011918	1	1	2	1	5
OG0011919	1	1	1	2	5
OG0011920	1	2	1	1	5
OG0011921	1	1	2	1	5
OG0011922	2	1	1	1	5
OG0011923	1	1	2	1	5
OG0011924	1	2	1	1	5
OG0011925	1	1	1	2	5
OG0011926	1	1	2	1	5
OG0011927	1	1	2	1	5
OG0011928	2	1	1	1	5
OG0011929	1	2	1	1	5
OG0011930	1	1	2	1	5
OG0011931	1	1	2	1	5
OG0011932	1	1	2	1	5
OG0011933	1	1	2	1	5
OG0011934	2	1	1	1	5
OG0011935	1	2	1	1	5
OG0011936	1	1	2	1	5
OG0011937	1	1	2	1	5
OG0011938	1	1	2	1	5
OG0011939	2	1	1	1	5
OG0011940	1	1	2	1	5
OG0011941	1	1	1	2	5
OG0011942	1	0	1	3	5
OG0011943	1	1	1	2	5
OG0011944	3	2	0	0	5
OG0011945	1	1	1	2	5
OG0011946	1	0	2	2	5
OG0011947	1	1	1	2	5
OG0011948	2	1	1	1	5
OG0011949	2	1	1	1	5
OG0011950	1	1	1	2	5
OG0011951	1	1	2	1	5
OG0011952	1	1	1	2	5
OG0011953	2	1	1	1	5
OG0011954	1	1	2	1	5
OG0011955	1	1	2	1	5
OG0011956	1	1	1	2	5
OG0011957	1	1	2	1	5
OG0011958	1	1	1	2	5
OG0011959	1	1	1	2	5
OG0011960	2	1	1	1	5
OG0011961	1	1	1	2	5
OG0011962	2	1	1	1	5
OG0011963	1	1	1	2	5
OG0011964	1	1	2	1	5
OG0011965	2	2	0	1	5
OG0011966	1	1	2	1	5
OG0011967	1	2	1	1	5
OG0011968	1	1	2	1	5
OG0011969	1	1	2	1	5
OG0011970	1	0	2	2	5
OG0011971	1	1	2	1	5
OG0011972	1	1	1	2	5
OG0011973	1	1	2	1	5
OG0011974	1	1	1	2	5
OG0011975	1	1	2	1	5
OG0011976	1	1	2	1	5
OG0011977	1	1	1	2	5
OG0011978	1	1	1	2	5
OG0011979	2	1	1	1	5
OG0011980	1	1	2	1	5
OG0011981	2	1	1	1	5
OG0011982	1	1	1	2	5
OG0011983	1	1	1	2	5
OG0011984	1	1	1	2	5
OG0011985	1	1	2	1	5
OG0011986	1	1	1	2	5
OG0011987	1	1	2	1	5
OG0011988	2	1	1	1	5
OG0011989	1	1	2	1	5
OG0011990	1	2	1	1	5
OG0011991	1	2	1	1	5
OG0011992	1	4	0	0	5
OG0011993	1	1	2	1	5
OG0011994	1	1	2	1	5
OG0011995	2	3	0	0	5
OG0011996	1	1	1	2	5
OG0011997	1	2	0	2	5
OG0011998	1	1	1	2	5
OG0011999	1	1	1	2	5
OG0012000	1	1	1	2	5
OG0012001	1	1	1	2	5
OG0012002	1	1	1	2	5
OG0012003	1	1	2	1	5
OG0012004	2	1	1	1	5
OG0012005	2	1	1	1	5
OG0012006	1	1	2	1	5
OG0012007	1	1	1	2	5
OG0012008	1	1	2	1	5
OG0012009	2	1	1	1	5
OG0012010	1	1	2	1	5
OG0012011	1	1	1	2	5
OG0012012	1	0	1	3	5
OG0012013	1	1	1	2	5
OG0012014	1	1	1	2	5
OG0012015	1	0	2	2	5
OG0012016	1	1	1	2	5
OG0012017	1	1	1	2	5
OG0012018	2	1	1	1	5
OG0012019	2	1	1	1	5
OG0012020	1	1	2	1	5
OG0012021	1	1	2	1	5
OG0012022	1	1	1	2	5
OG0012023	1	1	2	1	5
OG0012024	1	1	1	2	5
OG0012025	2	1	1	1	5
OG0012026	1	1	1	2	5
OG0012027	2	0	1	2	5
OG0012028	1	4	0	0	5
OG0012029	1	1	2	1	5
OG0012030	1	1	1	2	5
OG0012031	2	2	1	0	5
OG0012032	1	1	2	1	5
OG0012033	1	1	1	2	5
OG0012034	1	1	1	2	5
OG0012035	1	0	4	0	5
OG0012036	1	1	2	1	5
OG0012037	1	1	2	1	5
OG0012038	1	1	1	2	5
OG0012039	2	1	1	1	5
OG0012040	2	2	0	1	5
OG0012041	2	1	1	1	5
OG0012042	1	0	2	2	5
OG0012043	1	1	2	1	5
OG0012044	1	1	2	1	5
OG0012045	1	0	4	0	5
OG0012046	1	1	1	2	5
OG0012047	1	1	1	2	5
OG0012048	1	0	3	1	5
OG0012049	1	1	2	1	5
OG0012050	1	1	1	2	5
OG0012051	1	1	2	1	5
OG0012052	2	1	1	1	5
OG0012053	1	1	2	1	5
OG0012054	1	1	1	2	5
OG0012055	1	1	1	2	5
OG0012056	1	1	1	2	5
OG0012057	1	1	2	1	5
OG0012058	1	1	1	2	5
OG0012059	1	1	1	2	5
OG0012060	2	1	1	1	5
OG0012061	1	0	1	3	5
OG0012062	2	1	1	1	5
OG0012063	2	1	1	1	5
OG0012064	1	1	1	2	5
OG0012065	1	1	1	2	5
OG0012066	1	1	2	1	5
OG0012067	1	1	1	2	5
OG0012068	2	1	1	1	5
OG0012069	1	1	1	2	5
OG0012070	1	1	1	2	5
OG0012071	1	1	1	2	5
OG0012072	1	2	1	1	5
OG0012073	2	1	1	1	5
OG0012074	3	1	0	1	5
OG0012075	1	1	1	2	5
OG0012076	1	1	1	2	5
OG0012077	1	1	1	2	5
OG0012078	1	1	2	1	5
OG0012079	1	0	2	2	5
OG0012080	1	1	2	1	5
OG0012081	1	1	2	1	5
OG0012082	1	1	2	1	5
OG0012083	1	1	1	2	5
OG0012084	1	1	1	2	5
OG0012085	1	1	1	2	5
OG0012086	1	1	1	2	5
OG0012087	1	1	2	1	5
OG0012088	1	1	2	1	5
OG0012089	1	1	2	1	5
OG0012090	4	1	0	0	5
OG0012091	1	1	2	1	5
OG0012092	2	1	2	0	5
OG0012093	1	1	1	2	5
OG0012094	1	1	1	2	5
OG0012095	1	1	1	2	5
OG0012096	1	1	2	1	5
OG0012097	2	1	1	1	5
OG0012098	1	1	1	2	5
OG0012099	2	1	1	1	5
OG0012100	1	1	2	1	5
OG0012101	1	1	2	1	5
OG0012102	1	0	2	2	5
OG0012103	1	1	1	2	5
OG0012104	1	1	2	1	5
OG0012105	1	1	2	1	5
OG0012106	1	1	1	2	5
OG0012107	1	1	1	2	5
OG0012108	1	1	2	1	5
OG0012109	1	1	1	2	5
OG0012110	1	1	2	1	5
OG0012111	1	1	2	1	5
OG0012112	1	1	2	1	5
OG0012113	1	0	2	2	5
OG0012114	1	1	1	2	5
OG0012115	2	1	1	1	5
OG0012116	1	1	2	1	5
OG0012117	1	1	1	2	5
OG0012118	1	1	1	2	5
OG0012119	1	1	2	1	5
OG0012120	1	1	1	2	5
OG0012121	1	1	1	2	5
OG0012122	1	1	2	1	5
OG0012123	1	1	1	2	5
OG0012124	1	2	1	1	5
OG0012125	1	2	1	1	5
OG0012126	1	1	2	1	5
OG0012127	1	1	2	1	5
OG0012128	1	1	2	1	5
OG0012129	1	1	0	3	5
OG0012130	1	1	1	2	5
OG0012131	1	1	1	2	5
OG0012132	1	1	1	2	5
OG0012133	1	1	1	2	5
OG0012134	1	1	2	1	5
OG0012135	1	1	1	2	5
OG0012136	1	1	2	1	5
OG0012137	1	1	2	1	5
OG0012138	1	1	2	1	5
OG0012139	1	1	1	2	5
OG0012140	1	1	1	2	5
OG0012141	1	1	2	1	5
OG0012142	1	1	2	1	5
OG0012143	1	1	1	2	5
OG0012144	1	2	1	1	5
OG0012145	1	1	2	1	5
OG0012146	2	1	1	1	5
OG0012147	3	1	1	0	5
OG0012148	1	1	1	2	5
OG0012149	1	1	1	2	5
OG0012150	1	1	1	2	5
OG0012151	2	1	1	1	5
OG0012152	1	1	2	1	5
OG0012153	1	0	1	3	5
OG0012154	1	1	2	1	5
OG0012155	1	1	1	2	5
OG0012156	2	1	1	1	5
OG0012157	1	1	2	1	5
OG0012158	1	1	2	1	5
OG0012159	1	2	1	1	5
OG0012160	1	1	2	1	5
OG0012161	1	3	0	1	5
OG0012162	2	1	1	1	5
OG0012163	1	1	2	1	5
OG0012164	2	1	1	1	5
OG0012165	1	1	2	1	5
OG0012166	3	1	0	1	5
OG0012167	1	1	1	2	5
OG0012168	1	1	1	2	5
OG0012169	1	1	2	1	5
OG0012170	2	1	1	1	5
OG0012171	1	1	2	1	5
OG0012172	2	1	1	1	5
OG0012173	1	1	2	1	5
OG0012174	1	1	2	1	5
OG0012175	1	1	2	1	5
OG0012176	1	1	2	1	5
OG0012177	1	1	1	2	5
OG0012178	1	1	2	1	5
OG0012179	1	2	1	1	5
OG0012180	1	0	1	3	5
OG0012181	1	1	2	1	5
OG0012182	1	1	2	1	5
OG0012183	1	2	1	1	5
OG0012184	1	1	2	1	5
OG0012185	1	1	1	2	5
OG0012186	1	1	2	1	5
OG0012187	1	1	1	2	5
OG0012188	1	1	1	2	5
OG0012189	1	1	1	2	5
OG0012190	1	1	1	2	5
OG0012191	1	1	1	2	5
OG0012192	1	1	1	2	5
OG0012193	1	1	1	2	5
OG0012194	1	1	1	2	5
OG0012195	1	1	2	1	5
OG0012196	1	1	2	1	5
OG0012197	1	1	1	2	5
OG0012198	2	1	1	1	5
OG0012199	1	1	2	1	5
OG0012200	1	1	2	1	5
OG0012201	1	0	2	2	5
OG0012202	1	1	2	1	5
OG0012203	1	1	2	1	5
OG0012204	1	2	1	1	5
OG0012205	1	1	2	1	5
OG0012206	2	1	1	1	5
OG0012207	1	1	1	2	5
OG0012208	1	1	2	1	5
OG0012209	1	1	2	1	5
OG0012210	1	1	1	2	5
OG0012211	2	1	1	1	5
OG0012212	2	0	2	1	5
OG0012213	1	0	3	1	5
OG0012214	1	1	1	2	5
OG0012215	1	0	2	2	5
OG0012216	1	1	1	2	5
OG0012217	1	1	1	2	5
OG0012218	1	1	1	2	5
OG0012219	1	2	1	1	5
OG0012220	1	1	1	2	5
OG0012221	2	1	1	1	5
OG0012222	2	0	1	2	5
OG0012223	2	1	1	1	5
OG0012224	1	1	1	2	5
OG0012225	1	1	2	1	5
OG0012226	2	1	1	1	5
OG0012227	1	1	1	2	5
OG0012228	1	1	2	1	5
OG0012229	1	1	2	1	5
OG0012230	2	1	1	1	5
OG0012231	1	1	1	2	5
OG0012232	2	1	1	1	5
OG0012233	1	1	2	1	5
OG0012234	1	4	0	0	5
OG0012235	1	1	1	2	5
OG0012236	1	1	1	2	5
OG0012237	1	1	2	1	5
OG0012238	1	1	2	1	5
OG0012239	1	1	1	2	5
OG0012240	1	1	1	2	5
OG0012241	1	1	1	2	5
OG0012242	1	1	2	1	5
OG0012243	1	1	1	2	5
OG0012244	2	1	1	1	5
OG0012245	2	1	1	1	5
OG0012246	1	1	2	1	5
OG0012247	1	0	1	3	5
OG0012248	1	1	1	2	5
OG0012249	1	1	1	2	5
OG0012250	1	1	1	2	5
OG0012251	1	1	1	2	5
OG0012252	1	1	2	1	5
OG0012253	1	1	1	2	5
OG0012254	1	1	1	2	5
OG0012255	1	1	1	2	5
OG0012256	1	2	1	1	5
OG0012257	1	1	2	1	5
OG0012258	1	1	1	2	5
OG0012259	2	1	1	1	5
OG0012260	1	2	1	1	5
OG0012261	1	1	1	2	5
OG0012262	1	1	1	2	5
OG0012263	1	4	0	0	5
OG0012264	1	1	2	1	5
OG0012265	1	3	1	0	5
OG0012266	1	1	2	1	5
OG0012267	1	0	3	1	5
OG0012268	1	2	1	1	5
OG0012269	1	1	2	1	5
OG0012270	2	1	1	1	5
OG0012271	1	1	1	2	5
OG0012272	1	1	1	2	5
OG0012273	1	4	0	0	5
OG0012274	1	1	1	2	5
OG0012275	2	1	1	1	5
OG0012276	1	1	2	1	5
OG0012277	1	1	2	1	5
OG0012278	2	1	0	2	5
OG0012279	1	1	2	1	5
OG0012280	1	1	2	1	5
OG0012281	1	1	1	2	5
OG0012282	1	1	2	1	5
OG0012283	1	1	2	1	5
OG0012284	1	1	1	2	5
OG0012285	1	1	1	2	5
OG0012286	1	1	2	1	5
OG0012287	2	1	1	1	5
OG0012288	1	2	1	1	5
OG0012289	1	4	0	0	5
OG0012290	1	1	1	2	5
OG0012291	2	0	2	1	5
OG0012292	1	0	1	3	5
OG0012293	1	1	2	1	5
OG0012294	2	1	1	1	5
OG0012295	1	1	2	1	5
OG0012296	1	1	2	1	5
OG0012297	2	1	1	1	5
OG0012298	2	1	1	1	5
OG0012299	1	1	1	2	5
OG0012300	1	1	2	1	5
OG0012301	1	1	2	1	5
OG0012302	1	2	1	1	5
OG0012303	1	1	1	2	5
OG0012304	2	1	1	1	5
OG0012305	1	1	1	2	5
OG0012306	4	0	1	0	5
OG0012307	2	0	3	0	5
OG0012308	1	2	1	1	5
OG0012309	1	1	2	1	5
OG0012310	2	1	1	1	5
OG0012311	1	4	0	0	5
OG0012312	1	2	1	1	5
OG0012313	1	1	1	2	5
OG0012314	1	2	1	1	5
OG0012315	1	2	1	1	5
OG0012316	1	1	1	2	5
OG0012317	1	0	3	1	5
OG0012318	1	1	1	2	5
OG0012319	2	1	1	1	5
OG0012320	1	0	2	2	5
OG0012321	1	1	2	1	5
OG0012322	1	1	1	2	5
OG0012323	1	1	2	1	5
OG0012324	1	1	2	1	5
OG0012325	1	1	1	2	5
OG0012326	1	1	1	2	5
OG0012327	1	1	1	2	5
OG0012328	1	1	2	1	5
OG0012329	1	1	2	1	5
OG0012330	1	1	2	1	5
OG0012331	1	1	2	1	5
OG0012332	1	1	1	2	5
OG0012333	1	2	1	1	5
OG0012334	1	1	1	2	5
OG0012335	1	1	0	3	5
OG0012336	1	1	1	2	5
OG0012337	1	1	1	2	5
OG0012338	1	1	1	2	5
OG0012339	1	1	1	2	5
OG0012340	1	1	1	2	5
OG0012341	1	1	2	1	5
OG0012342	1	1	2	1	5
OG0012343	1	1	2	1	5
OG0012344	1	1	0	3	5
OG0012345	1	1	2	1	5
OG0012346	1	1	2	1	5
OG0012347	1	1	2	1	5
OG0012348	2	1	1	1	5
OG0012349	1	2	1	1	5
OG0012350	1	1	2	1	5
OG0012351	1	1	2	1	5
OG0012352	1	1	2	1	5
OG0012353	1	1	2	1	5
OG0012354	2	1	1	1	5
OG0012355	1	1	2	1	5
OG0012356	1	2	1	1	5
OG0012357	1	1	2	1	5
OG0012358	1	1	2	1	5
OG0012359	1	1	1	2	5
OG0012360	1	1	2	1	5
OG0012361	1	1	1	2	5
OG0012362	1	1	1	2	5
OG0012363	2	1	1	1	5
OG0012364	1	1	2	1	5
OG0012365	1	1	1	2	5
OG0012366	1	0	1	3	5
OG0012367	3	2	0	0	5
OG0012368	1	2	1	1	5
OG0012369	1	1	1	2	5
OG0012370	1	1	1	2	5
OG0012371	1	1	1	2	5
OG0012372	1	2	1	1	5
OG0012373	2	0	2	1	5
OG0012374	1	1	1	2	5
OG0012375	1	1	2	1	5
OG0012376	1	2	1	1	5
OG0012377	1	1	2	1	5
OG0012378	2	1	1	1	5
OG0012379	1	0	2	2	5
OG0012380	1	1	2	1	5
OG0012381	1	1	2	1	5
OG0012382	1	1	1	2	5
OG0012383	1	1	1	2	5
OG0012384	1	1	1	2	5
OG0012385	1	1	2	1	5
OG0012386	1	1	2	1	5
OG0012387	1	1	1	2	5
OG0012388	1	1	1	2	5
OG0012389	1	1	2	1	5
OG0012390	1	2	1	1	5
OG0012391	1	4	0	0	5
OG0012392	1	1	2	1	5
OG0012393	1	1	2	1	5
OG0012394	1	1	2	1	5
OG0012395	1	1	2	1	5
OG0012396	1	1	1	2	5
OG0012397	1	2	1	1	5
OG0012398	2	1	1	1	5
OG0012399	1	1	1	2	5
OG0012400	1	1	1	2	5
OG0012401	1	1	1	2	5
OG0012402	2	1	1	1	5
OG0012403	1	1	2	1	5
OG0012404	1	1	1	2	5
OG0012405	1	1	1	2	5
OG0012406	2	1	1	1	5
OG0012407	1	1	1	2	5
OG0012408	1	1	1	2	5
OG0012409	1	1	2	1	5
OG0012410	1	1	1	2	5
OG0012411	1	1	2	1	5
OG0012412	2	1	1	1	5
OG0012413	1	1	2	1	5
OG0012414	2	1	1	1	5
OG0012415	2	1	1	1	5
OG0012416	1	1	1	2	5
OG0012417	1	1	1	2	5
OG0012418	2	1	1	1	5
OG0012419	1	1	2	1	5
OG0012420	1	1	1	2	5
OG0012421	1	1	1	2	5
OG0012422	2	1	1	1	5
OG0012423	1	1	2	1	5
OG0012424	1	1	1	2	5
OG0012425	1	1	1	2	5
OG0012426	1	1	1	2	5
OG0012427	1	1	1	2	5
OG0012428	2	1	1	1	5
OG0012429	2	1	1	1	5
OG0012430	1	1	2	1	5
OG0012431	1	0	1	3	5
OG0012432	1	1	1	2	5
OG0012433	1	1	1	2	5
OG0012434	1	1	2	1	5
OG0012435	1	1	1	2	5
OG0012436	1	1	2	1	5
OG0012437	1	2	1	1	5
OG0012438	1	1	1	2	5
OG0012439	1	2	1	1	5
OG0012440	1	1	1	2	5
OG0012441	1	1	2	1	5
OG0012442	1	1	1	2	5
OG0012443	1	0	3	1	5
OG0012444	1	1	2	1	5
OG0012445	1	1	1	2	5
OG0012446	1	1	1	2	5
OG0012447	1	1	2	1	5
OG0012448	1	1	2	1	5
OG0012449	1	1	1	2	5
OG0012450	1	0	2	2	5
OG0012451	1	0	1	3	5
OG0012452	1	1	1	2	5
OG0012453	2	1	1	1	5
OG0012454	1	1	2	1	5
OG0012455	1	1	1	2	5
OG0012456	1	1	2	1	5
OG0012457	2	1	1	1	5
OG0012458	1	1	1	2	5
OG0012459	1	1	2	1	5
OG0012460	2	1	1	1	5
OG0012461	1	1	2	1	5
OG0012462	1	1	2	1	5
OG0012463	2	1	1	1	5
OG0012464	2	1	1	1	5
OG0012465	1	1	2	1	5
OG0012466	2	1	1	1	5
OG0012467	1	1	1	2	5
OG0012468	1	1	1	2	5
OG0012469	1	1	2	1	5
OG0012470	1	1	1	2	5
OG0012471	1	2	1	1	5
OG0012472	1	1	1	2	5
OG0012473	1	1	2	1	5
OG0012474	1	1	1	2	5
OG0012475	1	1	2	1	5
OG0012476	1	1	1	2	5
OG0012477	1	1	1	2	5
OG0012478	2	1	1	1	5
OG0012479	2	1	1	1	5
OG0012480	1	1	1	2	5
OG0012481	1	1	2	1	5
OG0012482	1	1	2	1	5
OG0012483	1	1	2	1	5
OG0012484	1	1	1	2	5
OG0012485	1	1	2	1	5
OG0012486	1	1	2	1	5
OG0012487	1	1	2	1	5
OG0012488	1	1	2	1	5
OG0012489	1	1	2	1	5
OG0012490	1	1	1	2	5
OG0012491	1	1	2	1	5
OG0012492	1	2	1	1	5
OG0012493	1	1	1	2	5
OG0012494	2	1	1	1	5
OG0012495	1	1	2	1	5
OG0012496	1	1	1	2	5
OG0012497	2	0	1	2	5
OG0012498	1	1	2	1	5
OG0012499	2	1	1	1	5
OG0012500	1	1	0	3	5
OG0012501	2	1	0	2	5
OG0012502	1	1	2	1	5
OG0012503	1	1	1	2	5
OG0012504	1	1	1	2	5
OG0012505	2	1	1	1	5
OG0012506	1	1	1	2	5
OG0012507	1	1	2	1	5
OG0012508	2	1	1	1	5
OG0012509	1	1	1	2	5
OG0012510	1	1	1	2	5
OG0012511	1	1	2	1	5
OG0012512	2	1	1	1	5
OG0012513	1	1	1	2	5
OG0012514	1	1	2	1	5
OG0012515	1	1	2	1	5
OG0012516	1	1	2	1	5
OG0012517	1	1	2	1	5
OG0012518	1	1	1	2	5
OG0012519	1	1	1	2	5
OG0012520	1	1	2	1	5
OG0012521	1	1	1	2	5
OG0012522	1	1	1	2	5
OG0012523	1	1	1	2	5
OG0012524	1	4	0	0	5
OG0012525	1	2	1	1	5
OG0012526	2	1	1	1	5
OG0012527	1	4	0	0	5
OG0012528	1	1	2	1	5
OG0012529	1	1	1	2	5
OG0012530	1	1	2	1	5
OG0012531	2	1	1	1	5
OG0012532	1	1	1	2	5
OG0012533	1	1	3	0	5
OG0012534	1	1	2	1	5
OG0012535	1	4	0	0	5
OG0012536	1	1	1	2	5
OG0012537	1	1	1	2	5
OG0012538	1	1	1	2	5
OG0012539	1	1	2	1	5
OG0012540	1	2	1	1	5
OG0012541	1	1	2	1	5
OG0012542	1	1	2	1	5
OG0012543	2	1	1	1	5
OG0012544	1	1	1	2	5
OG0012545	1	1	2	1	5
OG0012546	1	1	2	1	5
OG0012547	1	1	1	2	5
OG0012548	1	0	3	1	5
OG0012549	1	1	1	2	5
OG0012550	1	1	1	2	5
OG0012551	1	2	1	1	5
OG0012552	1	1	2	1	5
OG0012553	1	1	2	1	5
OG0012554	1	1	2	1	5
OG0012555	5	0	0	0	5
OG0012556	1	1	2	1	5
OG0012557	1	1	2	1	5
OG0012558	1	1	2	1	5
OG0012559	1	1	2	1	5
OG0012560	1	1	1	2	5
OG0012561	1	1	2	1	5
OG0012562	1	4	0	0	5
OG0012563	1	1	2	1	5
OG0012564	1	1	2	1	5
OG0012565	2	1	1	1	5
OG0012566	1	1	2	1	5
OG0012567	5	0	0	0	5
OG0012568	1	1	1	2	5
OG0012569	1	1	2	1	5
OG0012570	3	1	0	1	5
OG0012571	2	1	1	1	5
OG0012572	2	1	1	1	5
OG0012573	1	1	2	1	5
OG0012574	2	1	1	1	5
OG0012575	1	1	2	1	5
OG0012576	1	1	2	1	5
OG0012577	2	1	1	1	5
OG0012578	1	1	1	2	5
OG0012579	1	1	1	2	5
OG0012580	1	1	2	1	5
OG0012581	1	1	2	1	5
OG0012582	1	1	1	2	5
OG0012583	1	2	1	1	5
OG0012584	1	1	2	1	5
OG0012585	3	2	0	0	5
OG0012586	2	1	1	1	5
OG0012587	2	1	1	1	5
OG0012588	1	1	1	2	5
OG0012589	2	0	1	2	5
OG0012590	1	1	1	2	5
OG0012591	1	0	3	1	5
OG0012592	2	1	1	1	5
OG0012593	0	5	0	0	5
OG0012594	0	5	0	0	5
OG0012595	0	5	0	0	5
OG0012596	0	5	0	0	5
OG0012597	0	5	0	0	5
OG0012598	0	5	0	0	5
OG0012599	0	5	0	0	5
OG0012600	0	5	0	0	5
OG0012601	0	5	0	0	5
OG0012602	0	5	0	0	5
OG0012603	0	5	0	0	5
OG0012604	0	5	0	0	5
OG0012605	0	5	0	0	5
OG0012606	0	5	0	0	5
OG0012607	0	5	0	0	5
OG0012608	0	5	0	0	5
OG0012609	0	5	0	0	5
OG0012610	0	5	0	0	5
OG0012611	0	5	0	0	5
OG0012612	0	5	0	0	5
OG0012613	0	5	0	0	5
OG0012614	0	5	0	0	5
OG0012615	0	3	1	1	5
OG0012616	0	5	0	0	5
OG0012617	0	5	0	0	5
OG0012618	0	5	0	0	5
OG0012619	0	5	0	0	5
OG0012620	0	5	0	0	5
OG0012621	0	4	1	0	5
OG0012622	0	5	0	0	5
OG0012623	0	5	0	0	5
OG0012624	0	3	1	1	5
OG0012625	0	3	0	2	5
OG0012626	0	5	0	0	5
OG0012627	0	5	0	0	5
OG0012628	0	5	0	0	5
OG0012629	0	1	2	2	5
OG0012630	0	5	0	0	5
OG0012631	0	5	0	0	5
OG0012632	0	1	2	2	5
OG0012633	0	1	2	2	5
OG0012634	0	1	3	1	5
OG0012635	0	5	0	0	5
OG0012636	0	5	0	0	5
OG0012637	0	5	0	0	5
OG0012638	0	1	2	2	5
OG0012639	0	4	0	1	5
OG0012640	0	5	0	0	5
OG0012641	0	3	1	1	5
OG0012642	0	5	0	0	5
OG0012643	0	5	0	0	5
OG0012644	0	5	0	0	5
OG0012645	0	5	0	0	5
OG0012646	0	5	0	0	5
OG0012647	0	5	0	0	5
OG0012648	0	5	0	0	5
OG0012649	0	5	0	0	5
OG0012650	0	1	1	3	5
OG0012651	0	1	2	2	5
OG0012652	0	5	0	0	5
OG0012653	0	5	0	0	5
OG0012654	0	5	0	0	5
OG0012655	0	5	0	0	5
OG0012656	0	5	0	0	5
OG0012657	0	5	0	0	5
OG0012658	0	5	0	0	5
OG0012659	0	5	0	0	5
OG0012660	0	5	0	0	5
OG0012661	0	5	0	0	5
OG0012662	0	5	0	0	5
OG0012663	0	5	0	0	5
OG0012664	0	5	0	0	5
OG0012665	0	5	0	0	5
OG0012666	0	1	3	1	5
OG0012667	0	5	0	0	5
OG0012668	0	5	0	0	5
OG0012669	0	5	0	0	5
OG0012670	0	5	0	0	5
OG0012671	0	1	4	0	5
OG0012672	0	5	0	0	5
OG0012673	0	5	0	0	5
OG0012674	0	5	0	0	5
OG0012675	0	5	0	0	5
OG0012676	0	5	0	0	5
OG0012677	0	5	0	0	5
OG0012678	0	5	0	0	5
OG0012679	0	5	0	0	5
OG0012680	0	1	2	2	5
OG0012681	0	5	0	0	5
OG0012682	0	5	0	0	5
OG0012683	0	3	0	2	5
OG0012684	0	5	0	0	5
OG0012685	0	2	1	2	5
OG0012686	0	5	0	0	5
OG0012687	0	5	0	0	5
OG0012688	0	5	0	0	5
OG0012689	0	5	0	0	5
OG0012690	0	3	0	2	5
OG0012691	0	5	0	0	5
OG0012692	0	3	1	1	5
OG0012693	0	5	0	0	5
OG0012694	0	5	0	0	5
OG0012695	0	5	0	0	5
OG0012696	0	5	0	0	5
OG0012697	0	1	1	3	5
OG0012698	0	2	0	3	5
OG0012699	0	4	0	1	5
OG0012700	0	5	0	0	5
OG0012701	0	5	0	0	5
OG0012702	0	1	1	3	5
OG0012703	0	1	2	2	5
OG0012704	0	5	0	0	5
OG0012705	0	1	1	3	5
OG0012706	0	5	0	0	5
OG0012707	0	1	1	3	5
OG0012708	0	5	0	0	5
OG0012709	0	5	0	0	5
OG0012710	0	1	2	2	5
OG0012711	0	5	0	0	5
OG0012712	0	5	0	0	5
OG0012713	0	5	0	0	5
OG0012714	0	2	2	1	5
OG0012715	0	5	0	0	5
OG0012716	0	5	0	0	5
OG0012717	0	5	0	0	5
OG0012718	0	5	0	0	5
OG0012719	0	5	0	0	5
OG0012720	0	5	0	0	5
OG0012721	0	5	0	0	5
OG0012722	0	3	1	1	5
OG0012723	0	5	0	0	5
OG0012724	0	5	0	0	5
OG0012725	0	5	0	0	5
OG0012726	0	5	0	0	5
OG0012727	0	2	1	2	5
OG0012728	0	5	0	0	5
OG0012729	0	5	0	0	5
OG0012730	0	5	0	0	5
OG0012731	0	5	0	0	5
OG0012732	0	1	1	3	5
OG0012733	0	1	2	2	5
OG0012734	0	5	0	0	5
OG0012735	0	5	0	0	5
OG0012736	0	1	4	0	5
OG0012737	0	5	0	0	5
OG0012738	0	1	2	2	5
OG0012739	0	1	1	3	5
OG0012740	0	1	2	2	5
OG0012741	0	5	0	0	5
OG0012742	0	5	0	0	5
OG0012743	0	2	1	2	5
OG0012744	0	5	0	0	5
OG0012745	0	1	0	4	5
OG0012746	0	1	1	3	5
OG0012747	0	5	0	0	5
OG0012748	0	1	2	2	5
OG0012749	0	1	2	2	5
OG0012750	0	1	2	2	5
OG0012751	0	5	0	0	5
OG0012752	0	1	2	2	5
OG0012753	0	5	0	0	5
OG0012754	0	1	4	0	5
OG0012755	0	5	0	0	5
OG0012756	0	1	3	1	5
OG0012757	0	5	0	0	5
OG0012758	0	5	0	0	5
OG0012759	0	5	0	0	5
OG0012760	0	5	0	0	5
OG0012761	0	5	0	0	5
OG0012762	0	5	0	0	5
OG0012763	0	3	2	0	5
OG0012764	0	1	1	3	5
OG0012765	0	1	3	1	5
OG0012766	0	5	0	0	5
OG0012767	0	2	2	1	5
OG0012768	0	1	1	3	5
OG0012769	0	5	0	0	5
OG0012770	0	1	2	2	5
OG0012771	0	1	2	2	5
OG0012772	0	2	3	0	5
OG0012773	0	5	0	0	5
OG0012774	0	2	2	1	5
OG0012775	0	1	1	3	5
OG0012776	0	3	1	1	5
OG0012777	0	1	2	2	5
OG0012778	0	1	1	3	5
OG0012779	0	1	1	3	5
OG0012780	0	2	2	1	5
OG0012781	0	1	2	2	5
OG0012782	0	2	0	3	5
OG0012783	0	3	1	1	5
OG0012784	0	1	2	2	5
OG0012785	0	1	1	3	5
OG0012786	0	1	2	2	5
OG0012787	0	5	0	0	5
OG0012788	0	5	0	0	5
OG0012789	0	5	0	0	5
OG0012790	0	4	1	0	5
OG0012791	0	1	3	1	5
OG0012792	0	1	2	2	5
OG0012793	0	1	3	1	5
OG0012794	0	2	1	2	5
OG0012795	0	2	2	1	5
OG0012796	0	1	2	2	5
OG0012797	0	1	2	2	5
OG0012798	0	1	2	2	5
OG0012799	0	1	3	1	5
OG0012800	0	1	1	3	5
OG0012801	0	1	4	0	5
OG0012802	0	5	0	0	5
OG0012803	0	1	3	1	5
OG0012804	0	1	0	4	5
OG0012805	0	5	0	0	5
OG0012806	0	1	2	2	5
OG0012807	0	1	3	1	5
OG0012808	0	1	1	3	5
OG0012809	0	1	1	3	5
OG0012810	0	1	1	3	5
OG0012811	0	3	1	1	5
OG0012812	0	1	2	2	5
OG0012813	0	1	1	3	5
OG0012814	0	1	3	1	5
OG0012815	0	5	0	0	5
OG0012816	0	1	1	3	5
OG0012817	0	0	3	2	5
OG0012818	0	0	4	1	5
OG0012819	0	0	3	2	5
OG0012820	0	0	4	1	5
OG0012821	0	0	5	0	5
OG0012822	0	0	5	0	5
OG0012823	0	0	3	2	5
OG0012824	0	0	2	3	5
OG0012825	0	0	5	0	5
OG0012826	0	0	2	3	5
OG0012827	0	0	4	1	5
OG0012828	0	0	1	4	5
OG0012829	0	0	4	1	5
OG0012830	0	0	2	3	5
OG0012831	0	0	2	3	5
OG0012832	0	0	3	2	5
OG0012833	0	0	4	1	5
OG0012834	0	0	2	3	5
OG0012835	0	0	4	1	5
OG0012836	0	0	3	2	5
OG0012837	0	0	2	3	5
OG0012838	0	0	4	1	5
OG0012839	0	0	1	4	5
OG0012840	0	0	2	3	5
OG0012841	0	0	4	1	5
OG0012842	0	0	1	4	5
OG0012843	0	0	5	0	5
OG0012844	0	0	2	3	5
OG0012845	0	0	3	2	5
OG0012846	0	0	2	3	5
OG0012847	0	0	5	0	5
OG0012848	0	0	2	3	5
OG0012849	0	0	3	2	5
OG0012850	0	0	3	2	5
OG0012851	0	0	3	2	5
OG0012852	0	0	4	1	5
OG0012853	0	0	2	3	5
OG0012854	0	0	1	4	5
OG0012855	0	0	4	1	5
OG0012856	0	0	1	4	5
OG0012857	0	0	5	0	5
OG0012858	0	0	3	2	5
OG0012859	0	0	3	2	5
OG0012860	0	0	5	0	5
OG0012861	0	0	1	4	5
OG0012862	0	0	2	3	5
OG0012863	0	0	2	3	5
OG0012864	0	0	2	3	5
OG0012865	0	0	1	4	5
OG0012866	0	0	2	3	5
OG0012867	0	0	4	1	5
OG0012868	0	0	3	2	5
OG0012869	0	0	2	3	5
OG0012870	0	0	2	3	5
OG0012871	0	0	5	0	5
OG0012872	0	0	1	4	5
OG0012873	0	0	1	4	5
OG0012874	0	0	4	1	5
OG0012875	0	0	2	3	5
OG0012876	0	0	1	4	5
OG0012877	0	0	5	0	5
OG0012878	0	0	5	0	5
OG0012879	0	0	5	0	5
OG0012880	0	0	1	4	5
OG0012881	0	0	2	3	5
OG0012882	0	0	1	4	5
OG0012883	0	0	3	2	5
OG0012884	0	0	4	1	5
OG0012885	0	0	5	0	5
OG0012886	0	0	3	2	5
OG0012887	0	0	5	0	5
OG0012888	0	0	4	1	5
OG0012889	0	0	3	2	5
OG0012890	0	0	5	0	5
OG0012891	0	0	1	4	5
OG0012892	0	0	1	4	5
OG0012893	0	0	4	1	5
OG0012894	0	0	5	0	5
OG0012895	0	0	4	1	5
OG0012896	0	0	3	2	5
OG0012897	0	0	3	2	5
OG0012898	0	0	2	3	5
OG0012899	0	0	2	3	5
OG0012900	0	0	3	2	5
OG0012901	0	0	2	3	5
OG0012902	0	0	2	3	5
OG0012903	0	0	2	3	5
OG0012904	0	0	1	4	5
OG0012905	0	0	4	1	5
OG0012906	0	0	1	4	5
OG0012907	0	0	4	1	5
OG0012908	0	0	1	4	5
OG0012909	0	0	1	4	5
OG0012910	0	0	2	3	5
OG0012911	0	0	3	2	5
OG0012912	0	0	2	3	5
OG0012913	0	0	3	2	5
OG0012914	0	0	1	4	5
OG0012915	0	0	1	4	5
OG0012916	0	0	4	1	5
OG0012917	0	0	5	0	5
OG0012918	0	0	3	2	5
OG0012919	0	0	1	4	5
OG0012920	0	0	3	2	5
OG0012921	0	0	2	3	5
OG0012922	0	0	3	2	5
OG0012923	0	0	2	3	5
OG0012924	0	0	1	4	5
OG0012925	0	0	3	2	5
OG0012926	0	0	3	2	5
OG0012927	0	0	2	3	5
OG0012928	0	0	2	3	5
OG0012929	0	0	5	0	5
OG0012930	0	0	3	2	5
OG0012931	0	0	4	1	5
OG0012932	0	0	1	4	5
OG0012933	0	0	1	4	5
OG0012934	0	0	4	1	5
OG0012935	0	0	2	3	5
OG0012936	0	0	1	4	5
OG0012937	0	0	4	1	5
OG0012938	0	0	4	1	5
OG0012939	0	0	2	3	5
OG0012940	0	0	2	3	5
OG0012941	0	0	4	1	5
OG0012942	0	0	2	3	5
OG0012943	0	0	1	4	5
OG0012944	0	0	2	3	5
OG0012945	0	0	3	2	5
OG0012946	0	0	4	1	5
OG0012947	0	0	2	3	5
OG0012948	0	0	1	4	5
OG0012949	0	0	5	0	5
OG0012950	0	0	4	1	5
OG0012951	0	0	3	2	5
OG0012952	0	0	5	0	5
OG0012953	0	0	2	3	5
OG0012954	0	0	3	2	5
OG0012955	0	0	3	2	5
OG0012956	0	0	4	1	5
OG0012957	0	0	5	0	5
OG0012958	0	0	0	5	5
OG0012959	0	0	0	5	5
OG0012960	0	0	0	5	5
OG0012961	0	0	0	5	5
OG0012962	0	0	0	5	5
OG0012963	0	0	0	5	5
OG0012964	0	0	0	5	5
OG0012965	0	0	0	5	5
OG0012966	0	0	0	5	5
OG0012967	0	0	0	5	5
OG0012968	0	0	0	5	5
OG0012969	0	0	0	5	5
OG0012970	0	0	0	5	5
OG0012971	0	0	0	5	5
OG0012972	0	0	0	5	5
OG0012973	0	0	0	5	5
OG0012974	0	0	0	5	5
OG0012975	0	0	0	5	5
OG0012976	0	0	0	5	5
OG0012977	0	0	0	5	5
OG0012978	0	0	0	5	5
OG0012979	0	0	0	5	5
OG0012980	0	0	0	5	5
OG0012981	0	0	0	5	5
OG0012982	0	0	0	5	5
OG0012983	0	0	0	5	5
OG0012984	0	0	0	5	5
OG0012985	0	0	0	5	5
OG0012986	0	0	0	5	5
OG0012987	0	0	0	5	5
OG0012988	0	0	0	5	5
OG0012989	0	0	0	5	5
OG0012990	0	0	0	5	5
OG0012991	1	1	1	1	4
OG0012992	1	1	1	1	4
OG0012993	3	1	0	0	4
OG0012994	3	1	0	0	4
OG0012995	1	1	1	1	4
OG0012996	1	1	1	1	4
OG0012997	1	1	1	1	4
OG0012998	1	1	1	1	4
OG0012999	3	1	0	0	4
OG0013000	1	1	1	1	4
OG0013001	4	0	0	0	4
OG0013002	1	1	1	1	4
OG0013003	3	1	0	0	4
OG0013004	1	1	1	1	4
OG0013005	1	1	1	1	4
OG0013006	1	1	1	1	4
OG0013007	1	1	1	1	4
OG0013008	1	1	1	1	4
OG0013009	1	1	1	1	4
OG0013010	1	1	1	1	4
OG0013011	1	1	1	1	4
OG0013012	1	1	1	1	4
OG0013013	1	1	1	1	4
OG0013014	1	1	1	1	4
OG0013015	1	1	1	1	4
OG0013016	2	2	0	0	4
OG0013017	1	1	1	1	4
OG0013018	1	1	1	1	4
OG0013019	1	1	1	1	4
OG0013020	1	1	1	1	4
OG0013021	4	0	0	0	4
OG0013022	1	1	1	1	4
OG0013023	1	1	1	1	4
OG0013024	1	1	1	1	4
OG0013025	1	1	1	1	4
OG0013026	1	1	1	1	4
OG0013027	1	1	1	1	4
OG0013028	3	1	0	0	4
OG0013029	1	1	1	1	4
OG0013030	3	1	0	0	4
OG0013031	4	0	0	0	4
OG0013032	1	1	1	1	4
OG0013033	3	1	0	0	4
OG0013034	1	1	1	1	4
OG0013035	1	1	1	1	4
OG0013036	1	1	1	1	4
OG0013037	1	0	1	2	4
OG0013038	2	1	0	1	4
OG0013039	2	2	0	0	4
OG0013040	2	2	0	0	4
OG0013041	1	1	1	1	4
OG0013042	2	2	0	0	4
OG0013043	3	1	0	0	4
OG0013044	1	1	1	1	4
OG0013045	1	1	1	1	4
OG0013046	4	0	0	0	4
OG0013047	3	1	0	0	4
OG0013048	1	1	1	1	4
OG0013049	1	1	1	1	4
OG0013050	1	1	1	1	4
OG0013051	3	0	0	1	4
OG0013052	1	1	1	1	4
OG0013053	1	1	1	1	4
OG0013054	1	1	1	1	4
OG0013055	1	1	1	1	4
OG0013056	1	1	1	1	4
OG0013057	1	1	1	1	4
OG0013058	1	1	1	1	4
OG0013059	1	1	1	1	4
OG0013060	1	1	1	1	4
OG0013061	1	1	1	1	4
OG0013062	1	1	1	1	4
OG0013063	1	1	1	1	4
OG0013064	1	1	1	1	4
OG0013065	1	1	1	1	4
OG0013066	1	1	1	1	4
OG0013067	1	1	1	1	4
OG0013068	3	1	0	0	4
OG0013069	1	1	2	0	4
OG0013070	1	3	0	0	4
OG0013071	1	1	1	1	4
OG0013072	1	1	1	1	4
OG0013073	1	1	1	1	4
OG0013074	1	1	1	1	4
OG0013075	1	1	1	1	4
OG0013076	1	1	1	1	4
OG0013077	1	1	1	1	4
OG0013078	1	1	1	1	4
OG0013079	1	1	1	1	4
OG0013080	1	1	1	1	4
OG0013081	3	1	0	0	4
OG0013082	1	1	1	1	4
OG0013083	1	1	1	1	4
OG0013084	1	1	1	1	4
OG0013085	1	1	1	1	4
OG0013086	1	1	1	1	4
OG0013087	1	1	1	1	4
OG0013088	1	1	1	1	4
OG0013089	1	1	2	0	4
OG0013090	1	3	0	0	4
OG0013091	2	2	0	0	4
OG0013092	2	0	1	1	4
OG0013093	1	1	1	1	4
OG0013094	1	1	1	1	4
OG0013095	1	1	1	1	4
OG0013096	3	1	0	0	4
OG0013097	1	1	1	1	4
OG0013098	1	1	1	1	4
OG0013099	1	1	1	1	4
OG0013100	1	1	1	1	4
OG0013101	1	1	1	1	4
OG0013102	1	1	1	1	4
OG0013103	1	1	1	1	4
OG0013104	1	1	1	1	4
OG0013105	1	1	1	1	4
OG0013106	1	1	1	1	4
OG0013107	1	1	1	1	4
OG0013108	1	1	1	1	4
OG0013109	1	1	1	1	4
OG0013110	1	1	1	1	4
OG0013111	1	1	1	1	4
OG0013112	1	1	1	1	4
OG0013113	1	1	1	1	4
OG0013114	1	1	1	1	4
OG0013115	1	1	1	1	4
OG0013116	1	1	1	1	4
OG0013117	1	1	1	1	4
OG0013118	1	1	1	1	4
OG0013119	1	1	1	1	4
OG0013120	1	0	1	2	4
OG0013121	1	1	1	1	4
OG0013122	1	1	1	1	4
OG0013123	1	1	1	1	4
OG0013124	1	1	1	1	4
OG0013125	1	1	1	1	4
OG0013126	1	1	1	1	4
OG0013127	1	1	1	1	4
OG0013128	1	1	1	1	4
OG0013129	1	1	1	1	4
OG0013130	1	1	1	1	4
OG0013131	1	1	1	1	4
OG0013132	1	1	2	0	4
OG0013133	1	1	1	1	4
OG0013134	1	1	1	1	4
OG0013135	1	1	1	1	4
OG0013136	1	1	1	1	4
OG0013137	1	1	1	1	4
OG0013138	1	1	1	1	4
OG0013139	1	1	1	1	4
OG0013140	1	1	1	1	4
OG0013141	1	1	1	1	4
OG0013142	1	1	1	1	4
OG0013143	3	1	0	0	4
OG0013144	1	1	1	1	4
OG0013145	1	1	1	1	4
OG0013146	1	0	1	2	4
OG0013147	2	2	0	0	4
OG0013148	1	1	1	1	4
OG0013149	2	2	0	0	4
OG0013150	1	1	1	1	4
OG0013151	1	1	1	1	4
OG0013152	1	1	1	1	4
OG0013153	1	1	1	1	4
OG0013154	1	1	1	1	4
OG0013155	1	3	0	0	4
OG0013156	2	2	0	0	4
OG0013157	1	1	1	1	4
OG0013158	3	1	0	0	4
OG0013159	3	0	1	0	4
OG0013160	1	1	1	1	4
OG0013161	1	1	1	1	4
OG0013162	4	0	0	0	4
OG0013163	1	1	1	1	4
OG0013164	1	1	1	1	4
OG0013165	1	1	1	1	4
OG0013166	1	1	1	1	4
OG0013167	1	1	1	1	4
OG0013168	1	1	1	1	4
OG0013169	1	1	1	1	4
OG0013170	1	1	1	1	4
OG0013171	1	1	1	1	4
OG0013172	1	1	1	1	4
OG0013173	1	1	1	1	4
OG0013174	1	1	1	1	4
OG0013175	1	1	1	1	4
OG0013176	1	1	1	1	4
OG0013177	1	1	1	1	4
OG0013178	3	1	0	0	4
OG0013179	1	1	1	1	4
OG0013180	3	1	0	0	4
OG0013181	1	1	1	1	4
OG0013182	1	1	1	1	4
OG0013183	1	1	1	1	4
OG0013184	1	1	1	1	4
OG0013185	1	1	1	1	4
OG0013186	1	1	1	1	4
OG0013187	1	1	1	1	4
OG0013188	1	1	1	1	4
OG0013189	3	1	0	0	4
OG0013190	1	1	1	1	4
OG0013191	4	0	0	0	4
OG0013192	1	1	1	1	4
OG0013193	1	1	1	1	4
OG0013194	1	1	1	1	4
OG0013195	1	3	0	0	4
OG0013196	1	1	1	1	4
OG0013197	1	1	1	1	4
OG0013198	1	1	1	1	4
OG0013199	1	1	1	1	4
OG0013200	1	1	1	1	4
OG0013201	1	2	0	1	4
OG0013202	1	1	1	1	4
OG0013203	1	1	1	1	4
OG0013204	1	1	1	1	4
OG0013205	2	2	0	0	4
OG0013206	1	1	1	1	4
OG0013207	2	0	1	1	4
OG0013208	1	1	1	1	4
OG0013209	1	1	1	1	4
OG0013210	1	1	1	1	4
OG0013211	1	1	1	1	4
OG0013212	1	1	1	1	4
OG0013213	1	1	1	1	4
OG0013214	1	1	1	1	4
OG0013215	1	1	1	1	4
OG0013216	1	1	1	1	4
OG0013217	1	1	1	1	4
OG0013218	1	0	2	1	4
OG0013219	1	0	2	1	4
OG0013220	1	1	1	1	4
OG0013221	1	1	1	1	4
OG0013222	2	1	0	1	4
OG0013223	1	1	1	1	4
OG0013224	1	1	1	1	4
OG0013225	1	1	1	1	4
OG0013226	1	1	1	1	4
OG0013227	1	1	1	1	4
OG0013228	1	1	1	1	4
OG0013229	1	1	1	1	4
OG0013230	1	1	1	1	4
OG0013231	1	1	1	1	4
OG0013232	1	1	1	1	4
OG0013233	1	1	1	1	4
OG0013234	1	1	1	1	4
OG0013235	1	1	1	1	4
OG0013236	1	1	1	1	4
OG0013237	1	1	1	1	4
OG0013238	1	1	1	1	4
OG0013239	1	1	1	1	4
OG0013240	1	1	1	1	4
OG0013241	1	1	1	1	4
OG0013242	1	1	1	1	4
OG0013243	1	1	1	1	4
OG0013244	1	1	1	1	4
OG0013245	1	1	1	1	4
OG0013246	1	1	1	1	4
OG0013247	1	1	1	1	4
OG0013248	1	1	1	1	4
OG0013249	1	1	1	1	4
OG0013250	1	1	1	1	4
OG0013251	1	1	1	1	4
OG0013252	1	1	1	1	4
OG0013253	1	1	1	1	4
OG0013254	1	1	1	1	4
OG0013255	1	1	1	1	4
OG0013256	1	1	1	1	4
OG0013257	1	1	1	1	4
OG0013258	1	1	1	1	4
OG0013259	1	1	1	1	4
OG0013260	1	1	1	1	4
OG0013261	1	1	1	1	4
OG0013262	1	1	1	1	4
OG0013263	1	1	1	1	4
OG0013264	1	1	1	1	4
OG0013265	1	1	1	1	4
OG0013266	1	1	1	1	4
OG0013267	1	1	1	1	4
OG0013268	1	1	1	1	4
OG0013269	1	1	1	1	4
OG0013270	1	1	1	1	4
OG0013271	1	1	1	1	4
OG0013272	1	1	1	1	4
OG0013273	1	1	1	1	4
OG0013274	1	1	1	1	4
OG0013275	1	1	1	1	4
OG0013276	1	1	1	1	4
OG0013277	1	0	2	1	4
OG0013278	1	1	1	1	4
OG0013279	1	1	1	1	4
OG0013280	1	1	1	1	4
OG0013281	1	1	1	1	4
OG0013282	1	1	1	1	4
OG0013283	1	1	1	1	4
OG0013284	1	1	1	1	4
OG0013285	1	1	1	1	4
OG0013286	1	1	1	1	4
OG0013287	1	1	1	1	4
OG0013288	1	1	1	1	4
OG0013289	1	1	1	1	4
OG0013290	1	1	1	1	4
OG0013291	1	1	1	1	4
OG0013292	1	1	1	1	4
OG0013293	1	1	1	1	4
OG0013294	1	1	1	1	4
OG0013295	1	1	1	1	4
OG0013296	1	1	1	1	4
OG0013297	1	1	1	1	4
OG0013298	1	1	1	1	4
OG0013299	1	1	1	1	4
OG0013300	1	1	1	1	4
OG0013301	1	1	1	1	4
OG0013302	1	1	1	1	4
OG0013303	1	1	1	1	4
OG0013304	1	1	1	1	4
OG0013305	1	1	1	1	4
OG0013306	1	1	1	1	4
OG0013307	1	1	1	1	4
OG0013308	1	1	1	1	4
OG0013309	1	1	1	1	4
OG0013310	1	1	1	1	4
OG0013311	1	1	1	1	4
OG0013312	1	1	1	1	4
OG0013313	1	1	1	1	4
OG0013314	1	1	1	1	4
OG0013315	1	1	1	1	4
OG0013316	1	1	1	1	4
OG0013317	1	1	1	1	4
OG0013318	1	1	1	1	4
OG0013319	1	1	1	1	4
OG0013320	1	1	1	1	4
OG0013321	1	1	1	1	4
OG0013322	1	1	1	1	4
OG0013323	1	1	1	1	4
OG0013324	1	1	1	1	4
OG0013325	1	1	1	1	4
OG0013326	1	1	1	1	4
OG0013327	1	1	1	1	4
OG0013328	1	1	1	1	4
OG0013329	1	1	1	1	4
OG0013330	1	1	1	1	4
OG0013331	1	1	1	1	4
OG0013332	1	1	1	1	4
OG0013333	1	1	1	1	4
OG0013334	1	1	1	1	4
OG0013335	1	1	1	1	4
OG0013336	1	1	1	1	4
OG0013337	1	1	1	1	4
OG0013338	1	1	1	1	4
OG0013339	1	1	1	1	4
OG0013340	1	1	1	1	4
OG0013341	1	1	1	1	4
OG0013342	1	1	1	1	4
OG0013343	1	1	1	1	4
OG0013344	1	1	1	1	4
OG0013345	1	1	1	1	4
OG0013346	1	1	1	1	4
OG0013347	1	1	1	1	4
OG0013348	1	1	1	1	4
OG0013349	1	1	1	1	4
OG0013350	1	1	1	1	4
OG0013351	1	1	1	1	4
OG0013352	1	1	1	1	4
OG0013353	1	1	1	1	4
OG0013354	1	1	1	1	4
OG0013355	1	1	1	1	4
OG0013356	1	1	1	1	4
OG0013357	1	1	1	1	4
OG0013358	1	1	1	1	4
OG0013359	1	1	1	1	4
OG0013360	1	1	1	1	4
OG0013361	1	1	1	1	4
OG0013362	1	1	1	1	4
OG0013363	1	1	1	1	4
OG0013364	1	1	1	1	4
OG0013365	1	1	1	1	4
OG0013366	1	1	1	1	4
OG0013367	1	1	1	1	4
OG0013368	1	1	1	1	4
OG0013369	1	1	1	1	4
OG0013370	1	1	1	1	4
OG0013371	1	1	1	1	4
OG0013372	1	1	1	1	4
OG0013373	1	1	1	1	4
OG0013374	1	1	1	1	4
OG0013375	1	1	1	1	4
OG0013376	1	1	1	1	4
OG0013377	1	1	1	1	4
OG0013378	1	1	1	1	4
OG0013379	1	1	1	1	4
OG0013380	1	1	1	1	4
OG0013381	1	1	1	1	4
OG0013382	1	1	1	1	4
OG0013383	2	1	0	1	4
OG0013384	1	1	1	1	4
OG0013385	1	1	1	1	4
OG0013386	1	1	1	1	4
OG0013387	1	1	1	1	4
OG0013388	1	1	1	1	4
OG0013389	1	1	1	1	4
OG0013390	1	1	1	1	4
OG0013391	1	1	1	1	4
OG0013392	1	1	2	0	4
OG0013393	1	1	1	1	4
OG0013394	1	1	1	1	4
OG0013395	1	1	1	1	4
OG0013396	1	1	1	1	4
OG0013397	1	1	1	1	4
OG0013398	1	1	1	1	4
OG0013399	1	1	1	1	4
OG0013400	1	1	1	1	4
OG0013401	1	1	1	1	4
OG0013402	1	1	1	1	4
OG0013403	1	1	1	1	4
OG0013404	1	1	1	1	4
OG0013405	2	2	0	0	4
OG0013406	1	1	1	1	4
OG0013407	1	1	1	1	4
OG0013408	1	1	1	1	4
OG0013409	1	1	1	1	4
OG0013410	1	1	1	1	4
OG0013411	1	1	1	1	4
OG0013412	1	1	1	1	4
OG0013413	3	0	1	0	4
OG0013414	1	1	1	1	4
OG0013415	1	1	1	1	4
OG0013416	1	1	1	1	4
OG0013417	1	1	1	1	4
OG0013418	1	1	1	1	4
OG0013419	1	1	1	1	4
OG0013420	1	1	1	1	4
OG0013421	1	1	1	1	4
OG0013422	1	1	1	1	4
OG0013423	1	1	1	1	4
OG0013424	1	1	1	1	4
OG0013425	1	1	1	1	4
OG0013426	1	1	1	1	4
OG0013427	1	1	1	1	4
OG0013428	1	1	1	1	4
OG0013429	1	1	1	1	4
OG0013430	1	1	1	1	4
OG0013431	1	1	1	1	4
OG0013432	1	0	1	2	4
OG0013433	1	1	1	1	4
OG0013434	1	1	1	1	4
OG0013435	1	1	1	1	4
OG0013436	1	1	1	1	4
OG0013437	1	1	1	1	4
OG0013438	1	1	1	1	4
OG0013439	1	1	1	1	4
OG0013440	1	1	1	1	4
OG0013441	1	1	1	1	4
OG0013442	1	1	1	1	4
OG0013443	1	1	1	1	4
OG0013444	3	1	0	0	4
OG0013445	1	1	1	1	4
OG0013446	1	1	1	1	4
OG0013447	1	1	1	1	4
OG0013448	1	1	1	1	4
OG0013449	1	1	1	1	4
OG0013450	1	1	1	1	4
OG0013451	1	1	1	1	4
OG0013452	1	1	1	1	4
OG0013453	1	1	1	1	4
OG0013454	1	1	1	1	4
OG0013455	1	1	1	1	4
OG0013456	1	1	1	1	4
OG0013457	1	1	1	1	4
OG0013458	1	1	1	1	4
OG0013459	1	1	1	1	4
OG0013460	1	1	1	1	4
OG0013461	1	1	1	1	4
OG0013462	1	1	1	1	4
OG0013463	1	1	1	1	4
OG0013464	1	1	1	1	4
OG0013465	1	1	1	1	4
OG0013466	1	1	1	1	4
OG0013467	1	1	1	1	4
OG0013468	1	1	1	1	4
OG0013469	1	1	1	1	4
OG0013470	1	1	1	1	4
OG0013471	1	1	1	1	4
OG0013472	1	1	1	1	4
OG0013473	1	1	1	1	4
OG0013474	1	1	1	1	4
OG0013475	1	1	1	1	4
OG0013476	1	1	1	1	4
OG0013477	1	0	2	1	4
OG0013478	1	1	1	1	4
OG0013479	1	1	1	1	4
OG0013480	1	3	0	0	4
OG0013481	1	1	1	1	4
OG0013482	1	1	1	1	4
OG0013483	1	1	1	1	4
OG0013484	1	1	1	1	4
OG0013485	1	1	1	1	4
OG0013486	1	1	1	1	4
OG0013487	1	1	1	1	4
OG0013488	1	1	1	1	4
OG0013489	1	1	1	1	4
OG0013490	1	1	1	1	4
OG0013491	1	1	1	1	4
OG0013492	1	1	1	1	4
OG0013493	1	1	1	1	4
OG0013494	1	1	1	1	4
OG0013495	1	1	1	1	4
OG0013496	1	1	1	1	4
OG0013497	1	1	1	1	4
OG0013498	3	1	0	0	4
OG0013499	1	1	1	1	4
OG0013500	1	1	1	1	4
OG0013501	1	1	1	1	4
OG0013502	1	1	1	1	4
OG0013503	1	1	1	1	4
OG0013504	1	1	1	1	4
OG0013505	1	1	1	1	4
OG0013506	1	1	1	1	4
OG0013507	1	1	1	1	4
OG0013508	1	1	1	1	4
OG0013509	1	1	1	1	4
OG0013510	1	1	1	1	4
OG0013511	1	1	1	1	4
OG0013512	1	1	1	1	4
OG0013513	1	1	1	1	4
OG0013514	1	1	1	1	4
OG0013515	1	1	1	1	4
OG0013516	1	1	1	1	4
OG0013517	1	1	1	1	4
OG0013518	1	1	1	1	4
OG0013519	1	1	1	1	4
OG0013520	1	1	1	1	4
OG0013521	1	1	1	1	4
OG0013522	1	1	1	1	4
OG0013523	1	1	1	1	4
OG0013524	1	1	1	1	4
OG0013525	1	1	1	1	4
OG0013526	1	1	1	1	4
OG0013527	1	1	1	1	4
OG0013528	1	1	1	1	4
OG0013529	1	1	1	1	4
OG0013530	1	1	1	1	4
OG0013531	1	1	1	1	4
OG0013532	1	1	1	1	4
OG0013533	1	1	1	1	4
OG0013534	1	1	1	1	4
OG0013535	1	1	1	1	4
OG0013536	1	1	1	1	4
OG0013537	1	1	1	1	4
OG0013538	1	1	1	1	4
OG0013539	1	1	1	1	4
OG0013540	1	1	1	1	4
OG0013541	1	1	1	1	4
OG0013542	1	1	1	1	4
OG0013543	2	0	1	1	4
OG0013544	1	1	1	1	4
OG0013545	1	1	1	1	4
OG0013546	1	1	1	1	4
OG0013547	2	1	1	0	4
OG0013548	1	1	1	1	4
OG0013549	1	1	1	1	4
OG0013550	1	1	1	1	4
OG0013551	1	1	1	1	4
OG0013552	1	1	1	1	4
OG0013553	1	1	1	1	4
OG0013554	1	1	1	1	4
OG0013555	1	1	1	1	4
OG0013556	1	1	1	1	4
OG0013557	1	1	1	1	4
OG0013558	1	1	1	1	4
OG0013559	1	1	1	1	4
OG0013560	1	1	1	1	4
OG0013561	1	1	1	1	4
OG0013562	4	0	0	0	4
OG0013563	1	1	1	1	4
OG0013564	1	1	1	1	4
OG0013565	1	1	1	1	4
OG0013566	1	1	1	1	4
OG0013567	1	1	1	1	4
OG0013568	1	1	1	1	4
OG0013569	1	1	1	1	4
OG0013570	1	1	1	1	4
OG0013571	1	1	1	1	4
OG0013572	1	1	1	1	4
OG0013573	1	1	1	1	4
OG0013574	1	1	1	1	4
OG0013575	1	1	1	1	4
OG0013576	1	1	1	1	4
OG0013577	1	1	1	1	4
OG0013578	1	1	1	1	4
OG0013579	1	1	1	1	4
OG0013580	1	1	1	1	4
OG0013581	1	1	1	1	4
OG0013582	1	1	1	1	4
OG0013583	1	1	1	1	4
OG0013584	1	1	1	1	4
OG0013585	1	1	1	1	4
OG0013586	1	1	1	1	4
OG0013587	1	1	1	1	4
OG0013588	1	1	1	1	4
OG0013589	1	1	1	1	4
OG0013590	1	1	1	1	4
OG0013591	1	1	1	1	4
OG0013592	1	1	1	1	4
OG0013593	1	1	1	1	4
OG0013594	1	1	1	1	4
OG0013595	1	1	1	1	4
OG0013596	1	1	1	1	4
OG0013597	1	1	1	1	4
OG0013598	1	1	1	1	4
OG0013599	1	1	1	1	4
OG0013600	2	1	0	1	4
OG0013601	1	1	1	1	4
OG0013602	1	0	1	2	4
OG0013603	1	1	1	1	4
OG0013604	1	1	1	1	4
OG0013605	1	1	1	1	4
OG0013606	1	1	1	1	4
OG0013607	1	1	1	1	4
OG0013608	1	1	1	1	4
OG0013609	1	1	1	1	4
OG0013610	1	1	1	1	4
OG0013611	1	1	1	1	4
OG0013612	1	1	1	1	4
OG0013613	1	1	1	1	4
OG0013614	1	1	1	1	4
OG0013615	1	0	2	1	4
OG0013616	1	1	1	1	4
OG0013617	1	1	1	1	4
OG0013618	1	1	1	1	4
OG0013619	1	1	1	1	4
OG0013620	1	1	1	1	4
OG0013621	1	1	1	1	4
OG0013622	1	1	1	1	4
OG0013623	1	1	1	1	4
OG0013624	1	1	1	1	4
OG0013625	1	1	1	1	4
OG0013626	1	1	1	1	4
OG0013627	1	1	1	1	4
OG0013628	1	1	1	1	4
OG0013629	1	1	1	1	4
OG0013630	1	1	1	1	4
OG0013631	1	1	1	1	4
OG0013632	1	1	1	1	4
OG0013633	1	1	1	1	4
OG0013634	1	1	1	1	4
OG0013635	1	1	1	1	4
OG0013636	1	1	1	1	4
OG0013637	1	1	1	1	4
OG0013638	1	1	1	1	4
OG0013639	1	1	1	1	4
OG0013640	1	1	1	1	4
OG0013641	1	1	1	1	4
OG0013642	1	1	1	1	4
OG0013643	1	1	1	1	4
OG0013644	1	1	1	1	4
OG0013645	1	1	1	1	4
OG0013646	1	1	1	1	4
OG0013647	1	1	1	1	4
OG0013648	1	1	1	1	4
OG0013649	1	1	1	1	4
OG0013650	1	1	1	1	4
OG0013651	1	1	1	1	4
OG0013652	1	1	1	1	4
OG0013653	1	1	1	1	4
OG0013654	1	1	1	1	4
OG0013655	1	1	1	1	4
OG0013656	1	1	1	1	4
OG0013657	1	1	1	1	4
OG0013658	1	1	1	1	4
OG0013659	1	1	1	1	4
OG0013660	1	1	1	1	4
OG0013661	1	1	1	1	4
OG0013662	1	1	1	1	4
OG0013663	1	1	1	1	4
OG0013664	1	1	1	1	4
OG0013665	1	1	1	1	4
OG0013666	1	1	1	1	4
OG0013667	1	1	1	1	4
OG0013668	1	1	1	1	4
OG0013669	1	1	1	1	4
OG0013670	1	1	1	1	4
OG0013671	1	1	1	1	4
OG0013672	1	0	2	1	4
OG0013673	1	1	1	1	4
OG0013674	1	1	1	1	4
OG0013675	1	1	1	1	4
OG0013676	1	1	1	1	4
OG0013677	1	1	1	1	4
OG0013678	1	1	1	1	4
OG0013679	1	1	1	1	4
OG0013680	1	1	1	1	4
OG0013681	1	0	1	2	4
OG0013682	1	1	1	1	4
OG0013683	1	1	1	1	4
OG0013684	1	1	1	1	4
OG0013685	1	1	1	1	4
OG0013686	1	1	1	1	4
OG0013687	1	1	1	1	4
OG0013688	1	1	1	1	4
OG0013689	1	1	1	1	4
OG0013690	1	0	2	1	4
OG0013691	1	1	1	1	4
OG0013692	1	1	1	1	4
OG0013693	1	1	1	1	4
OG0013694	1	1	1	1	4
OG0013695	1	1	1	1	4
OG0013696	1	1	1	1	4
OG0013697	1	1	1	1	4
OG0013698	1	1	1	1	4
OG0013699	1	1	1	1	4
OG0013700	1	1	1	1	4
OG0013701	1	1	1	1	4
OG0013702	1	1	1	1	4
OG0013703	1	1	1	1	4
OG0013704	1	0	2	1	4
OG0013705	1	1	1	1	4
OG0013706	1	1	1	1	4
OG0013707	1	1	1	1	4
OG0013708	1	1	1	1	4
OG0013709	1	1	1	1	4
OG0013710	1	1	1	1	4
OG0013711	1	1	1	1	4
OG0013712	1	1	1	1	4
OG0013713	1	1	1	1	4
OG0013714	1	1	1	1	4
OG0013715	1	1	1	1	4
OG0013716	1	1	1	1	4
OG0013717	1	1	1	1	4
OG0013718	1	1	1	1	4
OG0013719	1	1	1	1	4
OG0013720	1	1	1	1	4
OG0013721	1	1	1	1	4
OG0013722	1	1	1	1	4
OG0013723	1	1	1	1	4
OG0013724	1	1	1	1	4
OG0013725	1	1	1	1	4
OG0013726	1	1	1	1	4
OG0013727	1	1	1	1	4
OG0013728	1	1	1	1	4
OG0013729	1	1	1	1	4
OG0013730	1	1	1	1	4
OG0013731	1	1	1	1	4
OG0013732	1	1	1	1	4
OG0013733	1	1	1	1	4
OG0013734	1	0	1	2	4
OG0013735	1	1	1	1	4
OG0013736	1	1	1	1	4
OG0013737	1	1	1	1	4
OG0013738	1	1	1	1	4
OG0013739	1	1	1	1	4
OG0013740	1	1	1	1	4
OG0013741	1	1	1	1	4
OG0013742	1	1	1	1	4
OG0013743	1	1	1	1	4
OG0013744	1	1	1	1	4
OG0013745	1	1	1	1	4
OG0013746	1	1	1	1	4
OG0013747	1	1	1	1	4
OG0013748	1	1	1	1	4
OG0013749	1	1	1	1	4
OG0013750	1	1	1	1	4
OG0013751	1	1	1	1	4
OG0013752	1	1	1	1	4
OG0013753	1	1	1	1	4
OG0013754	1	1	1	1	4
OG0013755	1	1	1	1	4
OG0013756	1	1	1	1	4
OG0013757	1	1	1	1	4
OG0013758	1	1	1	1	4
OG0013759	1	1	1	1	4
OG0013760	1	1	1	1	4
OG0013761	1	1	1	1	4
OG0013762	1	1	1	1	4
OG0013763	1	1	1	1	4
OG0013764	1	1	1	1	4
OG0013765	1	1	1	1	4
OG0013766	1	1	1	1	4
OG0013767	1	1	1	1	4
OG0013768	1	1	1	1	4
OG0013769	1	1	1	1	4
OG0013770	1	1	1	1	4
OG0013771	1	1	1	1	4
OG0013772	1	1	1	1	4
OG0013773	1	1	1	1	4
OG0013774	1	1	1	1	4
OG0013775	1	1	1	1	4
OG0013776	1	1	1	1	4
OG0013777	1	1	1	1	4
OG0013778	1	1	1	1	4
OG0013779	1	1	1	1	4
OG0013780	1	1	1	1	4
OG0013781	1	1	1	1	4
OG0013782	1	1	1	1	4
OG0013783	1	1	1	1	4
OG0013784	1	1	1	1	4
OG0013785	1	1	1	1	4
OG0013786	1	1	1	1	4
OG0013787	1	1	1	1	4
OG0013788	1	1	1	1	4
OG0013789	1	1	1	1	4
OG0013790	1	1	1	1	4
OG0013791	1	1	1	1	4
OG0013792	1	1	1	1	4
OG0013793	1	1	1	1	4
OG0013794	1	1	1	1	4
OG0013795	1	1	1	1	4
OG0013796	1	1	1	1	4
OG0013797	1	1	1	1	4
OG0013798	1	1	1	1	4
OG0013799	1	1	1	1	4
OG0013800	1	1	1	1	4
OG0013801	1	1	1	1	4
OG0013802	1	1	1	1	4
OG0013803	1	0	2	1	4
OG0013804	1	1	1	1	4
OG0013805	1	1	1	1	4
OG0013806	1	1	1	1	4
OG0013807	1	1	1	1	4
OG0013808	1	1	1	1	4
OG0013809	1	1	1	1	4
OG0013810	1	1	1	1	4
OG0013811	1	1	1	1	4
OG0013812	1	1	1	1	4
OG0013813	1	1	1	1	4
OG0013814	1	1	1	1	4
OG0013815	1	1	1	1	4
OG0013816	1	1	1	1	4
OG0013817	1	1	1	1	4
OG0013818	1	1	1	1	4
OG0013819	1	1	1	1	4
OG0013820	1	1	1	1	4
OG0013821	2	2	0	0	4
OG0013822	1	1	1	1	4
OG0013823	1	1	1	1	4
OG0013824	1	1	1	1	4
OG0013825	1	1	1	1	4
OG0013826	1	1	1	1	4
OG0013827	1	1	1	1	4
OG0013828	1	1	1	1	4
OG0013829	1	1	1	1	4
OG0013830	1	1	1	1	4
OG0013831	1	1	1	1	4
OG0013832	1	1	1	1	4
OG0013833	1	1	1	1	4
OG0013834	1	1	1	1	4
OG0013835	1	1	1	1	4
OG0013836	1	1	1	1	4
OG0013837	1	1	1	1	4
OG0013838	1	1	1	1	4
OG0013839	1	1	1	1	4
OG0013840	1	1	1	1	4
OG0013841	1	1	1	1	4
OG0013842	1	1	1	1	4
OG0013843	1	1	1	1	4
OG0013844	1	1	1	1	4
OG0013845	1	1	1	1	4
OG0013846	1	1	1	1	4
OG0013847	1	1	1	1	4
OG0013848	1	1	1	1	4
OG0013849	1	1	1	1	4
OG0013850	1	1	1	1	4
OG0013851	1	1	1	1	4
OG0013852	1	1	1	1	4
OG0013853	1	1	1	1	4
OG0013854	1	1	1	1	4
OG0013855	1	1	1	1	4
OG0013856	1	1	1	1	4
OG0013857	1	1	1	1	4
OG0013858	1	1	1	1	4
OG0013859	1	1	1	1	4
OG0013860	1	1	0	2	4
OG0013861	1	1	1	1	4
OG0013862	1	1	1	1	4
OG0013863	1	1	1	1	4
OG0013864	1	1	1	1	4
OG0013865	1	1	1	1	4
OG0013866	1	1	1	1	4
OG0013867	1	1	1	1	4
OG0013868	1	1	1	1	4
OG0013869	1	1	1	1	4
OG0013870	1	1	1	1	4
OG0013871	1	1	1	1	4
OG0013872	1	1	1	1	4
OG0013873	1	1	1	1	4
OG0013874	1	1	1	1	4
OG0013875	1	1	1	1	4
OG0013876	1	1	1	1	4
OG0013877	1	0	2	1	4
OG0013878	1	1	1	1	4
OG0013879	1	1	1	1	4
OG0013880	1	1	1	1	4
OG0013881	1	1	1	1	4
OG0013882	1	1	1	1	4
OG0013883	1	1	1	1	4
OG0013884	1	1	1	1	4
OG0013885	1	1	1	1	4
OG0013886	1	1	1	1	4
OG0013887	1	1	1	1	4
OG0013888	1	1	1	1	4
OG0013889	1	1	1	1	4
OG0013890	1	1	1	1	4
OG0013891	1	1	1	1	4
OG0013892	1	1	1	1	4
OG0013893	1	1	1	1	4
OG0013894	1	1	1	1	4
OG0013895	1	1	1	1	4
OG0013896	1	0	2	1	4
OG0013897	1	1	1	1	4
OG0013898	1	1	1	1	4
OG0013899	1	1	1	1	4
OG0013900	1	1	1	1	4
OG0013901	1	1	1	1	4
OG0013902	1	1	1	1	4
OG0013903	1	1	1	1	4
OG0013904	1	1	1	1	4
OG0013905	1	1	1	1	4
OG0013906	1	1	1	1	4
OG0013907	1	1	1	1	4
OG0013908	1	1	1	1	4
OG0013909	1	1	1	1	4
OG0013910	1	1	1	1	4
OG0013911	1	1	1	1	4
OG0013912	1	1	1	1	4
OG0013913	1	1	1	1	4
OG0013914	1	1	1	1	4
OG0013915	1	1	1	1	4
OG0013916	1	1	1	1	4
OG0013917	1	1	1	1	4
OG0013918	1	1	1	1	4
OG0013919	1	1	1	1	4
OG0013920	1	1	1	1	4
OG0013921	1	1	1	1	4
OG0013922	1	1	1	1	4
OG0013923	1	1	1	1	4
OG0013924	1	1	1	1	4
OG0013925	1	1	1	1	4
OG0013926	1	1	1	1	4
OG0013927	1	1	1	1	4
OG0013928	1	1	1	1	4
OG0013929	1	1	1	1	4
OG0013930	1	1	1	1	4
OG0013931	1	1	1	1	4
OG0013932	1	1	1	1	4
OG0013933	1	1	1	1	4
OG0013934	1	1	1	1	4
OG0013935	1	1	1	1	4
OG0013936	2	0	1	1	4
OG0013937	1	1	1	1	4
OG0013938	2	0	1	1	4
OG0013939	1	1	1	1	4
OG0013940	1	1	1	1	4
OG0013941	1	1	1	1	4
OG0013942	1	1	1	1	4
OG0013943	1	1	1	1	4
OG0013944	1	1	1	1	4
OG0013945	1	1	1	1	4
OG0013946	1	1	1	1	4
OG0013947	1	1	1	1	4
OG0013948	1	1	1	1	4
OG0013949	1	1	1	1	4
OG0013950	1	3	0	0	4
OG0013951	1	1	1	1	4
OG0013952	1	1	1	1	4
OG0013953	1	1	1	1	4
OG0013954	1	1	1	1	4
OG0013955	1	1	1	1	4
OG0013956	1	1	1	1	4
OG0013957	1	1	1	1	4
OG0013958	1	1	1	1	4
OG0013959	1	1	1	1	4
OG0013960	1	1	1	1	4
OG0013961	1	1	1	1	4
OG0013962	1	1	1	1	4
OG0013963	1	1	1	1	4
OG0013964	1	1	1	1	4
OG0013965	1	1	1	1	4
OG0013966	1	1	1	1	4
OG0013967	1	1	1	1	4
OG0013968	1	1	1	1	4
OG0013969	3	1	0	0	4
OG0013970	1	1	1	1	4
OG0013971	1	1	1	1	4
OG0013972	1	1	1	1	4
OG0013973	1	1	1	1	4
OG0013974	1	3	0	0	4
OG0013975	1	1	1	1	4
OG0013976	1	1	1	1	4
OG0013977	1	1	1	1	4
OG0013978	1	1	1	1	4
OG0013979	1	1	1	1	4
OG0013980	1	1	1	1	4
OG0013981	1	1	1	1	4
OG0013982	1	1	1	1	4
OG0013983	1	0	2	1	4
OG0013984	1	1	1	1	4
OG0013985	1	1	1	1	4
OG0013986	1	1	1	1	4
OG0013987	1	1	1	1	4
OG0013988	1	1	1	1	4
OG0013989	1	1	1	1	4
OG0013990	1	1	1	1	4
OG0013991	1	1	1	1	4
OG0013992	1	0	1	2	4
OG0013993	1	1	1	1	4
OG0013994	1	1	1	1	4
OG0013995	1	1	1	1	4
OG0013996	1	1	1	1	4
OG0013997	2	2	0	0	4
OG0013998	1	1	1	1	4
OG0013999	1	1	1	1	4
OG0014000	1	1	1	1	4
OG0014001	1	1	1	1	4
OG0014002	1	1	1	1	4
OG0014003	1	1	1	1	4
OG0014004	1	1	1	1	4
OG0014005	1	1	1	1	4
OG0014006	1	1	1	1	4
OG0014007	1	1	1	1	4
OG0014008	1	1	1	1	4
OG0014009	1	1	1	1	4
OG0014010	1	1	1	1	4
OG0014011	1	1	1	1	4
OG0014012	1	1	1	1	4
OG0014013	1	1	1	1	4
OG0014014	1	1	1	1	4
OG0014015	1	1	1	1	4
OG0014016	1	1	1	1	4
OG0014017	1	1	1	1	4
OG0014018	2	2	0	0	4
OG0014019	1	1	1	1	4
OG0014020	1	1	1	1	4
OG0014021	1	1	1	1	4
OG0014022	1	1	1	1	4
OG0014023	1	1	1	1	4
OG0014024	1	1	1	1	4
OG0014025	1	1	1	1	4
OG0014026	1	1	1	1	4
OG0014027	1	1	1	1	4
OG0014028	1	1	1	1	4
OG0014029	1	1	1	1	4
OG0014030	1	1	1	1	4
OG0014031	1	1	1	1	4
OG0014032	1	1	1	1	4
OG0014033	1	1	1	1	4
OG0014034	2	2	0	0	4
OG0014035	1	1	1	1	4
OG0014036	1	1	1	1	4
OG0014037	1	1	1	1	4
OG0014038	1	1	1	1	4
OG0014039	1	1	1	1	4
OG0014040	1	1	1	1	4
OG0014041	1	1	1	1	4
OG0014042	1	1	1	1	4
OG0014043	3	1	0	0	4
OG0014044	1	1	1	1	4
OG0014045	1	1	1	1	4
OG0014046	1	1	1	1	4
OG0014047	1	1	1	1	4
OG0014048	1	1	1	1	4
OG0014049	1	1	1	1	4
OG0014050	1	1	1	1	4
OG0014051	1	1	1	1	4
OG0014052	1	1	1	1	4
OG0014053	1	1	1	1	4
OG0014054	1	1	1	1	4
OG0014055	1	1	1	1	4
OG0014056	1	1	1	1	4
OG0014057	1	2	1	0	4
OG0014058	1	1	1	1	4
OG0014059	1	1	1	1	4
OG0014060	1	1	1	1	4
OG0014061	1	1	1	1	4
OG0014062	4	0	0	0	4
OG0014063	1	1	1	1	4
OG0014064	1	1	1	1	4
OG0014065	1	1	1	1	4
OG0014066	1	1	1	1	4
OG0014067	1	1	1	1	4
OG0014068	1	1	1	1	4
OG0014069	1	1	1	1	4
OG0014070	1	1	1	1	4
OG0014071	1	1	1	1	4
OG0014072	1	1	1	1	4
OG0014073	1	1	1	1	4
OG0014074	1	1	1	1	4
OG0014075	1	1	1	1	4
OG0014076	1	1	1	1	4
OG0014077	1	1	1	1	4
OG0014078	1	1	1	1	4
OG0014079	1	1	1	1	4
OG0014080	1	1	1	1	4
OG0014081	1	1	1	1	4
OG0014082	1	1	1	1	4
OG0014083	1	1	1	1	4
OG0014084	1	1	1	1	4
OG0014085	1	1	1	1	4
OG0014086	1	1	1	1	4
OG0014087	1	1	1	1	4
OG0014088	1	1	1	1	4
OG0014089	1	1	1	1	4
OG0014090	1	1	1	1	4
OG0014091	1	1	1	1	4
OG0014092	1	1	1	1	4
OG0014093	1	1	1	1	4
OG0014094	1	1	1	1	4
OG0014095	1	1	1	1	4
OG0014096	1	1	1	1	4
OG0014097	1	1	1	1	4
OG0014098	1	0	2	1	4
OG0014099	1	1	1	1	4
OG0014100	1	1	1	1	4
OG0014101	1	1	1	1	4
OG0014102	1	1	1	1	4
OG0014103	1	1	1	1	4
OG0014104	1	1	1	1	4
OG0014105	1	1	1	1	4
OG0014106	1	1	1	1	4
OG0014107	1	1	1	1	4
OG0014108	1	1	1	1	4
OG0014109	1	1	1	1	4
OG0014110	1	1	1	1	4
OG0014111	1	1	1	1	4
OG0014112	1	1	1	1	4
OG0014113	1	1	1	1	4
OG0014114	1	1	1	1	4
OG0014115	2	2	0	0	4
OG0014116	1	0	2	1	4
OG0014117	1	1	1	1	4
OG0014118	1	1	1	1	4
OG0014119	1	1	1	1	4
OG0014120	3	1	0	0	4
OG0014121	1	1	1	1	4
OG0014122	1	1	1	1	4
OG0014123	1	1	1	1	4
OG0014124	1	1	1	1	4
OG0014125	1	1	1	1	4
OG0014126	1	1	1	1	4
OG0014127	1	1	1	1	4
OG0014128	1	1	1	1	4
OG0014129	1	1	1	1	4
OG0014130	1	1	1	1	4
OG0014131	1	1	1	1	4
OG0014132	1	1	1	1	4
OG0014133	1	1	1	1	4
OG0014134	1	1	1	1	4
OG0014135	1	1	1	1	4
OG0014136	1	1	1	1	4
OG0014137	1	1	1	1	4
OG0014138	1	1	1	1	4
OG0014139	1	1	1	1	4
OG0014140	1	1	1	1	4
OG0014141	1	1	1	1	4
OG0014142	1	1	1	1	4
OG0014143	1	1	1	1	4
OG0014144	1	1	1	1	4
OG0014145	1	1	1	1	4
OG0014146	3	1	0	0	4
OG0014147	1	1	1	1	4
OG0014148	1	1	1	1	4
OG0014149	1	1	1	1	4
OG0014150	1	1	1	1	4
OG0014151	1	0	2	1	4
OG0014152	3	1	0	0	4
OG0014153	1	1	1	1	4
OG0014154	1	1	1	1	4
OG0014155	1	1	1	1	4
OG0014156	1	1	1	1	4
OG0014157	1	3	0	0	4
OG0014158	1	1	1	1	4
OG0014159	3	1	0	0	4
OG0014160	1	1	1	1	4
OG0014161	1	1	1	1	4
OG0014162	1	1	1	1	4
OG0014163	1	1	1	1	4
OG0014164	1	1	1	1	4
OG0014165	1	1	1	1	4
OG0014166	1	1	1	1	4
OG0014167	2	1	0	1	4
OG0014168	1	0	1	2	4
OG0014169	1	1	1	1	4
OG0014170	1	1	1	1	4
OG0014171	1	1	1	1	4
OG0014172	1	1	1	1	4
OG0014173	1	1	1	1	4
OG0014174	1	1	1	1	4
OG0014175	4	0	0	0	4
OG0014176	1	1	1	1	4
OG0014177	1	1	1	1	4
OG0014178	1	1	1	1	4
OG0014179	1	1	1	1	4
OG0014180	2	2	0	0	4
OG0014181	2	2	0	0	4
OG0014182	3	1	0	0	4
OG0014183	1	1	1	1	4
OG0014184	1	1	1	1	4
OG0014185	1	1	1	1	4
OG0014186	1	1	1	1	4
OG0014187	1	1	1	1	4
OG0014188	1	1	2	0	4
OG0014189	1	1	1	1	4
OG0014190	3	1	0	0	4
OG0014191	2	2	0	0	4
OG0014192	1	1	1	1	4
OG0014193	1	1	1	1	4
OG0014194	1	1	1	1	4
OG0014195	1	1	1	1	4
OG0014196	1	1	1	1	4
OG0014197	1	1	1	1	4
OG0014198	3	1	0	0	4
OG0014199	1	1	1	1	4
OG0014200	1	1	1	1	4
OG0014201	1	1	1	1	4
OG0014202	1	1	1	1	4
OG0014203	2	2	0	0	4
OG0014204	1	1	1	1	4
OG0014205	1	1	1	1	4
OG0014206	1	1	1	1	4
OG0014207	1	1	1	1	4
OG0014208	1	1	1	1	4
OG0014209	1	1	1	1	4
OG0014210	1	1	1	1	4
OG0014211	1	3	0	0	4
OG0014212	1	1	1	1	4
OG0014213	3	1	0	0	4
OG0014214	1	1	1	1	4
OG0014215	1	1	1	1	4
OG0014216	1	1	1	1	4
OG0014217	1	1	1	1	4
OG0014218	2	1	0	1	4
OG0014219	1	1	1	1	4
OG0014220	1	1	1	1	4
OG0014221	1	1	1	1	4
OG0014222	1	1	1	1	4
OG0014223	2	2	0	0	4
OG0014224	1	1	1	1	4
OG0014225	1	1	1	1	4
OG0014226	1	1	1	1	4
OG0014227	1	1	1	1	4
OG0014228	1	0	2	1	4
OG0014229	4	0	0	0	4
OG0014230	1	1	1	1	4
OG0014231	1	1	1	1	4
OG0014232	1	1	1	1	4
OG0014233	3	1	0	0	4
OG0014234	1	1	1	1	4
OG0014235	1	1	1	1	4
OG0014236	1	3	0	0	4
OG0014237	1	0	1	2	4
OG0014238	3	1	0	0	4
OG0014239	1	1	1	1	4
OG0014240	4	0	0	0	4
OG0014241	3	1	0	0	4
OG0014242	1	0	1	2	4
OG0014243	1	1	1	1	4
OG0014244	1	1	1	1	4
OG0014245	1	1	1	1	4
OG0014246	1	1	1	1	4
OG0014247	1	1	1	1	4
OG0014248	2	1	0	1	4
OG0014249	1	1	1	1	4
OG0014250	1	3	0	0	4
OG0014251	2	2	0	0	4
OG0014252	1	1	1	1	4
OG0014253	1	1	1	1	4
OG0014254	1	1	1	1	4
OG0014255	1	1	1	1	4
OG0014256	1	1	1	1	4
OG0014257	1	1	1	1	4
OG0014258	1	1	1	1	4
OG0014259	1	1	1	1	4
OG0014260	1	1	1	1	4
OG0014261	1	1	1	1	4
OG0014262	1	1	1	1	4
OG0014263	1	1	1	1	4
OG0014264	3	1	0	0	4
OG0014265	1	1	1	1	4
OG0014266	1	1	1	1	4
OG0014267	1	1	1	1	4
OG0014268	2	2	0	0	4
OG0014269	1	1	1	1	4
OG0014270	1	1	1	1	4
OG0014271	1	1	1	1	4
OG0014272	2	2	0	0	4
OG0014273	1	1	1	1	4
OG0014274	1	1	1	1	4
OG0014275	1	1	1	1	4
OG0014276	1	3	0	0	4
OG0014277	1	1	1	1	4
OG0014278	1	1	1	1	4
OG0014279	1	1	1	1	4
OG0014280	3	1	0	0	4
OG0014281	3	1	0	0	4
OG0014282	1	1	1	1	4
OG0014283	1	1	1	1	4
OG0014284	1	1	1	1	4
OG0014285	1	1	1	1	4
OG0014286	1	1	1	1	4
OG0014287	1	1	1	1	4
OG0014288	1	1	1	1	4
OG0014289	2	0	1	1	4
OG0014290	1	1	1	1	4
OG0014291	3	1	0	0	4
OG0014292	1	1	1	1	4
OG0014293	1	1	1	1	4
OG0014294	1	1	1	1	4
OG0014295	1	1	1	1	4
OG0014296	1	1	1	1	4
OG0014297	1	0	2	1	4
OG0014298	1	1	1	1	4
OG0014299	1	1	1	1	4
OG0014300	1	1	1	1	4
OG0014301	1	1	1	1	4
OG0014302	1	1	1	1	4
OG0014303	1	1	1	1	4
OG0014304	1	1	1	1	4
OG0014305	1	1	1	1	4
OG0014306	1	1	1	1	4
OG0014307	1	1	1	1	4
OG0014308	1	1	1	1	4
OG0014309	1	1	1	1	4
OG0014310	1	0	1	2	4
OG0014311	1	1	1	1	4
OG0014312	1	1	1	1	4
OG0014313	1	1	1	1	4
OG0014314	1	1	1	1	4
OG0014315	1	1	1	1	4
OG0014316	1	1	1	1	4
OG0014317	1	1	1	1	4
OG0014318	1	1	1	1	4
OG0014319	1	1	1	1	4
OG0014320	1	0	2	1	4
OG0014321	1	1	1	1	4
OG0014322	1	1	1	1	4
OG0014323	1	1	1	1	4
OG0014324	1	1	1	1	4
OG0014325	1	1	1	1	4
OG0014326	1	1	1	1	4
OG0014327	1	1	1	1	4
OG0014328	1	1	1	1	4
OG0014329	1	1	1	1	4
OG0014330	1	1	1	1	4
OG0014331	1	1	1	1	4
OG0014332	1	1	1	1	4
OG0014333	1	1	1	1	4
OG0014334	1	1	1	1	4
OG0014335	1	1	1	1	4
OG0014336	1	0	1	2	4
OG0014337	1	0	2	1	4
OG0014338	1	1	1	1	4
OG0014339	1	1	1	1	4
OG0014340	1	1	1	1	4
OG0014341	1	1	1	1	4
OG0014342	1	1	1	1	4
OG0014343	1	1	1	1	4
OG0014344	1	1	1	1	4
OG0014345	1	1	1	1	4
OG0014346	1	1	1	1	4
OG0014347	1	1	1	1	4
OG0014348	2	1	0	1	4
OG0014349	1	1	1	1	4
OG0014350	1	1	1	1	4
OG0014351	1	1	1	1	4
OG0014352	1	1	1	1	4
OG0014353	1	1	1	1	4
OG0014354	1	1	1	1	4
OG0014355	1	1	1	1	4
OG0014356	1	1	1	1	4
OG0014357	1	1	1	1	4
OG0014358	1	1	1	1	4
OG0014359	1	1	1	1	4
OG0014360	1	1	1	1	4
OG0014361	1	1	1	1	4
OG0014362	1	0	1	2	4
OG0014363	1	1	1	1	4
OG0014364	1	1	1	1	4
OG0014365	1	1	1	1	4
OG0014366	1	1	1	1	4
OG0014367	1	1	1	1	4
OG0014368	1	1	1	1	4
OG0014369	1	1	1	1	4
OG0014370	1	1	1	1	4
OG0014371	1	1	1	1	4
OG0014372	1	1	1	1	4
OG0014373	1	1	1	1	4
OG0014374	1	1	1	1	4
OG0014375	1	1	1	1	4
OG0014376	1	1	1	1	4
OG0014377	1	1	1	1	4
OG0014378	1	1	1	1	4
OG0014379	1	1	1	1	4
OG0014380	1	1	1	1	4
OG0014381	1	1	1	1	4
OG0014382	1	1	1	1	4
OG0014383	1	1	1	1	4
OG0014384	1	1	1	1	4
OG0014385	1	1	1	1	4
OG0014386	1	1	1	1	4
OG0014387	1	1	1	1	4
OG0014388	1	1	1	1	4
OG0014389	1	1	1	1	4
OG0014390	1	1	1	1	4
OG0014391	1	1	1	1	4
OG0014392	1	1	1	1	4
OG0014393	1	1	1	1	4
OG0014394	2	0	1	1	4
OG0014395	1	0	2	1	4
OG0014396	1	1	1	1	4
OG0014397	1	1	1	1	4
OG0014398	1	1	1	1	4
OG0014399	1	1	1	1	4
OG0014400	1	1	1	1	4
OG0014401	1	1	1	1	4
OG0014402	1	1	1	1	4
OG0014403	1	1	1	1	4
OG0014404	1	1	1	1	4
OG0014405	1	1	1	1	4
OG0014406	1	1	1	1	4
OG0014407	1	1	1	1	4
OG0014408	1	1	1	1	4
OG0014409	1	1	1	1	4
OG0014410	1	1	1	1	4
OG0014411	1	1	1	1	4
OG0014412	1	1	1	1	4
OG0014413	4	0	0	0	4
OG0014414	1	1	1	1	4
OG0014415	1	1	1	1	4
OG0014416	1	1	1	1	4
OG0014417	1	1	1	1	4
OG0014418	1	1	1	1	4
OG0014419	1	1	1	1	4
OG0014420	1	1	1	1	4
OG0014421	1	1	1	1	4
OG0014422	1	1	1	1	4
OG0014423	1	1	1	1	4
OG0014424	1	1	1	1	4
OG0014425	1	1	1	1	4
OG0014426	1	1	1	1	4
OG0014427	1	1	1	1	4
OG0014428	1	1	1	1	4
OG0014429	1	1	1	1	4
OG0014430	1	1	1	1	4
OG0014431	1	1	1	1	4
OG0014432	1	1	1	1	4
OG0014433	1	1	1	1	4
OG0014434	1	1	1	1	4
OG0014435	2	2	0	0	4
OG0014436	1	1	1	1	4
OG0014437	1	1	1	1	4
OG0014438	1	1	1	1	4
OG0014439	1	1	1	1	4
OG0014440	1	1	1	1	4
OG0014441	1	1	1	1	4
OG0014442	1	1	1	1	4
OG0014443	1	1	1	1	4
OG0014444	1	1	1	1	4
OG0014445	1	1	1	1	4
OG0014446	1	1	1	1	4
OG0014447	1	1	1	1	4
OG0014448	1	1	1	1	4
OG0014449	1	1	1	1	4
OG0014450	1	1	1	1	4
OG0014451	1	1	1	1	4
OG0014452	1	1	1	1	4
OG0014453	1	1	1	1	4
OG0014454	1	1	1	1	4
OG0014455	1	1	1	1	4
OG0014456	1	3	0	0	4
OG0014457	1	1	1	1	4
OG0014458	1	1	1	1	4
OG0014459	1	1	1	1	4
OG0014460	1	1	1	1	4
OG0014461	1	1	1	1	4
OG0014462	1	1	1	1	4
OG0014463	1	1	1	1	4
OG0014464	1	1	1	1	4
OG0014465	1	1	1	1	4
OG0014466	1	1	1	1	4
OG0014467	1	1	1	1	4
OG0014468	1	1	1	1	4
OG0014469	1	1	1	1	4
OG0014470	1	1	1	1	4
OG0014471	1	1	1	1	4
OG0014472	1	1	1	1	4
OG0014473	1	1	1	1	4
OG0014474	1	1	1	1	4
OG0014475	1	1	1	1	4
OG0014476	1	1	1	1	4
OG0014477	1	0	2	1	4
OG0014478	1	1	1	1	4
OG0014479	1	1	1	1	4
OG0014480	1	1	1	1	4
OG0014481	1	1	1	1	4
OG0014482	1	1	1	1	4
OG0014483	1	1	1	1	4
OG0014484	1	1	1	1	4
OG0014485	1	1	1	1	4
OG0014486	1	1	1	1	4
OG0014487	1	1	1	1	4
OG0014488	1	1	1	1	4
OG0014489	1	1	1	1	4
OG0014490	1	1	1	1	4
OG0014491	1	1	1	1	4
OG0014492	1	1	1	1	4
OG0014493	1	1	1	1	4
OG0014494	1	1	1	1	4
OG0014495	1	1	1	1	4
OG0014496	1	1	1	1	4
OG0014497	1	1	1	1	4
OG0014498	1	1	1	1	4
OG0014499	2	1	0	1	4
OG0014500	1	1	1	1	4
OG0014501	1	1	1	1	4
OG0014502	1	1	1	1	4
OG0014503	1	1	1	1	4
OG0014504	1	1	1	1	4
OG0014505	1	1	1	1	4
OG0014506	1	1	1	1	4
OG0014507	1	1	1	1	4
OG0014508	1	1	1	1	4
OG0014509	1	1	1	1	4
OG0014510	1	1	1	1	4
OG0014511	1	1	1	1	4
OG0014512	1	0	1	2	4
OG0014513	1	1	1	1	4
OG0014514	1	1	1	1	4
OG0014515	1	1	1	1	4
OG0014516	1	1	1	1	4
OG0014517	1	1	1	1	4
OG0014518	1	0	0	3	4
OG0014519	1	1	1	1	4
OG0014520	1	0	1	2	4
OG0014521	1	1	1	1	4
OG0014522	1	1	1	1	4
OG0014523	1	1	1	1	4
OG0014524	1	1	1	1	4
OG0014525	1	1	1	1	4
OG0014526	1	1	1	1	4
OG0014527	1	1	1	1	4
OG0014528	1	1	1	1	4
OG0014529	1	1	1	1	4
OG0014530	1	1	1	1	4
OG0014531	1	1	1	1	4
OG0014532	1	1	1	1	4
OG0014533	1	1	1	1	4
OG0014534	1	1	1	1	4
OG0014535	1	1	1	1	4
OG0014536	1	1	1	1	4
OG0014537	1	1	1	1	4
OG0014538	1	1	1	1	4
OG0014539	1	1	1	1	4
OG0014540	2	0	1	1	4
OG0014541	1	1	1	1	4
OG0014542	1	1	1	1	4
OG0014543	1	1	1	1	4
OG0014544	1	1	1	1	4
OG0014545	1	0	1	2	4
OG0014546	1	1	1	1	4
OG0014547	1	1	1	1	4
OG0014548	1	1	1	1	4
OG0014549	1	1	1	1	4
OG0014550	1	1	1	1	4
OG0014551	1	1	1	1	4
OG0014552	1	1	1	1	4
OG0014553	1	1	1	1	4
OG0014554	1	1	1	1	4
OG0014555	1	1	1	1	4
OG0014556	1	1	1	1	4
OG0014557	1	1	1	1	4
OG0014558	1	1	1	1	4
OG0014559	1	1	1	1	4
OG0014560	1	1	1	1	4
OG0014561	1	1	1	1	4
OG0014562	1	1	1	1	4
OG0014563	1	1	1	1	4
OG0014564	1	1	1	1	4
OG0014565	1	1	1	1	4
OG0014566	1	1	1	1	4
OG0014567	1	1	1	1	4
OG0014568	1	1	1	1	4
OG0014569	2	2	0	0	4
OG0014570	1	1	1	1	4
OG0014571	1	1	1	1	4
OG0014572	1	1	1	1	4
OG0014573	1	1	1	1	4
OG0014574	1	1	1	1	4
OG0014575	1	1	1	1	4
OG0014576	1	1	2	0	4
OG0014577	1	1	1	1	4
OG0014578	1	1	1	1	4
OG0014579	1	1	1	1	4
OG0014580	1	1	1	1	4
OG0014581	1	1	1	1	4
OG0014582	1	1	1	1	4
OG0014583	1	2	0	1	4
OG0014584	1	1	1	1	4
OG0014585	1	1	1	1	4
OG0014586	1	1	1	1	4
OG0014587	1	1	1	1	4
OG0014588	1	1	1	1	4
OG0014589	1	1	1	1	4
OG0014590	1	1	1	1	4
OG0014591	1	1	1	1	4
OG0014592	1	1	1	1	4
OG0014593	1	1	1	1	4
OG0014594	1	1	1	1	4
OG0014595	1	1	1	1	4
OG0014596	1	1	1	1	4
OG0014597	1	1	1	1	4
OG0014598	1	1	1	1	4
OG0014599	1	1	1	1	4
OG0014600	1	1	1	1	4
OG0014601	1	1	1	1	4
OG0014602	1	1	1	1	4
OG0014603	1	1	1	1	4
OG0014604	1	1	1	1	4
OG0014605	1	1	1	1	4
OG0014606	1	1	1	1	4
OG0014607	1	1	1	1	4
OG0014608	1	1	1	1	4
OG0014609	1	1	1	1	4
OG0014610	1	1	1	1	4
OG0014611	1	0	1	2	4
OG0014612	1	1	1	1	4
OG0014613	1	1	1	1	4
OG0014614	1	1	1	1	4
OG0014615	1	1	1	1	4
OG0014616	1	1	1	1	4
OG0014617	1	1	1	1	4
OG0014618	1	1	1	1	4
OG0014619	1	1	1	1	4
OG0014620	1	1	1	1	4
OG0014621	1	1	1	1	4
OG0014622	1	1	1	1	4
OG0014623	1	1	1	1	4
OG0014624	1	1	1	1	4
OG0014625	1	1	1	1	4
OG0014626	1	1	1	1	4
OG0014627	1	1	1	1	4
OG0014628	1	1	1	1	4
OG0014629	1	1	1	1	4
OG0014630	1	1	1	1	4
OG0014631	1	1	1	1	4
OG0014632	1	3	0	0	4
OG0014633	1	1	1	1	4
OG0014634	1	1	1	1	4
OG0014635	1	1	1	1	4
OG0014636	1	1	1	1	4
OG0014637	1	1	1	1	4
OG0014638	1	1	1	1	4
OG0014639	1	1	1	1	4
OG0014640	1	1	1	1	4
OG0014641	1	1	1	1	4
OG0014642	2	0	1	1	4
OG0014643	1	1	1	1	4
OG0014644	1	1	1	1	4
OG0014645	1	1	1	1	4
OG0014646	1	1	1	1	4
OG0014647	1	1	1	1	4
OG0014648	1	1	1	1	4
OG0014649	1	1	1	1	4
OG0014650	1	1	1	1	4
OG0014651	1	1	1	1	4
OG0014652	1	1	1	1	4
OG0014653	1	1	1	1	4
OG0014654	1	1	1	1	4
OG0014655	1	1	1	1	4
OG0014656	1	1	1	1	4
OG0014657	1	1	1	1	4
OG0014658	1	1	1	1	4
OG0014659	1	1	1	1	4
OG0014660	1	1	1	1	4
OG0014661	1	1	1	1	4
OG0014662	1	1	1	1	4
OG0014663	1	1	1	1	4
OG0014664	1	1	1	1	4
OG0014665	1	1	2	0	4
OG0014666	1	1	1	1	4
OG0014667	1	1	1	1	4
OG0014668	1	1	1	1	4
OG0014669	1	1	1	1	4
OG0014670	1	1	1	1	4
OG0014671	1	0	1	2	4
OG0014672	1	1	1	1	4
OG0014673	1	0	1	2	4
OG0014674	1	1	1	1	4
OG0014675	1	1	1	1	4
OG0014676	1	1	1	1	4
OG0014677	1	1	1	1	4
OG0014678	1	1	1	1	4
OG0014679	1	1	1	1	4
OG0014680	1	1	1	1	4
OG0014681	1	1	1	1	4
OG0014682	1	1	1	1	4
OG0014683	1	1	1	1	4
OG0014684	1	1	1	1	4
OG0014685	1	1	1	1	4
OG0014686	1	1	1	1	4
OG0014687	1	1	1	1	4
OG0014688	1	1	1	1	4
OG0014689	1	1	1	1	4
OG0014690	1	1	1	1	4
OG0014691	1	1	1	1	4
OG0014692	1	1	1	1	4
OG0014693	1	1	1	1	4
OG0014694	1	1	1	1	4
OG0014695	1	1	1	1	4
OG0014696	1	1	1	1	4
OG0014697	1	1	1	1	4
OG0014698	1	1	1	1	4
OG0014699	1	1	1	1	4
OG0014700	1	1	1	1	4
OG0014701	1	1	1	1	4
OG0014702	2	2	0	0	4
OG0014703	1	1	1	1	4
OG0014704	1	1	1	1	4
OG0014705	1	1	1	1	4
OG0014706	1	1	1	1	4
OG0014707	1	1	1	1	4
OG0014708	1	1	1	1	4
OG0014709	1	1	1	1	4
OG0014710	1	1	1	1	4
OG0014711	1	1	1	1	4
OG0014712	1	1	1	1	4
OG0014713	1	1	1	1	4
OG0014714	1	1	1	1	4
OG0014715	1	1	1	1	4
OG0014716	1	1	1	1	4
OG0014717	1	1	1	1	4
OG0014718	1	1	1	1	4
OG0014719	1	1	1	1	4
OG0014720	1	1	1	1	4
OG0014721	1	1	1	1	4
OG0014722	4	0	0	0	4
OG0014723	1	1	1	1	4
OG0014724	2	1	0	1	4
OG0014725	1	1	1	1	4
OG0014726	4	0	0	0	4
OG0014727	1	1	1	1	4
OG0014728	1	1	1	1	4
OG0014729	1	1	1	1	4
OG0014730	1	1	1	1	4
OG0014731	1	1	1	1	4
OG0014732	1	1	1	1	4
OG0014733	1	1	1	1	4
OG0014734	1	1	1	1	4
OG0014735	1	1	1	1	4
OG0014736	1	1	1	1	4
OG0014737	1	1	1	1	4
OG0014738	1	1	1	1	4
OG0014739	1	1	1	1	4
OG0014740	1	1	1	1	4
OG0014741	3	1	0	0	4
OG0014742	1	1	1	1	4
OG0014743	1	1	1	1	4
OG0014744	1	1	1	1	4
OG0014745	1	1	1	1	4
OG0014746	1	1	1	1	4
OG0014747	1	1	1	1	4
OG0014748	1	1	1	1	4
OG0014749	1	1	1	1	4
OG0014750	1	1	1	1	4
OG0014751	1	1	1	1	4
OG0014752	1	1	1	1	4
OG0014753	1	1	1	1	4
OG0014754	1	1	1	1	4
OG0014755	1	1	1	1	4
OG0014756	1	1	1	1	4
OG0014757	1	1	1	1	4
OG0014758	1	1	1	1	4
OG0014759	1	1	1	1	4
OG0014760	1	1	1	1	4
OG0014761	1	1	1	1	4
OG0014762	1	1	1	1	4
OG0014763	1	1	1	1	4
OG0014764	1	1	1	1	4
OG0014765	1	1	1	1	4
OG0014766	1	1	1	1	4
OG0014767	1	1	1	1	4
OG0014768	1	1	1	1	4
OG0014769	1	0	2	1	4
OG0014770	1	3	0	0	4
OG0014771	1	1	1	1	4
OG0014772	2	1	1	0	4
OG0014773	1	1	1	1	4
OG0014774	1	1	1	1	4
OG0014775	1	1	1	1	4
OG0014776	1	1	0	2	4
OG0014777	1	1	1	1	4
OG0014778	1	1	1	1	4
OG0014779	1	1	1	1	4
OG0014780	1	1	1	1	4
OG0014781	1	1	1	1	4
OG0014782	1	1	1	1	4
OG0014783	1	1	1	1	4
OG0014784	1	1	2	0	4
OG0014785	1	1	1	1	4
OG0014786	1	1	1	1	4
OG0014787	1	1	1	1	4
OG0014788	1	1	1	1	4
OG0014789	1	1	1	1	4
OG0014790	1	1	1	1	4
OG0014791	1	1	1	1	4
OG0014792	1	1	1	1	4
OG0014793	1	1	1	1	4
OG0014794	1	1	1	1	4
OG0014795	1	1	1	1	4
OG0014796	1	1	1	1	4
OG0014797	1	1	1	1	4
OG0014798	1	1	1	1	4
OG0014799	1	1	1	1	4
OG0014800	1	1	1	1	4
OG0014801	1	1	1	1	4
OG0014802	3	1	0	0	4
OG0014803	1	1	1	1	4
OG0014804	1	1	1	1	4
OG0014805	1	1	1	1	4
OG0014806	1	1	1	1	4
OG0014807	1	1	1	1	4
OG0014808	1	1	1	1	4
OG0014809	1	1	1	1	4
OG0014810	2	0	1	1	4
OG0014811	1	1	1	1	4
OG0014812	1	1	1	1	4
OG0014813	1	1	1	1	4
OG0014814	1	1	1	1	4
OG0014815	1	1	1	1	4
OG0014816	1	1	1	1	4
OG0014817	1	1	1	1	4
OG0014818	1	1	1	1	4
OG0014819	1	1	1	1	4
OG0014820	1	1	1	1	4
OG0014821	1	1	1	1	4
OG0014822	3	1	0	0	4
OG0014823	1	1	1	1	4
OG0014824	1	1	1	1	4
OG0014825	1	1	1	1	4
OG0014826	1	1	1	1	4
OG0014827	1	0	2	1	4
OG0014828	1	1	1	1	4
OG0014829	1	1	1	1	4
OG0014830	1	1	1	1	4
OG0014831	1	1	1	1	4
OG0014832	1	1	1	1	4
OG0014833	1	1	1	1	4
OG0014834	1	1	1	1	4
OG0014835	1	1	1	1	4
OG0014836	1	1	1	1	4
OG0014837	1	1	1	1	4
OG0014838	1	1	1	1	4
OG0014839	1	1	1	1	4
OG0014840	3	1	0	0	4
OG0014841	3	1	0	0	4
OG0014842	1	0	1	2	4
OG0014843	1	1	1	1	4
OG0014844	1	1	1	1	4
OG0014845	1	1	0	2	4
OG0014846	1	1	1	1	4
OG0014847	1	1	1	1	4
OG0014848	1	1	1	1	4
OG0014849	2	0	1	1	4
OG0014850	2	1	1	0	4
OG0014851	1	1	1	1	4
OG0014852	1	1	1	1	4
OG0014853	1	1	1	1	4
OG0014854	1	1	1	1	4
OG0014855	1	1	1	1	4
OG0014856	1	1	1	1	4
OG0014857	1	1	1	1	4
OG0014858	1	1	1	1	4
OG0014859	1	1	1	1	4
OG0014860	1	1	1	1	4
OG0014861	1	1	1	1	4
OG0014862	1	1	1	1	4
OG0014863	1	1	1	1	4
OG0014864	1	1	1	1	4
OG0014865	3	1	0	0	4
OG0014866	1	1	1	1	4
OG0014867	1	1	1	1	4
OG0014868	4	0	0	0	4
OG0014869	1	0	1	2	4
OG0014870	1	1	1	1	4
OG0014871	1	1	1	1	4
OG0014872	1	1	1	1	4
OG0014873	1	1	1	1	4
OG0014874	1	1	1	1	4
OG0014875	1	1	1	1	4
OG0014876	1	1	1	1	4
OG0014877	1	1	1	1	4
OG0014878	1	0	1	2	4
OG0014879	1	1	1	1	4
OG0014880	1	1	1	1	4
OG0014881	1	1	1	1	4
OG0014882	1	1	1	1	4
OG0014883	1	1	1	1	4
OG0014884	1	1	1	1	4
OG0014885	1	1	1	1	4
OG0014886	1	1	1	1	4
OG0014887	1	1	1	1	4
OG0014888	3	1	0	0	4
OG0014889	1	1	1	1	4
OG0014890	1	1	1	1	4
OG0014891	4	0	0	0	4
OG0014892	2	2	0	0	4
OG0014893	1	0	1	2	4
OG0014894	1	1	1	1	4
OG0014895	1	1	1	1	4
OG0014896	1	1	1	1	4
OG0014897	1	1	1	1	4
OG0014898	1	1	1	1	4
OG0014899	1	1	1	1	4
OG0014900	2	2	0	0	4
OG0014901	1	1	1	1	4
OG0014902	1	1	1	1	4
OG0014903	1	1	1	1	4
OG0014904	1	1	1	1	4
OG0014905	2	1	1	0	4
OG0014906	1	1	1	1	4
OG0014907	1	1	1	1	4
OG0014908	1	1	1	1	4
OG0014909	1	1	1	1	4
OG0014910	1	1	1	1	4
OG0014911	2	2	0	0	4
OG0014912	1	1	1	1	4
OG0014913	1	1	1	1	4
OG0014914	1	0	2	1	4
OG0014915	1	3	0	0	4
OG0014916	2	2	0	0	4
OG0014917	1	1	1	1	4
OG0014918	4	0	0	0	4
OG0014919	1	1	1	1	4
OG0014920	1	1	1	1	4
OG0014921	1	3	0	0	4
OG0014922	4	0	0	0	4
OG0014923	1	1	1	1	4
OG0014924	1	1	1	1	4
OG0014925	1	1	1	1	4
OG0014926	1	1	1	1	4
OG0014927	1	1	1	1	4
OG0014928	1	1	1	1	4
OG0014929	1	1	1	1	4
OG0014930	1	1	1	1	4
OG0014931	1	1	1	1	4
OG0014932	1	0	2	1	4
OG0014933	1	1	1	1	4
OG0014934	3	1	0	0	4
OG0014935	1	1	1	1	4
OG0014936	1	1	1	1	4
OG0014937	1	1	1	1	4
OG0014938	1	1	1	1	4
OG0014939	1	1	1	1	4
OG0014940	1	1	1	1	4
OG0014941	1	1	1	1	4
OG0014942	1	1	1	1	4
OG0014943	1	3	0	0	4
OG0014944	1	1	1	1	4
OG0014945	2	0	1	1	4
OG0014946	1	1	1	1	4
OG0014947	3	1	0	0	4
OG0014948	1	1	1	1	4
OG0014949	1	1	1	1	4
OG0014950	1	1	1	1	4
OG0014951	1	1	1	1	4
OG0014952	1	1	1	1	4
OG0014953	1	1	1	1	4
OG0014954	1	1	1	1	4
OG0014955	1	1	1	1	4
OG0014956	1	1	1	1	4
OG0014957	1	1	1	1	4
OG0014958	1	1	1	1	4
OG0014959	1	1	1	1	4
OG0014960	1	1	1	1	4
OG0014961	1	1	1	1	4
OG0014962	1	1	1	1	4
OG0014963	1	1	1	1	4
OG0014964	1	1	1	1	4
OG0014965	1	0	3	0	4
OG0014966	1	1	1	1	4
OG0014967	3	1	0	0	4
OG0014968	1	1	1	1	4
OG0014969	1	1	1	1	4
OG0014970	1	1	1	1	4
OG0014971	4	0	0	0	4
OG0014972	1	1	1	1	4
OG0014973	1	1	1	1	4
OG0014974	1	1	1	1	4
OG0014975	1	1	1	1	4
OG0014976	1	1	1	1	4
OG0014977	1	1	1	1	4
OG0014978	1	1	1	1	4
OG0014979	1	1	1	1	4
OG0014980	1	1	1	1	4
OG0014981	1	1	1	1	4
OG0014982	1	1	1	1	4
OG0014983	1	1	1	1	4
OG0014984	1	1	1	1	4
OG0014985	1	1	1	1	4
OG0014986	1	0	2	1	4
OG0014987	1	1	1	1	4
OG0014988	1	1	1	1	4
OG0014989	1	1	1	1	4
OG0014990	1	1	1	1	4
OG0014991	1	1	1	1	4
OG0014992	1	1	1	1	4
OG0014993	1	1	1	1	4
OG0014994	1	1	1	1	4
OG0014995	1	1	1	1	4
OG0014996	1	1	1	1	4
OG0014997	1	1	1	1	4
OG0014998	1	1	1	1	4
OG0014999	1	1	2	0	4
OG0015000	1	1	1	1	4
OG0015001	1	1	1	1	4
OG0015002	1	1	1	1	4
OG0015003	1	1	1	1	4
OG0015004	1	1	1	1	4
OG0015005	1	1	1	1	4
OG0015006	1	1	1	1	4
OG0015007	1	1	1	1	4
OG0015008	1	1	1	1	4
OG0015009	1	1	1	1	4
OG0015010	1	1	1	1	4
OG0015011	1	1	1	1	4
OG0015012	1	1	1	1	4
OG0015013	1	1	1	1	4
OG0015014	1	1	1	1	4
OG0015015	1	1	1	1	4
OG0015016	1	1	1	1	4
OG0015017	1	1	1	1	4
OG0015018	1	1	1	1	4
OG0015019	1	1	1	1	4
OG0015020	1	1	1	1	4
OG0015021	1	1	1	1	4
OG0015022	1	1	1	1	4
OG0015023	1	1	1	1	4
OG0015024	1	1	1	1	4
OG0015025	1	1	1	1	4
OG0015026	1	1	1	1	4
OG0015027	1	1	1	1	4
OG0015028	1	1	1	1	4
OG0015029	1	1	1	1	4
OG0015030	1	1	1	1	4
OG0015031	2	1	1	0	4
OG0015032	1	1	1	1	4
OG0015033	1	2	1	0	4
OG0015034	1	1	1	1	4
OG0015035	1	1	1	1	4
OG0015036	1	1	1	1	4
OG0015037	1	1	1	1	4
OG0015038	1	1	1	1	4
OG0015039	1	1	1	1	4
OG0015040	1	1	1	1	4
OG0015041	1	1	1	1	4
OG0015042	1	1	1	1	4
OG0015043	1	1	1	1	4
OG0015044	1	1	1	1	4
OG0015045	1	1	1	1	4
OG0015046	1	1	1	1	4
OG0015047	1	1	1	1	4
OG0015048	1	1	1	1	4
OG0015049	1	1	1	1	4
OG0015050	1	1	1	1	4
OG0015051	1	1	1	1	4
OG0015052	1	1	1	1	4
OG0015053	1	1	1	1	4
OG0015054	1	1	1	1	4
OG0015055	1	1	1	1	4
OG0015056	1	1	1	1	4
OG0015057	1	1	1	1	4
OG0015058	1	1	1	1	4
OG0015059	1	1	1	1	4
OG0015060	1	1	1	1	4
OG0015061	1	1	1	1	4
OG0015062	1	1	1	1	4
OG0015063	1	1	1	1	4
OG0015064	1	1	1	1	4
OG0015065	1	1	1	1	4
OG0015066	1	1	1	1	4
OG0015067	1	1	1	1	4
OG0015068	1	1	1	1	4
OG0015069	1	1	1	1	4
OG0015070	1	1	1	1	4
OG0015071	1	1	1	1	4
OG0015072	1	1	1	1	4
OG0015073	1	1	1	1	4
OG0015074	1	1	1	1	4
OG0015075	1	1	1	1	4
OG0015076	1	1	1	1	4
OG0015077	1	1	1	1	4
OG0015078	1	1	1	1	4
OG0015079	1	1	1	1	4
OG0015080	1	1	1	1	4
OG0015081	1	1	1	1	4
OG0015082	1	1	1	1	4
OG0015083	4	0	0	0	4
OG0015084	1	1	1	1	4
OG0015085	1	1	1	1	4
OG0015086	1	1	1	1	4
OG0015087	1	1	1	1	4
OG0015088	1	1	1	1	4
OG0015089	1	1	1	1	4
OG0015090	1	1	1	1	4
OG0015091	1	1	1	1	4
OG0015092	1	1	1	1	4
OG0015093	1	1	1	1	4
OG0015094	1	1	1	1	4
OG0015095	1	1	1	1	4
OG0015096	1	1	1	1	4
OG0015097	1	1	1	1	4
OG0015098	2	0	1	1	4
OG0015099	1	1	1	1	4
OG0015100	1	1	1	1	4
OG0015101	1	1	1	1	4
OG0015102	1	1	1	1	4
OG0015103	1	1	1	1	4
OG0015104	1	1	1	1	4
OG0015105	1	1	1	1	4
OG0015106	1	1	1	1	4
OG0015107	1	1	1	1	4
OG0015108	1	1	1	1	4
OG0015109	1	1	1	1	4
OG0015110	1	1	1	1	4
OG0015111	1	1	1	1	4
OG0015112	1	1	1	1	4
OG0015113	1	1	1	1	4
OG0015114	1	1	1	1	4
OG0015115	1	1	1	1	4
OG0015116	1	1	1	1	4
OG0015117	1	1	1	1	4
OG0015118	1	1	1	1	4
OG0015119	1	1	1	1	4
OG0015120	1	1	1	1	4
OG0015121	1	1	1	1	4
OG0015122	1	1	1	1	4
OG0015123	2	1	1	0	4
OG0015124	1	1	1	1	4
OG0015125	1	1	1	1	4
OG0015126	1	1	1	1	4
OG0015127	1	1	1	1	4
OG0015128	1	1	1	1	4
OG0015129	1	1	1	1	4
OG0015130	1	1	1	1	4
OG0015131	1	1	1	1	4
OG0015132	1	1	1	1	4
OG0015133	1	1	1	1	4
OG0015134	1	1	1	1	4
OG0015135	1	1	1	1	4
OG0015136	1	1	1	1	4
OG0015137	1	1	1	1	4
OG0015138	1	1	1	1	4
OG0015139	1	1	1	1	4
OG0015140	1	1	1	1	4
OG0015141	1	1	1	1	4
OG0015142	1	1	1	1	4
OG0015143	1	1	1	1	4
OG0015144	1	1	1	1	4
OG0015145	1	1	1	1	4
OG0015146	1	1	1	1	4
OG0015147	1	1	1	1	4
OG0015148	1	1	1	1	4
OG0015149	1	1	1	1	4
OG0015150	1	1	1	1	4
OG0015151	1	1	1	1	4
OG0015152	1	1	1	1	4
OG0015153	1	1	1	1	4
OG0015154	1	1	1	1	4
OG0015155	1	1	1	1	4
OG0015156	1	1	1	1	4
OG0015157	1	1	1	1	4
OG0015158	1	1	1	1	4
OG0015159	1	1	1	1	4
OG0015160	1	1	1	1	4
OG0015161	1	1	1	1	4
OG0015162	1	1	1	1	4
OG0015163	1	1	1	1	4
OG0015164	1	1	1	1	4
OG0015165	1	1	1	1	4
OG0015166	1	1	1	1	4
OG0015167	1	1	1	1	4
OG0015168	1	1	1	1	4
OG0015169	3	1	0	0	4
OG0015170	1	1	1	1	4
OG0015171	1	1	1	1	4
OG0015172	1	1	1	1	4
OG0015173	1	1	1	1	4
OG0015174	1	1	1	1	4
OG0015175	1	1	1	1	4
OG0015176	1	1	1	1	4
OG0015177	1	1	1	1	4
OG0015178	1	1	1	1	4
OG0015179	1	1	1	1	4
OG0015180	1	1	1	1	4
OG0015181	1	1	1	1	4
OG0015182	1	1	1	1	4
OG0015183	1	0	2	1	4
OG0015184	1	1	1	1	4
OG0015185	1	1	1	1	4
OG0015186	1	1	1	1	4
OG0015187	1	1	1	1	4
OG0015188	1	1	1	1	4
OG0015189	2	0	1	1	4
OG0015190	1	1	1	1	4
OG0015191	1	1	1	1	4
OG0015192	1	1	1	1	4
OG0015193	1	1	1	1	4
OG0015194	1	1	1	1	4
OG0015195	1	3	0	0	4
OG0015196	1	1	1	1	4
OG0015197	1	1	1	1	4
OG0015198	1	1	1	1	4
OG0015199	1	1	1	1	4
OG0015200	1	1	1	1	4
OG0015201	1	1	0	2	4
OG0015202	1	1	1	1	4
OG0015203	1	0	2	1	4
OG0015204	1	1	1	1	4
OG0015205	1	1	1	1	4
OG0015206	1	1	1	1	4
OG0015207	1	1	1	1	4
OG0015208	1	1	1	1	4
OG0015209	1	1	1	1	4
OG0015210	1	1	1	1	4
OG0015211	1	1	1	1	4
OG0015212	1	1	1	1	4
OG0015213	1	1	1	1	4
OG0015214	1	1	1	1	4
OG0015215	1	1	1	1	4
OG0015216	1	1	1	1	4
OG0015217	1	1	1	1	4
OG0015218	1	1	0	2	4
OG0015219	1	1	1	1	4
OG0015220	1	1	1	1	4
OG0015221	1	1	1	1	4
OG0015222	1	1	1	1	4
OG0015223	1	1	1	1	4
OG0015224	1	1	1	1	4
OG0015225	1	1	1	1	4
OG0015226	1	1	1	1	4
OG0015227	1	1	1	1	4
OG0015228	1	1	1	1	4
OG0015229	1	1	1	1	4
OG0015230	1	1	1	1	4
OG0015231	1	1	1	1	4
OG0015232	1	1	1	1	4
OG0015233	1	1	1	1	4
OG0015234	1	1	1	1	4
OG0015235	1	1	1	1	4
OG0015236	1	1	1	1	4
OG0015237	1	1	1	1	4
OG0015238	1	1	1	1	4
OG0015239	1	1	1	1	4
OG0015240	1	1	1	1	4
OG0015241	1	1	1	1	4
OG0015242	1	1	1	1	4
OG0015243	1	1	1	1	4
OG0015244	1	1	1	1	4
OG0015245	1	1	1	1	4
OG0015246	1	1	1	1	4
OG0015247	1	1	1	1	4
OG0015248	1	1	1	1	4
OG0015249	1	1	1	1	4
OG0015250	1	1	1	1	4
OG0015251	1	1	1	1	4
OG0015252	1	2	0	1	4
OG0015253	1	1	1	1	4
OG0015254	1	1	1	1	4
OG0015255	1	1	1	1	4
OG0015256	1	1	1	1	4
OG0015257	1	1	1	1	4
OG0015258	1	1	1	1	4
OG0015259	1	1	1	1	4
OG0015260	1	1	1	1	4
OG0015261	1	1	1	1	4
OG0015262	1	1	1	1	4
OG0015263	1	1	1	1	4
OG0015264	1	1	1	1	4
OG0015265	1	1	1	1	4
OG0015266	1	1	1	1	4
OG0015267	1	1	1	1	4
OG0015268	1	1	1	1	4
OG0015269	1	1	1	1	4
OG0015270	1	1	1	1	4
OG0015271	1	1	1	1	4
OG0015272	1	1	1	1	4
OG0015273	1	1	1	1	4
OG0015274	1	1	1	1	4
OG0015275	1	1	1	1	4
OG0015276	1	1	1	1	4
OG0015277	1	1	1	1	4
OG0015278	1	1	1	1	4
OG0015279	1	1	1	1	4
OG0015280	1	1	1	1	4
OG0015281	1	1	1	1	4
OG0015282	1	2	1	0	4
OG0015283	1	1	1	1	4
OG0015284	1	1	1	1	4
OG0015285	1	1	1	1	4
OG0015286	3	1	0	0	4
OG0015287	3	1	0	0	4
OG0015288	1	1	1	1	4
OG0015289	1	1	1	1	4
OG0015290	1	1	1	1	4
OG0015291	1	1	1	1	4
OG0015292	1	1	1	1	4
OG0015293	1	1	1	1	4
OG0015294	1	1	1	1	4
OG0015295	1	1	1	1	4
OG0015296	1	1	1	1	4
OG0015297	1	1	1	1	4
OG0015298	1	1	1	1	4
OG0015299	1	1	1	1	4
OG0015300	1	1	1	1	4
OG0015301	4	0	0	0	4
OG0015302	1	1	1	1	4
OG0015303	1	1	1	1	4
OG0015304	1	1	1	1	4
OG0015305	1	1	1	1	4
OG0015306	1	1	1	1	4
OG0015307	1	1	1	1	4
OG0015308	1	1	1	1	4
OG0015309	1	1	1	1	4
OG0015310	1	1	1	1	4
OG0015311	1	1	1	1	4
OG0015312	1	1	1	1	4
OG0015313	1	1	1	1	4
OG0015314	2	2	0	0	4
OG0015315	2	0	1	1	4
OG0015316	1	1	1	1	4
OG0015317	1	1	1	1	4
OG0015318	1	1	1	1	4
OG0015319	1	1	1	1	4
OG0015320	1	1	1	1	4
OG0015321	1	1	1	1	4
OG0015322	1	1	1	1	4
OG0015323	1	1	1	1	4
OG0015324	1	1	1	1	4
OG0015325	1	1	1	1	4
OG0015326	1	1	1	1	4
OG0015327	1	1	1	1	4
OG0015328	1	1	1	1	4
OG0015329	2	2	0	0	4
OG0015330	3	0	1	0	4
OG0015331	1	1	1	1	4
OG0015332	1	1	1	1	4
OG0015333	1	1	1	1	4
OG0015334	1	1	1	1	4
OG0015335	1	1	1	1	4
OG0015336	1	1	1	1	4
OG0015337	1	1	1	1	4
OG0015338	1	1	1	1	4
OG0015339	1	1	1	1	4
OG0015340	1	1	1	1	4
OG0015341	3	1	0	0	4
OG0015342	1	1	1	1	4
OG0015343	1	1	1	1	4
OG0015344	1	1	1	1	4
OG0015345	1	1	1	1	4
OG0015346	1	1	1	1	4
OG0015347	1	1	1	1	4
OG0015348	1	1	1	1	4
OG0015349	1	1	1	1	4
OG0015350	1	1	1	1	4
OG0015351	1	1	1	1	4
OG0015352	1	1	0	2	4
OG0015353	3	1	0	0	4
OG0015354	1	1	1	1	4
OG0015355	1	1	1	1	4
OG0015356	1	1	1	1	4
OG0015357	1	1	1	1	4
OG0015358	1	1	1	1	4
OG0015359	1	1	1	1	4
OG0015360	1	1	1	1	4
OG0015361	1	1	1	1	4
OG0015362	1	1	1	1	4
OG0015363	4	0	0	0	4
OG0015364	1	1	1	1	4
OG0015365	1	1	1	1	4
OG0015366	2	2	0	0	4
OG0015367	1	1	1	1	4
OG0015368	1	1	1	1	4
OG0015369	1	1	1	1	4
OG0015370	1	1	1	1	4
OG0015371	1	1	1	1	4
OG0015372	1	1	1	1	4
OG0015373	1	3	0	0	4
OG0015374	3	1	0	0	4
OG0015375	1	1	1	1	4
OG0015376	1	1	1	1	4
OG0015377	2	1	1	0	4
OG0015378	1	1	1	1	4
OG0015379	4	0	0	0	4
OG0015380	1	1	1	1	4
OG0015381	1	1	1	1	4
OG0015382	1	1	1	1	4
OG0015383	1	1	1	1	4
OG0015384	1	1	1	1	4
OG0015385	2	0	1	1	4
OG0015386	1	1	1	1	4
OG0015387	1	1	1	1	4
OG0015388	1	1	1	1	4
OG0015389	1	1	1	1	4
OG0015390	1	1	1	1	4
OG0015391	1	0	2	1	4
OG0015392	1	1	1	1	4
OG0015393	1	1	1	1	4
OG0015394	1	1	1	1	4
OG0015395	3	1	0	0	4
OG0015396	1	1	1	1	4
OG0015397	1	1	1	1	4
OG0015398	1	1	1	1	4
OG0015399	1	1	1	1	4
OG0015400	3	1	0	0	4
OG0015401	1	1	1	1	4
OG0015402	1	1	1	1	4
OG0015403	1	1	1	1	4
OG0015404	2	2	0	0	4
OG0015405	1	1	1	1	4
OG0015406	1	1	1	1	4
OG0015407	1	1	1	1	4
OG0015408	1	1	1	1	4
OG0015409	3	1	0	0	4
OG0015410	2	0	1	1	4
OG0015411	1	1	1	1	4
OG0015412	1	1	1	1	4
OG0015413	1	1	1	1	4
OG0015414	1	1	1	1	4
OG0015415	1	1	1	1	4
OG0015416	1	1	1	1	4
OG0015417	1	1	1	1	4
OG0015418	1	3	0	0	4
OG0015419	3	1	0	0	4
OG0015420	1	1	1	1	4
OG0015421	1	1	1	1	4
OG0015422	1	1	1	1	4
OG0015423	1	1	1	1	4
OG0015424	1	1	1	1	4
OG0015425	1	1	1	1	4
OG0015426	1	1	1	1	4
OG0015427	1	1	1	1	4
OG0015428	1	3	0	0	4
OG0015429	2	2	0	0	4
OG0015430	1	1	1	1	4
OG0015431	1	1	1	1	4
OG0015432	1	1	1	1	4
OG0015433	1	1	1	1	4
OG0015434	1	1	1	1	4
OG0015435	2	1	1	0	4
OG0015436	1	1	1	1	4
OG0015437	3	1	0	0	4
OG0015438	2	2	0	0	4
OG0015439	3	1	0	0	4
OG0015440	1	1	2	0	4
OG0015441	1	1	1	1	4
OG0015442	1	1	1	1	4
OG0015443	1	1	1	1	4
OG0015444	1	1	1	1	4
OG0015445	1	1	1	1	4
OG0015446	1	1	1	1	4
OG0015447	1	1	1	1	4
OG0015448	2	2	0	0	4
OG0015449	1	1	1	1	4
OG0015450	1	1	1	1	4
OG0015451	1	1	1	1	4
OG0015452	1	1	1	1	4
OG0015453	1	1	1	1	4
OG0015454	1	1	1	1	4
OG0015455	1	1	1	1	4
OG0015456	1	3	0	0	4
OG0015457	1	1	1	1	4
OG0015458	1	1	1	1	4
OG0015459	1	1	1	1	4
OG0015460	1	3	0	0	4
OG0015461	1	1	1	1	4
OG0015462	1	1	1	1	4
OG0015463	1	1	1	1	4
OG0015464	1	1	1	1	4
OG0015465	1	1	1	1	4
OG0015466	1	1	1	1	4
OG0015467	1	1	1	1	4
OG0015468	1	1	1	1	4
OG0015469	1	2	1	0	4
OG0015470	1	1	1	1	4
OG0015471	1	1	1	1	4
OG0015472	1	1	1	1	4
OG0015473	3	1	0	0	4
OG0015474	1	1	1	1	4
OG0015475	1	1	1	1	4
OG0015476	1	1	1	1	4
OG0015477	1	1	1	1	4
OG0015478	1	1	1	1	4
OG0015479	3	1	0	0	4
OG0015480	1	1	1	1	4
OG0015481	1	1	1	1	4
OG0015482	3	1	0	0	4
OG0015483	3	1	0	0	4
OG0015484	1	1	1	1	4
OG0015485	1	1	1	1	4
OG0015486	1	1	1	1	4
OG0015487	1	1	1	1	4
OG0015488	1	1	1	1	4
OG0015489	1	1	1	1	4
OG0015490	1	3	0	0	4
OG0015491	1	1	1	1	4
OG0015492	1	1	1	1	4
OG0015493	3	1	0	0	4
OG0015494	3	0	0	1	4
OG0015495	3	1	0	0	4
OG0015496	1	1	1	1	4
OG0015497	1	1	1	1	4
OG0015498	1	1	1	1	4
OG0015499	1	1	1	1	4
OG0015500	1	1	1	1	4
OG0015501	1	1	1	1	4
OG0015502	1	1	1	1	4
OG0015503	1	2	1	0	4
OG0015504	1	1	1	1	4
OG0015505	4	0	0	0	4
OG0015506	1	1	1	1	4
OG0015507	1	1	1	1	4
OG0015508	1	1	1	1	4
OG0015509	1	3	0	0	4
OG0015510	1	1	1	1	4
OG0015511	1	1	1	1	4
OG0015512	1	1	1	1	4
OG0015513	1	1	1	1	4
OG0015514	1	1	1	1	4
OG0015515	1	1	1	1	4
OG0015516	1	1	1	1	4
OG0015517	1	1	1	1	4
OG0015518	1	1	1	1	4
OG0015519	1	1	1	1	4
OG0015520	2	2	0	0	4
OG0015521	1	1	1	1	4
OG0015522	1	1	1	1	4
OG0015523	1	1	1	1	4
OG0015524	1	1	1	1	4
OG0015525	1	1	1	1	4
OG0015526	2	2	0	0	4
OG0015527	1	1	1	1	4
OG0015528	1	1	1	1	4
OG0015529	1	1	1	1	4
OG0015530	1	1	1	1	4
OG0015531	1	1	1	1	4
OG0015532	1	1	1	1	4
OG0015533	1	1	1	1	4
OG0015534	1	1	1	1	4
OG0015535	1	1	1	1	4
OG0015536	1	1	1	1	4
OG0015537	1	1	1	1	4
OG0015538	1	1	1	1	4
OG0015539	1	1	1	1	4
OG0015540	1	1	1	1	4
OG0015541	1	1	1	1	4
OG0015542	1	1	1	1	4
OG0015543	1	1	1	1	4
OG0015544	1	1	1	1	4
OG0015545	3	1	0	0	4
OG0015546	1	1	1	1	4
OG0015547	1	1	1	1	4
OG0015548	1	0	3	0	4
OG0015549	1	1	1	1	4
OG0015550	1	1	1	1	4
OG0015551	1	1	1	1	4
OG0015552	1	1	1	1	4
OG0015553	1	1	1	1	4
OG0015554	1	1	1	1	4
OG0015555	1	1	1	1	4
OG0015556	1	1	1	1	4
OG0015557	1	1	1	1	4
OG0015558	1	1	1	1	4
OG0015559	1	1	1	1	4
OG0015560	1	1	1	1	4
OG0015561	1	1	1	1	4
OG0015562	1	1	1	1	4
OG0015563	1	1	1	1	4
OG0015564	1	1	1	1	4
OG0015565	3	1	0	0	4
OG0015566	2	1	1	0	4
OG0015567	1	1	1	1	4
OG0015568	1	1	1	1	4
OG0015569	1	1	1	1	4
OG0015570	1	1	1	1	4
OG0015571	3	1	0	0	4
OG0015572	1	1	1	1	4
OG0015573	3	0	0	1	4
OG0015574	1	1	1	1	4
OG0015575	1	1	1	1	4
OG0015576	1	1	1	1	4
OG0015577	1	1	1	1	4
OG0015578	4	0	0	0	4
OG0015579	1	1	1	1	4
OG0015580	1	1	1	1	4
OG0015581	1	1	1	1	4
OG0015582	1	1	1	1	4
OG0015583	1	1	0	2	4
OG0015584	1	1	1	1	4
OG0015585	1	1	1	1	4
OG0015586	1	1	1	1	4
OG0015587	1	1	1	1	4
OG0015588	1	1	1	1	4
OG0015589	1	1	1	1	4
OG0015590	1	3	0	0	4
OG0015591	1	1	1	1	4
OG0015592	4	0	0	0	4
OG0015593	4	0	0	0	4
OG0015594	1	1	2	0	4
OG0015595	1	1	1	1	4
OG0015596	1	1	1	1	4
OG0015597	1	1	1	1	4
OG0015598	1	1	1	1	4
OG0015599	1	1	1	1	4
OG0015600	2	2	0	0	4
OG0015601	1	3	0	0	4
OG0015602	3	1	0	0	4
OG0015603	1	1	1	1	4
OG0015604	1	1	1	1	4
OG0015605	1	1	1	1	4
OG0015606	1	1	1	1	4
OG0015607	1	1	1	1	4
OG0015608	1	1	1	1	4
OG0015609	1	1	1	1	4
OG0015610	1	1	1	1	4
OG0015611	1	1	1	1	4
OG0015612	1	1	1	1	4
OG0015613	1	1	1	1	4
OG0015614	1	1	1	1	4
OG0015615	1	1	1	1	4
OG0015616	1	1	1	1	4
OG0015617	1	1	1	1	4
OG0015618	1	1	1	1	4
OG0015619	1	1	1	1	4
OG0015620	1	1	1	1	4
OG0015621	3	1	0	0	4
OG0015622	1	1	1	1	4
OG0015623	1	1	1	1	4
OG0015624	1	3	0	0	4
OG0015625	1	1	1	1	4
OG0015626	1	1	1	1	4
OG0015627	3	1	0	0	4
OG0015628	1	1	1	1	4
OG0015629	1	3	0	0	4
OG0015630	1	1	1	1	4
OG0015631	1	1	1	1	4
OG0015632	1	1	1	1	4
OG0015633	1	1	1	1	4
OG0015634	1	1	1	1	4
OG0015635	1	1	1	1	4
OG0015636	3	1	0	0	4
OG0015637	2	2	0	0	4
OG0015638	1	1	1	1	4
OG0015639	1	1	1	1	4
OG0015640	1	1	1	1	4
OG0015641	1	1	1	1	4
OG0015642	1	1	1	1	4
OG0015643	1	1	1	1	4
OG0015644	1	1	1	1	4
OG0015645	1	1	1	1	4
OG0015646	1	3	0	0	4
OG0015647	1	1	1	1	4
OG0015648	1	1	0	2	4
OG0015649	1	1	1	1	4
OG0015650	1	1	1	1	4
OG0015651	1	1	1	1	4
OG0015652	2	0	1	1	4
OG0015653	1	1	1	1	4
OG0015654	1	1	1	1	4
OG0015655	1	1	1	1	4
OG0015656	1	1	1	1	4
OG0015657	1	1	1	1	4
OG0015658	1	1	1	1	4
OG0015659	1	1	1	1	4
OG0015660	1	1	1	1	4
OG0015661	1	1	1	1	4
OG0015662	1	1	1	1	4
OG0015663	1	1	1	1	4
OG0015664	1	2	1	0	4
OG0015665	1	0	2	1	4
OG0015666	1	3	0	0	4
OG0015667	1	1	1	1	4
OG0015668	1	1	1	1	4
OG0015669	1	1	1	1	4
OG0015670	1	1	1	1	4
OG0015671	1	1	1	1	4
OG0015672	1	0	1	2	4
OG0015673	1	1	1	1	4
OG0015674	1	1	1	1	4
OG0015675	1	0	2	1	4
OG0015676	1	1	1	1	4
OG0015677	1	1	1	1	4
OG0015678	1	1	1	1	4
OG0015679	1	1	1	1	4
OG0015680	1	1	1	1	4
OG0015681	1	1	1	1	4
OG0015682	1	1	1	1	4
OG0015683	1	1	1	1	4
OG0015684	1	1	1	1	4
OG0015685	1	1	1	1	4
OG0015686	1	1	1	1	4
OG0015687	1	1	1	1	4
OG0015688	1	1	1	1	4
OG0015689	1	1	1	1	4
OG0015690	1	1	1	1	4
OG0015691	1	1	1	1	4
OG0015692	4	0	0	0	4
OG0015693	1	1	1	1	4
OG0015694	4	0	0	0	4
OG0015695	1	1	1	1	4
OG0015696	1	1	1	1	4
OG0015697	1	1	1	1	4
OG0015698	1	1	1	1	4
OG0015699	1	1	1	1	4
OG0015700	1	1	1	1	4
OG0015701	1	1	0	2	4
OG0015702	1	3	0	0	4
OG0015703	1	1	1	1	4
OG0015704	1	1	1	1	4
OG0015705	1	1	1	1	4
OG0015706	3	1	0	0	4
OG0015707	1	1	1	1	4
OG0015708	1	1	1	1	4
OG0015709	1	1	1	1	4
OG0015710	1	1	1	1	4
OG0015711	1	1	1	1	4
OG0015712	1	1	1	1	4
OG0015713	1	1	1	1	4
OG0015714	1	1	1	1	4
OG0015715	1	0	2	1	4
OG0015716	1	1	1	1	4
OG0015717	1	1	1	1	4
OG0015718	1	1	1	1	4
OG0015719	1	1	1	1	4
OG0015720	1	1	1	1	4
OG0015721	2	1	1	0	4
OG0015722	1	1	1	1	4
OG0015723	2	0	1	1	4
OG0015724	1	1	1	1	4
OG0015725	1	1	1	1	4
OG0015726	1	1	1	1	4
OG0015727	1	1	1	1	4
OG0015728	2	0	1	1	4
OG0015729	1	1	1	1	4
OG0015730	1	1	1	1	4
OG0015731	1	1	1	1	4
OG0015732	1	1	1	1	4
OG0015733	1	1	1	1	4
OG0015734	1	1	1	1	4
OG0015735	1	1	1	1	4
OG0015736	1	1	1	1	4
OG0015737	1	1	1	1	4
OG0015738	1	1	1	1	4
OG0015739	2	0	1	1	4
OG0015740	1	1	1	1	4
OG0015741	2	0	1	1	4
OG0015742	2	1	0	1	4
OG0015743	1	1	1	1	4
OG0015744	1	1	1	1	4
OG0015745	1	1	1	1	4
OG0015746	1	1	1	1	4
OG0015747	1	1	1	1	4
OG0015748	1	1	1	1	4
OG0015749	1	1	1	1	4
OG0015750	1	1	1	1	4
OG0015751	1	1	1	1	4
OG0015752	1	1	1	1	4
OG0015753	1	1	1	1	4
OG0015754	1	1	1	1	4
OG0015755	1	1	1	1	4
OG0015756	1	1	1	1	4
OG0015757	1	1	1	1	4
OG0015758	1	2	0	1	4
OG0015759	1	1	1	1	4
OG0015760	1	1	1	1	4
OG0015761	1	1	1	1	4
OG0015762	1	1	1	1	4
OG0015763	1	1	1	1	4
OG0015764	1	1	1	1	4
OG0015765	1	1	1	1	4
OG0015766	1	1	1	1	4
OG0015767	1	1	1	1	4
OG0015768	1	1	1	1	4
OG0015769	1	1	1	1	4
OG0015770	1	1	1	1	4
OG0015771	1	1	1	1	4
OG0015772	1	1	1	1	4
OG0015773	1	1	1	1	4
OG0015774	4	0	0	0	4
OG0015775	1	1	1	1	4
OG0015776	1	1	1	1	4
OG0015777	1	1	1	1	4
OG0015778	1	1	1	1	4
OG0015779	1	1	1	1	4
OG0015780	1	1	1	1	4
OG0015781	1	0	1	2	4
OG0015782	1	1	1	1	4
OG0015783	1	1	1	1	4
OG0015784	1	1	1	1	4
OG0015785	4	0	0	0	4
OG0015786	1	1	1	1	4
OG0015787	1	1	2	0	4
OG0015788	1	1	1	1	4
OG0015789	1	1	1	1	4
OG0015790	1	1	1	1	4
OG0015791	1	1	1	1	4
OG0015792	1	1	1	1	4
OG0015793	1	1	1	1	4
OG0015794	1	1	1	1	4
OG0015795	1	1	1	1	4
OG0015796	1	1	1	1	4
OG0015797	1	1	1	1	4
OG0015798	1	1	1	1	4
OG0015799	1	1	1	1	4
OG0015800	1	1	1	1	4
OG0015801	2	0	1	1	4
OG0015802	1	1	1	1	4
OG0015803	1	1	1	1	4
OG0015804	1	1	1	1	4
OG0015805	1	1	1	1	4
OG0015806	1	1	1	1	4
OG0015807	1	1	1	1	4
OG0015808	1	1	1	1	4
OG0015809	1	1	1	1	4
OG0015810	1	1	1	1	4
OG0015811	1	1	1	1	4
OG0015812	1	1	1	1	4
OG0015813	1	1	1	1	4
OG0015814	1	1	1	1	4
OG0015815	1	1	1	1	4
OG0015816	1	1	1	1	4
OG0015817	1	1	1	1	4
OG0015818	1	1	1	1	4
OG0015819	1	1	1	1	4
OG0015820	1	1	1	1	4
OG0015821	1	1	1	1	4
OG0015822	1	1	1	1	4
OG0015823	1	1	1	1	4
OG0015824	1	1	1	1	4
OG0015825	1	1	1	1	4
OG0015826	1	1	1	1	4
OG0015827	1	1	1	1	4
OG0015828	1	1	1	1	4
OG0015829	1	0	2	1	4
OG0015830	1	1	1	1	4
OG0015831	1	1	1	1	4
OG0015832	1	1	1	1	4
OG0015833	1	1	1	1	4
OG0015834	1	1	1	1	4
OG0015835	1	1	1	1	4
OG0015836	1	1	1	1	4
OG0015837	1	1	1	1	4
OG0015838	1	1	1	1	4
OG0015839	1	1	1	1	4
OG0015840	1	1	1	1	4
OG0015841	1	1	1	1	4
OG0015842	1	1	1	1	4
OG0015843	1	1	1	1	4
OG0015844	1	1	1	1	4
OG0015845	1	1	1	1	4
OG0015846	1	1	1	1	4
OG0015847	1	1	1	1	4
OG0015848	1	1	1	1	4
OG0015849	1	1	1	1	4
OG0015850	1	1	1	1	4
OG0015851	1	1	1	1	4
OG0015852	1	1	1	1	4
OG0015853	1	1	1	1	4
OG0015854	1	1	1	1	4
OG0015855	1	1	1	1	4
OG0015856	1	1	1	1	4
OG0015857	1	1	1	1	4
OG0015858	1	0	1	2	4
OG0015859	1	1	1	1	4
OG0015860	1	1	1	1	4
OG0015861	1	1	1	1	4
OG0015862	1	1	1	1	4
OG0015863	1	1	1	1	4
OG0015864	1	1	1	1	4
OG0015865	1	1	1	1	4
OG0015866	1	1	1	1	4
OG0015867	1	1	1	1	4
OG0015868	1	1	1	1	4
OG0015869	1	1	1	1	4
OG0015870	1	1	1	1	4
OG0015871	1	1	1	1	4
OG0015872	1	1	1	1	4
OG0015873	1	1	1	1	4
OG0015874	1	1	1	1	4
OG0015875	1	1	1	1	4
OG0015876	1	1	1	1	4
OG0015877	1	1	1	1	4
OG0015878	1	1	1	1	4
OG0015879	1	1	1	1	4
OG0015880	1	1	1	1	4
OG0015881	1	1	1	1	4
OG0015882	1	0	2	1	4
OG0015883	1	1	1	1	4
OG0015884	1	1	1	1	4
OG0015885	1	1	1	1	4
OG0015886	1	1	1	1	4
OG0015887	1	1	1	1	4
OG0015888	1	1	1	1	4
OG0015889	1	1	1	1	4
OG0015890	1	1	1	1	4
OG0015891	1	1	1	1	4
OG0015892	1	1	1	1	4
OG0015893	1	1	1	1	4
OG0015894	1	1	1	1	4
OG0015895	2	1	0	1	4
OG0015896	1	1	1	1	4
OG0015897	1	1	1	1	4
OG0015898	1	1	1	1	4
OG0015899	1	1	1	1	4
OG0015900	1	1	1	1	4
OG0015901	1	1	1	1	4
OG0015902	1	1	1	1	4
OG0015903	1	1	1	1	4
OG0015904	1	1	1	1	4
OG0015905	1	1	1	1	4
OG0015906	1	1	1	1	4
OG0015907	1	1	1	1	4
OG0015908	1	1	1	1	4
OG0015909	1	1	1	1	4
OG0015910	1	1	1	1	4
OG0015911	1	1	1	1	4
OG0015912	1	1	1	1	4
OG0015913	1	1	1	1	4
OG0015914	1	1	1	1	4
OG0015915	1	1	1	1	4
OG0015916	1	1	1	1	4
OG0015917	1	1	1	1	4
OG0015918	1	1	1	1	4
OG0015919	1	1	1	1	4
OG0015920	1	1	1	1	4
OG0015921	1	1	1	1	4
OG0015922	1	1	1	1	4
OG0015923	1	1	1	1	4
OG0015924	1	1	1	1	4
OG0015925	1	1	1	1	4
OG0015926	1	1	1	1	4
OG0015927	1	1	1	1	4
OG0015928	1	1	1	1	4
OG0015929	1	1	1	1	4
OG0015930	1	1	1	1	4
OG0015931	1	1	0	2	4
OG0015932	1	1	1	1	4
OG0015933	1	1	1	1	4
OG0015934	1	1	1	1	4
OG0015935	1	1	1	1	4
OG0015936	1	1	1	1	4
OG0015937	1	1	1	1	4
OG0015938	1	1	1	1	4
OG0015939	1	0	1	2	4
OG0015940	1	1	1	1	4
OG0015941	1	1	1	1	4
OG0015942	1	1	1	1	4
OG0015943	1	1	1	1	4
OG0015944	1	1	1	1	4
OG0015945	1	1	1	1	4
OG0015946	1	0	2	1	4
OG0015947	1	0	2	1	4
OG0015948	1	1	1	1	4
OG0015949	1	1	1	1	4
OG0015950	2	0	1	1	4
OG0015951	1	1	1	1	4
OG0015952	1	1	1	1	4
OG0015953	1	1	1	1	4
OG0015954	1	1	1	1	4
OG0015955	1	1	1	1	4
OG0015956	1	1	1	1	4
OG0015957	1	1	1	1	4
OG0015958	1	1	1	1	4
OG0015959	1	1	1	1	4
OG0015960	1	1	1	1	4
OG0015961	1	0	1	2	4
OG0015962	1	1	1	1	4
OG0015963	1	1	1	1	4
OG0015964	1	1	1	1	4
OG0015965	1	1	1	1	4
OG0015966	1	1	1	1	4
OG0015967	1	1	1	1	4
OG0015968	1	1	1	1	4
OG0015969	1	1	1	1	4
OG0015970	1	1	1	1	4
OG0015971	1	1	1	1	4
OG0015972	1	1	1	1	4
OG0015973	1	1	1	1	4
OG0015974	1	1	1	1	4
OG0015975	1	1	1	1	4
OG0015976	1	1	1	1	4
OG0015977	1	1	1	1	4
OG0015978	1	1	1	1	4
OG0015979	1	1	1	1	4
OG0015980	2	0	1	1	4
OG0015981	1	1	1	1	4
OG0015982	1	1	1	1	4
OG0015983	1	1	1	1	4
OG0015984	1	1	1	1	4
OG0015985	1	1	1	1	4
OG0015986	1	1	1	1	4
OG0015987	1	1	1	1	4
OG0015988	1	1	1	1	4
OG0015989	1	1	1	1	4
OG0015990	1	1	1	1	4
OG0015991	3	1	0	0	4
OG0015992	1	1	1	1	4
OG0015993	1	1	1	1	4
OG0015994	2	1	1	0	4
OG0015995	1	1	1	1	4
OG0015996	1	1	1	1	4
OG0015997	1	1	1	1	4
OG0015998	1	1	1	1	4
OG0015999	1	1	1	1	4
OG0016000	1	1	1	1	4
OG0016001	1	1	1	1	4
OG0016002	1	1	1	1	4
OG0016003	1	1	1	1	4
OG0016004	1	1	1	1	4
OG0016005	1	1	1	1	4
OG0016006	1	1	1	1	4
OG0016007	1	1	1	1	4
OG0016008	1	1	1	1	4
OG0016009	1	1	1	1	4
OG0016010	1	1	1	1	4
OG0016011	1	1	1	1	4
OG0016012	1	1	1	1	4
OG0016013	1	1	1	1	4
OG0016014	1	0	1	2	4
OG0016015	1	1	1	1	4
OG0016016	1	1	1	1	4
OG0016017	1	1	1	1	4
OG0016018	1	1	1	1	4
OG0016019	1	1	1	1	4
OG0016020	1	1	1	1	4
OG0016021	1	1	1	1	4
OG0016022	1	1	1	1	4
OG0016023	1	1	1	1	4
OG0016024	1	1	1	1	4
OG0016025	1	1	1	1	4
OG0016026	1	1	1	1	4
OG0016027	1	1	1	1	4
OG0016028	1	1	1	1	4
OG0016029	1	1	1	1	4
OG0016030	1	1	1	1	4
OG0016031	1	1	1	1	4
OG0016032	1	1	1	1	4
OG0016033	3	1	0	0	4
OG0016034	1	1	1	1	4
OG0016035	1	1	1	1	4
OG0016036	1	1	1	1	4
OG0016037	1	1	1	1	4
OG0016038	1	1	1	1	4
OG0016039	1	1	1	1	4
OG0016040	1	1	1	1	4
OG0016041	1	1	1	1	4
OG0016042	1	1	1	1	4
OG0016043	1	1	1	1	4
OG0016044	1	1	1	1	4
OG0016045	1	1	1	1	4
OG0016046	1	1	1	1	4
OG0016047	1	1	1	1	4
OG0016048	1	1	1	1	4
OG0016049	1	1	1	1	4
OG0016050	1	1	1	1	4
OG0016051	1	1	1	1	4
OG0016052	1	1	1	1	4
OG0016053	1	1	1	1	4
OG0016054	1	1	1	1	4
OG0016055	1	1	1	1	4
OG0016056	1	1	1	1	4
OG0016057	1	1	1	1	4
OG0016058	1	1	1	1	4
OG0016059	1	1	1	1	4
OG0016060	1	1	1	1	4
OG0016061	1	1	1	1	4
OG0016062	1	1	1	1	4
OG0016063	1	1	1	1	4
OG0016064	1	1	1	1	4
OG0016065	1	1	1	1	4
OG0016066	1	1	1	1	4
OG0016067	1	0	0	3	4
OG0016068	1	1	1	1	4
OG0016069	1	1	1	1	4
OG0016070	1	1	1	1	4
OG0016071	1	1	1	1	4
OG0016072	1	1	1	1	4
OG0016073	1	1	1	1	4
OG0016074	1	1	1	1	4
OG0016075	1	1	1	1	4
OG0016076	1	1	1	1	4
OG0016077	1	1	1	1	4
OG0016078	1	1	1	1	4
OG0016079	1	1	1	1	4
OG0016080	1	1	1	1	4
OG0016081	1	1	1	1	4
OG0016082	1	1	1	1	4
OG0016083	1	1	1	1	4
OG0016084	1	1	1	1	4
OG0016085	1	1	1	1	4
OG0016086	1	1	1	1	4
OG0016087	1	1	1	1	4
OG0016088	1	1	1	1	4
OG0016089	1	1	1	1	4
OG0016090	1	1	1	1	4
OG0016091	1	1	1	1	4
OG0016092	1	1	1	1	4
OG0016093	1	1	1	1	4
OG0016094	1	1	1	1	4
OG0016095	1	1	1	1	4
OG0016096	1	1	1	1	4
OG0016097	1	1	1	1	4
OG0016098	1	1	1	1	4
OG0016099	1	1	1	1	4
OG0016100	1	1	1	1	4
OG0016101	1	1	1	1	4
OG0016102	1	1	1	1	4
OG0016103	1	1	1	1	4
OG0016104	1	1	1	1	4
OG0016105	1	1	1	1	4
OG0016106	1	1	1	1	4
OG0016107	1	1	1	1	4
OG0016108	1	1	1	1	4
OG0016109	1	1	1	1	4
OG0016110	1	1	1	1	4
OG0016111	1	1	1	1	4
OG0016112	1	1	1	1	4
OG0016113	1	1	1	1	4
OG0016114	1	1	1	1	4
OG0016115	1	1	1	1	4
OG0016116	1	1	1	1	4
OG0016117	1	1	1	1	4
OG0016118	1	1	1	1	4
OG0016119	1	1	1	1	4
OG0016120	1	1	1	1	4
OG0016121	1	1	1	1	4
OG0016122	1	1	1	1	4
OG0016123	1	1	1	1	4
OG0016124	1	1	1	1	4
OG0016125	1	1	1	1	4
OG0016126	1	1	1	1	4
OG0016127	1	1	1	1	4
OG0016128	1	1	1	1	4
OG0016129	1	1	2	0	4
OG0016130	1	1	1	1	4
OG0016131	1	0	2	1	4
OG0016132	1	1	1	1	4
OG0016133	1	1	1	1	4
OG0016134	1	1	1	1	4
OG0016135	1	1	1	1	4
OG0016136	1	1	1	1	4
OG0016137	1	1	1	1	4
OG0016138	1	1	1	1	4
OG0016139	1	1	1	1	4
OG0016140	1	1	1	1	4
OG0016141	1	1	1	1	4
OG0016142	1	1	1	1	4
OG0016143	1	1	1	1	4
OG0016144	1	1	1	1	4
OG0016145	1	1	1	1	4
OG0016146	1	1	1	1	4
OG0016147	1	1	1	1	4
OG0016148	1	1	1	1	4
OG0016149	1	1	1	1	4
OG0016150	1	1	1	1	4
OG0016151	1	1	1	1	4
OG0016152	1	1	1	1	4
OG0016153	1	1	1	1	4
OG0016154	1	1	1	1	4
OG0016155	1	1	1	1	4
OG0016156	1	1	1	1	4
OG0016157	1	1	1	1	4
OG0016158	1	1	1	1	4
OG0016159	1	1	1	1	4
OG0016160	1	0	0	3	4
OG0016161	1	1	1	1	4
OG0016162	1	1	1	1	4
OG0016163	1	1	1	1	4
OG0016164	1	1	1	1	4
OG0016165	1	1	1	1	4
OG0016166	1	1	1	1	4
OG0016167	1	1	1	1	4
OG0016168	1	1	1	1	4
OG0016169	1	1	1	1	4
OG0016170	1	1	1	1	4
OG0016171	1	1	1	1	4
OG0016172	1	1	1	1	4
OG0016173	1	1	1	1	4
OG0016174	1	1	1	1	4
OG0016175	1	1	1	1	4
OG0016176	1	1	1	1	4
OG0016177	1	1	1	1	4
OG0016178	1	1	1	1	4
OG0016179	1	1	1	1	4
OG0016180	2	2	0	0	4
OG0016181	1	1	1	1	4
OG0016182	1	1	1	1	4
OG0016183	1	1	1	1	4
OG0016184	1	1	1	1	4
OG0016185	1	1	1	1	4
OG0016186	1	1	1	1	4
OG0016187	1	1	1	1	4
OG0016188	1	1	1	1	4
OG0016189	1	1	1	1	4
OG0016190	1	1	1	1	4
OG0016191	1	1	1	1	4
OG0016192	1	1	1	1	4
OG0016193	1	1	1	1	4
OG0016194	1	1	1	1	4
OG0016195	1	1	1	1	4
OG0016196	1	1	1	1	4
OG0016197	1	1	1	1	4
OG0016198	1	1	1	1	4
OG0016199	1	1	1	1	4
OG0016200	1	1	1	1	4
OG0016201	1	1	1	1	4
OG0016202	1	1	1	1	4
OG0016203	1	1	1	1	4
OG0016204	1	1	1	1	4
OG0016205	1	1	1	1	4
OG0016206	1	1	1	1	4
OG0016207	1	1	1	1	4
OG0016208	1	1	1	1	4
OG0016209	1	1	1	1	4
OG0016210	1	1	1	1	4
OG0016211	1	1	1	1	4
OG0016212	1	1	1	1	4
OG0016213	1	1	1	1	4
OG0016214	1	1	1	1	4
OG0016215	1	1	1	1	4
OG0016216	1	1	1	1	4
OG0016217	1	1	1	1	4
OG0016218	1	1	1	1	4
OG0016219	1	1	1	1	4
OG0016220	1	1	1	1	4
OG0016221	1	1	1	1	4
OG0016222	1	1	1	1	4
OG0016223	1	1	1	1	4
OG0016224	1	1	1	1	4
OG0016225	1	1	1	1	4
OG0016226	1	1	1	1	4
OG0016227	1	1	1	1	4
OG0016228	1	1	1	1	4
OG0016229	1	1	1	1	4
OG0016230	1	1	1	1	4
OG0016231	1	1	1	1	4
OG0016232	1	1	1	1	4
OG0016233	1	1	1	1	4
OG0016234	1	1	2	0	4
OG0016235	1	1	1	1	4
OG0016236	1	1	1	1	4
OG0016237	1	1	1	1	4
OG0016238	1	1	1	1	4
OG0016239	1	1	1	1	4
OG0016240	1	1	1	1	4
OG0016241	1	1	1	1	4
OG0016242	1	1	1	1	4
OG0016243	1	1	1	1	4
OG0016244	1	1	1	1	4
OG0016245	1	1	1	1	4
OG0016246	1	1	1	1	4
OG0016247	1	1	1	1	4
OG0016248	1	1	1	1	4
OG0016249	1	1	1	1	4
OG0016250	1	3	0	0	4
OG0016251	1	1	1	1	4
OG0016252	1	1	1	1	4
OG0016253	1	1	1	1	4
OG0016254	1	1	1	1	4
OG0016255	1	1	1	1	4
OG0016256	1	1	1	1	4
OG0016257	1	1	1	1	4
OG0016258	1	1	1	1	4
OG0016259	1	1	1	1	4
OG0016260	1	1	1	1	4
OG0016261	1	1	1	1	4
OG0016262	1	1	1	1	4
OG0016263	1	1	1	1	4
OG0016264	1	1	1	1	4
OG0016265	1	1	1	1	4
OG0016266	3	1	0	0	4
OG0016267	1	1	0	2	4
OG0016268	1	1	1	1	4
OG0016269	1	1	1	1	4
OG0016270	1	1	1	1	4
OG0016271	1	1	1	1	4
OG0016272	1	1	1	1	4
OG0016273	1	1	1	1	4
OG0016274	1	1	1	1	4
OG0016275	1	1	1	1	4
OG0016276	1	1	1	1	4
OG0016277	1	1	1	1	4
OG0016278	1	1	1	1	4
OG0016279	1	1	1	1	4
OG0016280	1	1	1	1	4
OG0016281	1	1	1	1	4
OG0016282	1	1	1	1	4
OG0016283	1	1	1	1	4
OG0016284	1	1	1	1	4
OG0016285	1	1	1	1	4
OG0016286	1	1	1	1	4
OG0016287	1	1	1	1	4
OG0016288	1	1	1	1	4
OG0016289	1	1	1	1	4
OG0016290	1	1	1	1	4
OG0016291	1	1	1	1	4
OG0016292	1	1	1	1	4
OG0016293	1	1	1	1	4
OG0016294	1	1	1	1	4
OG0016295	1	1	1	1	4
OG0016296	1	1	1	1	4
OG0016297	1	1	1	1	4
OG0016298	1	1	1	1	4
OG0016299	1	1	1	1	4
OG0016300	1	1	1	1	4
OG0016301	1	1	1	1	4
OG0016302	1	1	1	1	4
OG0016303	1	1	1	1	4
OG0016304	1	1	1	1	4
OG0016305	1	1	1	1	4
OG0016306	1	1	1	1	4
OG0016307	1	1	1	1	4
OG0016308	1	1	1	1	4
OG0016309	1	1	1	1	4
OG0016310	1	1	1	1	4
OG0016311	1	1	1	1	4
OG0016312	1	1	1	1	4
OG0016313	1	1	1	1	4
OG0016314	1	1	1	1	4
OG0016315	1	1	1	1	4
OG0016316	1	1	1	1	4
OG0016317	1	1	1	1	4
OG0016318	1	3	0	0	4
OG0016319	1	1	1	1	4
OG0016320	1	0	2	1	4
OG0016321	1	1	1	1	4
OG0016322	1	1	1	1	4
OG0016323	1	1	1	1	4
OG0016324	1	1	1	1	4
OG0016325	1	1	1	1	4
OG0016326	1	1	1	1	4
OG0016327	1	1	1	1	4
OG0016328	1	1	1	1	4
OG0016329	1	1	1	1	4
OG0016330	1	1	1	1	4
OG0016331	1	1	1	1	4
OG0016332	1	1	1	1	4
OG0016333	1	1	1	1	4
OG0016334	1	1	1	1	4
OG0016335	1	1	1	1	4
OG0016336	1	1	1	1	4
OG0016337	1	1	1	1	4
OG0016338	1	1	1	1	4
OG0016339	3	1	0	0	4
OG0016340	1	1	1	1	4
OG0016341	1	1	1	1	4
OG0016342	1	1	1	1	4
OG0016343	1	1	1	1	4
OG0016344	2	0	1	1	4
OG0016345	1	1	1	1	4
OG0016346	1	1	1	1	4
OG0016347	1	1	1	1	4
OG0016348	1	1	1	1	4
OG0016349	1	1	1	1	4
OG0016350	1	1	1	1	4
OG0016351	1	1	1	1	4
OG0016352	1	1	1	1	4
OG0016353	1	1	1	1	4
OG0016354	1	1	1	1	4
OG0016355	1	1	1	1	4
OG0016356	1	1	1	1	4
OG0016357	1	1	1	1	4
OG0016358	1	1	1	1	4
OG0016359	1	1	1	1	4
OG0016360	1	1	1	1	4
OG0016361	1	1	1	1	4
OG0016362	1	1	1	1	4
OG0016363	1	1	1	1	4
OG0016364	2	2	0	0	4
OG0016365	4	0	0	0	4
OG0016366	1	1	1	1	4
OG0016367	1	1	1	1	4
OG0016368	1	1	1	1	4
OG0016369	1	1	1	1	4
OG0016370	1	1	1	1	4
OG0016371	1	1	1	1	4
OG0016372	1	1	1	1	4
OG0016373	1	1	1	1	4
OG0016374	1	1	1	1	4
OG0016375	1	1	1	1	4
OG0016376	1	1	1	1	4
OG0016377	1	1	1	1	4
OG0016378	1	1	0	2	4
OG0016379	4	0	0	0	4
OG0016380	1	1	1	1	4
OG0016381	1	1	1	1	4
OG0016382	1	1	1	1	4
OG0016383	1	1	1	1	4
OG0016384	1	0	1	2	4
OG0016385	1	1	1	1	4
OG0016386	1	1	1	1	4
OG0016387	1	1	1	1	4
OG0016388	1	1	1	1	4
OG0016389	1	1	1	1	4
OG0016390	1	1	1	1	4
OG0016391	1	1	1	1	4
OG0016392	1	1	1	1	4
OG0016393	1	1	1	1	4
OG0016394	1	1	1	1	4
OG0016395	1	1	1	1	4
OG0016396	1	1	1	1	4
OG0016397	1	1	1	1	4
OG0016398	1	3	0	0	4
OG0016399	1	1	1	1	4
OG0016400	1	1	1	1	4
OG0016401	1	1	1	1	4
OG0016402	1	1	1	1	4
OG0016403	1	1	1	1	4
OG0016404	1	1	1	1	4
OG0016405	1	1	1	1	4
OG0016406	1	1	1	1	4
OG0016407	1	1	1	1	4
OG0016408	1	3	0	0	4
OG0016409	1	1	1	1	4
OG0016410	1	1	1	1	4
OG0016411	1	1	1	1	4
OG0016412	1	1	1	1	4
OG0016413	1	1	1	1	4
OG0016414	1	1	1	1	4
OG0016415	1	1	1	1	4
OG0016416	1	1	1	1	4
OG0016417	1	1	1	1	4
OG0016418	1	1	1	1	4
OG0016419	1	1	1	1	4
OG0016420	1	1	1	1	4
OG0016421	1	1	1	1	4
OG0016422	1	1	1	1	4
OG0016423	1	1	1	1	4
OG0016424	1	1	1	1	4
OG0016425	1	1	1	1	4
OG0016426	1	1	1	1	4
OG0016427	1	1	1	1	4
OG0016428	1	1	1	1	4
OG0016429	1	1	1	1	4
OG0016430	1	1	1	1	4
OG0016431	1	1	1	1	4
OG0016432	1	1	1	1	4
OG0016433	1	1	1	1	4
OG0016434	1	1	1	1	4
OG0016435	1	1	1	1	4
OG0016436	1	1	1	1	4
OG0016437	1	1	1	1	4
OG0016438	1	1	1	1	4
OG0016439	1	1	1	1	4
OG0016440	1	1	1	1	4
OG0016441	1	1	1	1	4
OG0016442	1	1	1	1	4
OG0016443	1	1	1	1	4
OG0016444	1	1	1	1	4
OG0016445	1	1	1	1	4
OG0016446	1	1	1	1	4
OG0016447	1	1	1	1	4
OG0016448	1	1	1	1	4
OG0016449	1	1	1	1	4
OG0016450	1	1	1	1	4
OG0016451	1	1	1	1	4
OG0016452	1	1	1	1	4
OG0016453	1	1	1	1	4
OG0016454	1	1	1	1	4
OG0016455	1	1	1	1	4
OG0016456	1	1	1	1	4
OG0016457	1	1	1	1	4
OG0016458	1	1	1	1	4
OG0016459	1	1	1	1	4
OG0016460	1	1	1	1	4
OG0016461	1	0	2	1	4
OG0016462	1	1	1	1	4
OG0016463	1	1	1	1	4
OG0016464	1	1	1	1	4
OG0016465	1	1	1	1	4
OG0016466	4	0	0	0	4
OG0016467	1	1	1	1	4
OG0016468	2	2	0	0	4
OG0016469	1	1	1	1	4
OG0016470	1	1	2	0	4
OG0016471	1	1	1	1	4
OG0016472	1	1	1	1	4
OG0016473	1	1	1	1	4
OG0016474	1	1	1	1	4
OG0016475	3	1	0	0	4
OG0016476	1	1	1	1	4
OG0016477	1	1	1	1	4
OG0016478	1	0	1	2	4
OG0016479	2	2	0	0	4
OG0016480	1	1	1	1	4
OG0016481	1	0	2	1	4
OG0016482	1	1	1	1	4
OG0016483	1	1	1	1	4
OG0016484	1	1	1	1	4
OG0016485	1	1	1	1	4
OG0016486	3	1	0	0	4
OG0016487	2	0	1	1	4
OG0016488	1	1	1	1	4
OG0016489	1	1	1	1	4
OG0016490	2	2	0	0	4
OG0016491	1	1	1	1	4
OG0016492	1	3	0	0	4
OG0016493	1	1	1	1	4
OG0016494	1	1	1	1	4
OG0016495	1	1	1	1	4
OG0016496	1	1	1	1	4
OG0016497	1	1	1	1	4
OG0016498	1	1	1	1	4
OG0016499	1	1	1	1	4
OG0016500	1	1	1	1	4
OG0016501	1	1	1	1	4
OG0016502	1	1	1	1	4
OG0016503	1	1	1	1	4
OG0016504	1	1	1	1	4
OG0016505	1	1	1	1	4
OG0016506	1	1	1	1	4
OG0016507	1	1	1	1	4
OG0016508	1	1	1	1	4
OG0016509	1	1	1	1	4
OG0016510	1	1	1	1	4
OG0016511	1	1	1	1	4
OG0016512	1	1	1	1	4
OG0016513	1	1	1	1	4
OG0016514	1	1	1	1	4
OG0016515	1	3	0	0	4
OG0016516	2	2	0	0	4
OG0016517	4	0	0	0	4
OG0016518	1	1	1	1	4
OG0016519	3	1	0	0	4
OG0016520	1	1	1	1	4
OG0016521	1	1	1	1	4
OG0016522	1	1	1	1	4
OG0016523	4	0	0	0	4
OG0016524	1	1	1	1	4
OG0016525	1	1	1	1	4
OG0016526	1	1	1	1	4
OG0016527	1	1	1	1	4
OG0016528	1	1	1	1	4
OG0016529	1	1	1	1	4
OG0016530	1	1	1	1	4
OG0016531	1	1	1	1	4
OG0016532	1	1	1	1	4
OG0016533	1	1	1	1	4
OG0016534	2	2	0	0	4
OG0016535	1	1	1	1	4
OG0016536	1	1	1	1	4
OG0016537	1	1	1	1	4
OG0016538	1	1	1	1	4
OG0016539	1	1	1	1	4
OG0016540	3	1	0	0	4
OG0016541	3	1	0	0	4
OG0016542	1	3	0	0	4
OG0016543	1	0	2	1	4
OG0016544	1	3	0	0	4
OG0016545	1	1	0	2	4
OG0016546	1	1	1	1	4
OG0016547	1	1	1	1	4
OG0016548	1	1	1	1	4
OG0016549	1	1	1	1	4
OG0016550	2	2	0	0	4
OG0016551	1	1	1	1	4
OG0016552	1	1	1	1	4
OG0016553	4	0	0	0	4
OG0016554	1	1	1	1	4
OG0016555	1	1	1	1	4
OG0016556	1	1	1	1	4
OG0016557	1	1	1	1	4
OG0016558	1	1	1	1	4
OG0016559	1	1	1	1	4
OG0016560	1	1	1	1	4
OG0016561	1	1	1	1	4
OG0016562	1	2	1	0	4
OG0016563	1	1	1	1	4
OG0016564	1	1	1	1	4
OG0016565	1	1	1	1	4
OG0016566	1	1	1	1	4
OG0016567	1	1	1	1	4
OG0016568	1	1	1	1	4
OG0016569	1	1	1	1	4
OG0016570	1	1	1	1	4
OG0016571	1	1	1	1	4
OG0016572	1	1	1	1	4
OG0016573	1	1	1	1	4
OG0016574	1	1	1	1	4
OG0016575	1	1	1	1	4
OG0016576	1	1	1	1	4
OG0016577	1	1	1	1	4
OG0016578	3	1	0	0	4
OG0016579	1	1	1	1	4
OG0016580	1	1	1	1	4
OG0016581	1	1	1	1	4
OG0016582	2	1	1	0	4
OG0016583	1	1	1	1	4
OG0016584	1	1	1	1	4
OG0016585	1	1	1	1	4
OG0016586	1	1	1	1	4
OG0016587	1	1	1	1	4
OG0016588	1	1	1	1	4
OG0016589	4	0	0	0	4
OG0016590	4	0	0	0	4
OG0016591	1	1	1	1	4
OG0016592	1	1	1	1	4
OG0016593	1	1	1	1	4
OG0016594	1	1	1	1	4
OG0016595	1	1	1	1	4
OG0016596	1	1	1	1	4
OG0016597	1	1	1	1	4
OG0016598	1	1	1	1	4
OG0016599	1	0	1	2	4
OG0016600	1	1	1	1	4
OG0016601	1	1	1	1	4
OG0016602	1	1	1	1	4
OG0016603	1	1	1	1	4
OG0016604	1	1	1	1	4
OG0016605	1	1	1	1	4
OG0016606	1	1	1	1	4
OG0016607	1	1	1	1	4
OG0016608	1	1	1	1	4
OG0016609	1	1	1	1	4
OG0016610	1	1	1	1	4
OG0016611	1	1	1	1	4
OG0016612	1	1	1	1	4
OG0016613	1	1	1	1	4
OG0016614	1	1	1	1	4
OG0016615	1	1	1	1	4
OG0016616	1	1	1	1	4
OG0016617	1	1	1	1	4
OG0016618	1	1	1	1	4
OG0016619	1	1	1	1	4
OG0016620	1	1	1	1	4
OG0016621	1	1	1	1	4
OG0016622	1	1	1	1	4
OG0016623	1	1	1	1	4
OG0016624	1	1	1	1	4
OG0016625	2	1	1	0	4
OG0016626	1	1	1	1	4
OG0016627	1	1	1	1	4
OG0016628	1	1	1	1	4
OG0016629	1	1	1	1	4
OG0016630	1	1	1	1	4
OG0016631	1	1	1	1	4
OG0016632	1	1	1	1	4
OG0016633	1	1	1	1	4
OG0016634	1	1	1	1	4
OG0016635	1	1	1	1	4
OG0016636	1	1	1	1	4
OG0016637	1	0	2	1	4
OG0016638	2	0	1	1	4
OG0016639	2	1	1	0	4
OG0016640	1	1	1	1	4
OG0016641	1	1	1	1	4
OG0016642	1	1	1	1	4
OG0016643	1	1	1	1	4
OG0016644	1	1	1	1	4
OG0016645	1	1	1	1	4
OG0016646	1	1	1	1	4
OG0016647	1	1	1	1	4
OG0016648	1	1	1	1	4
OG0016649	1	1	1	1	4
OG0016650	1	1	1	1	4
OG0016651	1	1	1	1	4
OG0016652	2	0	2	0	4
OG0016653	1	1	1	1	4
OG0016654	1	1	1	1	4
OG0016655	1	1	1	1	4
OG0016656	1	1	1	1	4
OG0016657	1	1	1	1	4
OG0016658	1	1	1	1	4
OG0016659	1	1	1	1	4
OG0016660	1	1	1	1	4
OG0016661	1	1	1	1	4
OG0016662	1	1	1	1	4
OG0016663	1	1	1	1	4
OG0016664	1	0	2	1	4
OG0016665	2	2	0	0	4
OG0016666	1	1	1	1	4
OG0016667	1	1	1	1	4
OG0016668	1	1	1	1	4
OG0016669	1	1	1	1	4
OG0016670	1	1	1	1	4
OG0016671	1	1	1	1	4
OG0016672	1	1	1	1	4
OG0016673	1	1	1	1	4
OG0016674	1	1	1	1	4
OG0016675	1	1	1	1	4
OG0016676	1	1	1	1	4
OG0016677	1	1	1	1	4
OG0016678	1	1	1	1	4
OG0016679	1	1	1	1	4
OG0016680	1	1	1	1	4
OG0016681	1	0	1	2	4
OG0016682	1	0	2	1	4
OG0016683	1	1	1	1	4
OG0016684	1	1	1	1	4
OG0016685	1	1	1	1	4
OG0016686	1	1	1	1	4
OG0016687	1	1	1	1	4
OG0016688	1	1	1	1	4
OG0016689	1	1	1	1	4
OG0016690	1	1	1	1	4
OG0016691	1	1	1	1	4
OG0016692	1	1	0	2	4
OG0016693	1	1	1	1	4
OG0016694	1	1	1	1	4
OG0016695	1	1	1	1	4
OG0016696	1	1	1	1	4
OG0016697	1	1	1	1	4
OG0016698	1	1	1	1	4
OG0016699	1	1	1	1	4
OG0016700	1	1	1	1	4
OG0016701	1	1	1	1	4
OG0016702	1	1	1	1	4
OG0016703	1	1	1	1	4
OG0016704	1	1	1	1	4
OG0016705	1	1	1	1	4
OG0016706	1	1	1	1	4
OG0016707	1	1	1	1	4
OG0016708	1	1	1	1	4
OG0016709	1	1	1	1	4
OG0016710	1	1	1	1	4
OG0016711	1	1	1	1	4
OG0016712	1	1	1	1	4
OG0016713	1	1	1	1	4
OG0016714	1	1	1	1	4
OG0016715	1	1	1	1	4
OG0016716	1	1	1	1	4
OG0016717	1	1	1	1	4
OG0016718	1	1	1	1	4
OG0016719	1	1	1	1	4
OG0016720	1	1	1	1	4
OG0016721	1	1	1	1	4
OG0016722	1	1	1	1	4
OG0016723	1	1	1	1	4
OG0016724	1	1	1	1	4
OG0016725	1	1	1	1	4
OG0016726	1	1	1	1	4
OG0016727	1	1	1	1	4
OG0016728	1	1	1	1	4
OG0016729	1	1	1	1	4
OG0016730	1	1	1	1	4
OG0016731	2	2	0	0	4
OG0016732	1	1	1	1	4
OG0016733	1	1	1	1	4
OG0016734	1	1	1	1	4
OG0016735	1	1	1	1	4
OG0016736	1	1	1	1	4
OG0016737	1	1	1	1	4
OG0016738	1	1	1	1	4
OG0016739	1	1	1	1	4
OG0016740	1	1	1	1	4
OG0016741	1	1	1	1	4
OG0016742	1	1	1	1	4
OG0016743	1	1	1	1	4
OG0016744	1	1	1	1	4
OG0016745	1	1	1	1	4
OG0016746	1	1	1	1	4
OG0016747	1	1	1	1	4
OG0016748	1	1	1	1	4
OG0016749	1	1	1	1	4
OG0016750	1	1	1	1	4
OG0016751	1	1	1	1	4
OG0016752	1	1	1	1	4
OG0016753	1	1	1	1	4
OG0016754	1	1	1	1	4
OG0016755	1	1	1	1	4
OG0016756	1	1	1	1	4
OG0016757	1	1	1	1	4
OG0016758	1	1	1	1	4
OG0016759	1	1	1	1	4
OG0016760	1	1	1	1	4
OG0016761	1	1	1	1	4
OG0016762	1	1	1	1	4
OG0016763	1	1	1	1	4
OG0016764	1	1	1	1	4
OG0016765	1	1	1	1	4
OG0016766	1	1	1	1	4
OG0016767	1	1	1	1	4
OG0016768	1	1	1	1	4
OG0016769	1	1	1	1	4
OG0016770	1	1	1	1	4
OG0016771	1	1	1	1	4
OG0016772	1	1	1	1	4
OG0016773	1	1	1	1	4
OG0016774	1	1	1	1	4
OG0016775	1	1	1	1	4
OG0016776	1	1	1	1	4
OG0016777	1	1	1	1	4
OG0016778	1	1	1	1	4
OG0016779	1	1	1	1	4
OG0016780	1	1	1	1	4
OG0016781	1	2	1	0	4
OG0016782	1	1	1	1	4
OG0016783	1	1	1	1	4
OG0016784	1	1	1	1	4
OG0016785	1	1	1	1	4
OG0016786	1	1	1	1	4
OG0016787	1	0	0	3	4
OG0016788	1	1	1	1	4
OG0016789	1	1	1	1	4
OG0016790	1	1	1	1	4
OG0016791	1	1	1	1	4
OG0016792	1	1	1	1	4
OG0016793	1	3	0	0	4
OG0016794	1	1	1	1	4
OG0016795	1	1	1	1	4
OG0016796	1	1	1	1	4
OG0016797	1	1	1	1	4
OG0016798	1	1	1	1	4
OG0016799	3	1	0	0	4
OG0016800	1	1	1	1	4
OG0016801	1	1	1	1	4
OG0016802	1	1	1	1	4
OG0016803	1	1	1	1	4
OG0016804	1	1	1	1	4
OG0016805	1	0	2	1	4
OG0016806	1	1	1	1	4
OG0016807	2	2	0	0	4
OG0016808	1	1	1	1	4
OG0016809	1	1	1	1	4
OG0016810	1	1	1	1	4
OG0016811	1	1	1	1	4
OG0016812	1	1	1	1	4
OG0016813	2	2	0	0	4
OG0016814	4	0	0	0	4
OG0016815	1	1	1	1	4
OG0016816	1	1	1	1	4
OG0016817	1	1	1	1	4
OG0016818	1	1	1	1	4
OG0016819	1	1	1	1	4
OG0016820	1	3	0	0	4
OG0016821	1	1	1	1	4
OG0016822	1	1	1	1	4
OG0016823	1	1	1	1	4
OG0016824	1	1	1	1	4
OG0016825	1	1	1	1	4
OG0016826	1	1	1	1	4
OG0016827	1	1	1	1	4
OG0016828	1	1	1	1	4
OG0016829	1	1	1	1	4
OG0016830	1	1	1	1	4
OG0016831	3	1	0	0	4
OG0016832	4	0	0	0	4
OG0016833	2	2	0	0	4
OG0016834	1	1	1	1	4
OG0016835	1	1	1	1	4
OG0016836	3	1	0	0	4
OG0016837	1	1	1	1	4
OG0016838	1	1	1	1	4
OG0016839	1	1	1	1	4
OG0016840	1	1	1	1	4
OG0016841	1	1	1	1	4
OG0016842	1	0	1	2	4
OG0016843	1	1	1	1	4
OG0016844	1	1	1	1	4
OG0016845	1	1	1	1	4
OG0016846	1	1	1	1	4
OG0016847	1	3	0	0	4
OG0016848	1	1	1	1	4
OG0016849	1	1	1	1	4
OG0016850	1	1	1	1	4
OG0016851	1	1	1	1	4
OG0016852	1	1	1	1	4
OG0016853	2	2	0	0	4
OG0016854	1	1	1	1	4
OG0016855	2	0	1	1	4
OG0016856	1	1	1	1	4
OG0016857	3	1	0	0	4
OG0016858	1	1	1	1	4
OG0016859	1	1	1	1	4
OG0016860	1	1	1	1	4
OG0016861	1	1	1	1	4
OG0016862	4	0	0	0	4
OG0016863	1	1	1	1	4
OG0016864	2	2	0	0	4
OG0016865	1	1	1	1	4
OG0016866	1	1	1	1	4
OG0016867	1	1	1	1	4
OG0016868	1	3	0	0	4
OG0016869	1	1	1	1	4
OG0016870	1	3	0	0	4
OG0016871	1	1	1	1	4
OG0016872	1	1	1	1	4
OG0016873	3	1	0	0	4
OG0016874	1	1	1	1	4
OG0016875	1	1	1	1	4
OG0016876	3	1	0	0	4
OG0016877	1	1	1	1	4
OG0016878	1	1	1	1	4
OG0016879	1	1	1	1	4
OG0016880	1	1	1	1	4
OG0016881	1	1	1	1	4
OG0016882	1	1	1	1	4
OG0016883	1	3	0	0	4
OG0016884	1	1	1	1	4
OG0016885	1	1	1	1	4
OG0016886	1	1	1	1	4
OG0016887	1	1	1	1	4
OG0016888	1	1	1	1	4
OG0016889	1	1	1	1	4
OG0016890	1	1	1	1	4
OG0016891	3	1	0	0	4
OG0016892	1	3	0	0	4
OG0016893	1	1	1	1	4
OG0016894	1	1	1	1	4
OG0016895	1	1	1	1	4
OG0016896	3	1	0	0	4
OG0016897	1	1	1	1	4
OG0016898	1	1	1	1	4
OG0016899	1	1	1	1	4
OG0016900	1	3	0	0	4
OG0016901	1	1	1	1	4
OG0016902	1	1	1	1	4
OG0016903	1	1	1	1	4
OG0016904	1	1	1	1	4
OG0016905	1	1	1	1	4
OG0016906	1	1	1	1	4
OG0016907	2	0	1	1	4
OG0016908	1	1	1	1	4
OG0016909	1	1	1	1	4
OG0016910	1	1	1	1	4
OG0016911	1	1	1	1	4
OG0016912	1	1	1	1	4
OG0016913	1	1	1	1	4
OG0016914	1	1	1	1	4
OG0016915	1	1	1	1	4
OG0016916	3	1	0	0	4
OG0016917	2	2	0	0	4
OG0016918	1	1	1	1	4
OG0016919	1	1	1	1	4
OG0016920	3	1	0	0	4
OG0016921	1	1	1	1	4
OG0016922	1	1	1	1	4
OG0016923	1	1	1	1	4
OG0016924	1	1	1	1	4
OG0016925	1	1	1	1	4
OG0016926	1	1	1	1	4
OG0016927	1	1	1	1	4
OG0016928	1	1	1	1	4
OG0016929	1	1	1	1	4
OG0016930	1	1	1	1	4
OG0016931	1	1	1	1	4
OG0016932	1	1	1	1	4
OG0016933	1	1	1	1	4
OG0016934	1	1	1	1	4
OG0016935	1	1	1	1	4
OG0016936	1	1	1	1	4
OG0016937	1	1	1	1	4
OG0016938	1	1	1	1	4
OG0016939	1	1	1	1	4
OG0016940	1	1	1	1	4
OG0016941	1	1	1	1	4
OG0016942	1	1	1	1	4
OG0016943	1	1	1	1	4
OG0016944	1	1	1	1	4
OG0016945	1	1	1	1	4
OG0016946	1	1	1	1	4
OG0016947	1	1	1	1	4
OG0016948	1	1	1	1	4
OG0016949	1	1	1	1	4
OG0016950	1	1	1	1	4
OG0016951	2	0	1	1	4
OG0016952	3	1	0	0	4
OG0016953	1	1	1	1	4
OG0016954	1	1	1	1	4
OG0016955	1	1	2	0	4
OG0016956	1	1	1	1	4
OG0016957	1	1	1	1	4
OG0016958	1	1	1	1	4
OG0016959	1	1	1	1	4
OG0016960	2	0	1	1	4
OG0016961	4	0	0	0	4
OG0016962	1	1	1	1	4
OG0016963	1	1	1	1	4
OG0016964	1	1	1	1	4
OG0016965	1	1	1	1	4
OG0016966	1	1	1	1	4
OG0016967	1	1	1	1	4
OG0016968	1	0	3	0	4
OG0016969	1	1	1	1	4
OG0016970	1	1	1	1	4
OG0016971	1	1	1	1	4
OG0016972	1	3	0	0	4
OG0016973	2	1	1	0	4
OG0016974	1	1	1	1	4
OG0016975	1	1	1	1	4
OG0016976	1	1	1	1	4
OG0016977	1	1	1	1	4
OG0016978	1	1	1	1	4
OG0016979	1	1	1	1	4
OG0016980	1	1	1	1	4
OG0016981	1	1	1	1	4
OG0016982	1	1	1	1	4
OG0016983	1	1	1	1	4
OG0016984	3	1	0	0	4
OG0016985	1	1	1	1	4
OG0016986	1	1	1	1	4
OG0016987	1	1	1	1	4
OG0016988	1	1	1	1	4
OG0016989	1	1	1	1	4
OG0016990	1	1	1	1	4
OG0016991	1	1	1	1	4
OG0016992	1	1	1	1	4
OG0016993	1	0	1	2	4
OG0016994	1	1	1	1	4
OG0016995	1	1	1	1	4
OG0016996	1	1	1	1	4
OG0016997	1	1	1	1	4
OG0016998	1	1	1	1	4
OG0016999	1	1	1	1	4
OG0017000	1	3	0	0	4
OG0017001	1	1	1	1	4
OG0017002	1	1	1	1	4
OG0017003	1	1	1	1	4
OG0017004	1	1	1	1	4
OG0017005	2	0	1	1	4
OG0017006	3	1	0	0	4
OG0017007	1	1	1	1	4
OG0017008	1	1	1	1	4
OG0017009	1	1	2	0	4
OG0017010	1	1	1	1	4
OG0017011	1	1	1	1	4
OG0017012	1	1	1	1	4
OG0017013	1	1	1	1	4
OG0017014	1	1	1	1	4
OG0017015	1	0	1	2	4
OG0017016	1	1	1	1	4
OG0017017	1	1	1	1	4
OG0017018	1	1	1	1	4
OG0017019	1	1	1	1	4
OG0017020	1	1	1	1	4
OG0017021	1	1	1	1	4
OG0017022	1	1	1	1	4
OG0017023	1	1	1	1	4
OG0017024	1	1	1	1	4
OG0017025	1	1	1	1	4
OG0017026	1	1	1	1	4
OG0017027	1	1	1	1	4
OG0017028	1	1	1	1	4
OG0017029	1	1	1	1	4
OG0017030	1	1	1	1	4
OG0017031	1	1	1	1	4
OG0017032	1	1	1	1	4
OG0017033	1	1	1	1	4
OG0017034	1	1	1	1	4
OG0017035	1	1	1	1	4
OG0017036	1	1	1	1	4
OG0017037	1	1	1	1	4
OG0017038	1	1	1	1	4
OG0017039	1	1	1	1	4
OG0017040	1	1	1	1	4
OG0017041	1	1	1	1	4
OG0017042	1	1	1	1	4
OG0017043	1	1	1	1	4
OG0017044	1	1	1	1	4
OG0017045	1	1	1	1	4
OG0017046	1	1	1	1	4
OG0017047	1	1	1	1	4
OG0017048	1	1	1	1	4
OG0017049	1	1	1	1	4
OG0017050	1	2	0	1	4
OG0017051	1	1	1	1	4
OG0017052	2	0	1	1	4
OG0017053	1	1	1	1	4
OG0017054	1	1	1	1	4
OG0017055	1	1	1	1	4
OG0017056	1	1	1	1	4
OG0017057	1	1	1	1	4
OG0017058	1	1	1	1	4
OG0017059	1	1	1	1	4
OG0017060	1	1	1	1	4
OG0017061	1	1	1	1	4
OG0017062	1	1	1	1	4
OG0017063	1	1	1	1	4
OG0017064	1	1	1	1	4
OG0017065	1	1	1	1	4
OG0017066	1	1	1	1	4
OG0017067	1	1	1	1	4
OG0017068	1	1	1	1	4
OG0017069	1	1	1	1	4
OG0017070	1	1	1	1	4
OG0017071	1	1	1	1	4
OG0017072	1	1	1	1	4
OG0017073	3	1	0	0	4
OG0017074	1	1	1	1	4
OG0017075	1	1	1	1	4
OG0017076	1	1	1	1	4
OG0017077	1	1	1	1	4
OG0017078	1	0	2	1	4
OG0017079	1	1	1	1	4
OG0017080	1	1	1	1	4
OG0017081	1	1	1	1	4
OG0017082	1	1	1	1	4
OG0017083	1	1	1	1	4
OG0017084	2	2	0	0	4
OG0017085	1	1	1	1	4
OG0017086	1	1	1	1	4
OG0017087	1	1	1	1	4
OG0017088	1	1	1	1	4
OG0017089	1	1	1	1	4
OG0017090	1	1	1	1	4
OG0017091	1	1	1	1	4
OG0017092	1	1	1	1	4
OG0017093	1	1	2	0	4
OG0017094	1	1	1	1	4
OG0017095	2	1	0	1	4
OG0017096	1	1	1	1	4
OG0017097	1	1	1	1	4
OG0017098	1	1	1	1	4
OG0017099	1	1	1	1	4
OG0017100	1	1	1	1	4
OG0017101	1	1	1	1	4
OG0017102	1	1	0	2	4
OG0017103	1	1	1	1	4
OG0017104	1	1	1	1	4
OG0017105	1	0	1	2	4
OG0017106	1	1	1	1	4
OG0017107	1	1	1	1	4
OG0017108	1	1	1	1	4
OG0017109	1	1	1	1	4
OG0017110	1	1	1	1	4
OG0017111	1	1	1	1	4
OG0017112	1	1	1	1	4
OG0017113	1	1	1	1	4
OG0017114	1	1	1	1	4
OG0017115	1	1	1	1	4
OG0017116	1	1	1	1	4
OG0017117	1	1	1	1	4
OG0017118	1	1	1	1	4
OG0017119	1	1	1	1	4
OG0017120	1	1	1	1	4
OG0017121	1	1	1	1	4
OG0017122	1	1	1	1	4
OG0017123	1	1	1	1	4
OG0017124	1	1	1	1	4
OG0017125	1	1	1	1	4
OG0017126	1	1	1	1	4
OG0017127	1	1	1	1	4
OG0017128	1	1	1	1	4
OG0017129	1	1	1	1	4
OG0017130	1	1	1	1	4
OG0017131	1	1	1	1	4
OG0017132	1	1	1	1	4
OG0017133	1	1	1	1	4
OG0017134	1	1	1	1	4
OG0017135	1	1	1	1	4
OG0017136	1	1	1	1	4
OG0017137	1	1	1	1	4
OG0017138	1	1	1	1	4
OG0017139	1	1	1	1	4
OG0017140	1	1	1	1	4
OG0017141	1	1	1	1	4
OG0017142	1	1	1	1	4
OG0017143	1	1	1	1	4
OG0017144	1	1	1	1	4
OG0017145	1	1	1	1	4
OG0017146	1	1	1	1	4
OG0017147	1	1	1	1	4
OG0017148	1	1	1	1	4
OG0017149	1	1	1	1	4
OG0017150	2	1	0	1	4
OG0017151	1	1	1	1	4
OG0017152	1	1	1	1	4
OG0017153	1	1	1	1	4
OG0017154	1	1	1	1	4
OG0017155	1	1	1	1	4
OG0017156	1	1	1	1	4
OG0017157	1	1	1	1	4
OG0017158	1	1	1	1	4
OG0017159	1	1	1	1	4
OG0017160	1	1	1	1	4
OG0017161	1	1	1	1	4
OG0017162	1	1	1	1	4
OG0017163	1	1	1	1	4
OG0017164	1	1	1	1	4
OG0017165	1	1	1	1	4
OG0017166	1	1	1	1	4
OG0017167	1	0	1	2	4
OG0017168	1	1	1	1	4
OG0017169	1	1	1	1	4
OG0017170	1	1	1	1	4
OG0017171	1	1	1	1	4
OG0017172	1	1	1	1	4
OG0017173	1	1	1	1	4
OG0017174	1	1	1	1	4
OG0017175	1	1	1	1	4
OG0017176	3	1	0	0	4
OG0017177	1	1	1	1	4
OG0017178	1	1	1	1	4
OG0017179	1	1	1	1	4
OG0017180	1	1	1	1	4
OG0017181	1	1	1	1	4
OG0017182	1	1	1	1	4
OG0017183	3	0	0	1	4
OG0017184	1	1	1	1	4
OG0017185	1	1	1	1	4
OG0017186	1	1	1	1	4
OG0017187	1	1	1	1	4
OG0017188	1	1	1	1	4
OG0017189	1	1	1	1	4
OG0017190	1	1	1	1	4
OG0017191	1	1	1	1	4
OG0017192	1	1	1	1	4
OG0017193	1	1	1	1	4
OG0017194	1	1	1	1	4
OG0017195	1	1	1	1	4
OG0017196	1	1	1	1	4
OG0017197	1	1	1	1	4
OG0017198	1	1	1	1	4
OG0017199	1	1	1	1	4
OG0017200	1	1	1	1	4
OG0017201	1	1	1	1	4
OG0017202	1	1	1	1	4
OG0017203	1	1	1	1	4
OG0017204	1	1	1	1	4
OG0017205	1	1	1	1	4
OG0017206	1	1	1	1	4
OG0017207	1	1	1	1	4
OG0017208	1	1	1	1	4
OG0017209	1	1	1	1	4
OG0017210	1	1	1	1	4
OG0017211	1	1	1	1	4
OG0017212	1	1	1	1	4
OG0017213	1	1	1	1	4
OG0017214	1	1	1	1	4
OG0017215	1	1	1	1	4
OG0017216	1	1	1	1	4
OG0017217	1	1	1	1	4
OG0017218	1	1	1	1	4
OG0017219	1	1	1	1	4
OG0017220	1	1	1	1	4
OG0017221	1	1	1	1	4
OG0017222	1	1	1	1	4
OG0017223	1	1	1	1	4
OG0017224	1	1	1	1	4
OG0017225	1	1	1	1	4
OG0017226	1	1	1	1	4
OG0017227	1	1	1	1	4
OG0017228	1	1	1	1	4
OG0017229	1	1	1	1	4
OG0017230	1	1	1	1	4
OG0017231	1	1	1	1	4
OG0017232	1	1	1	1	4
OG0017233	1	1	1	1	4
OG0017234	1	1	1	1	4
OG0017235	1	1	1	1	4
OG0017236	1	1	1	1	4
OG0017237	1	1	1	1	4
OG0017238	1	1	1	1	4
OG0017239	1	1	1	1	4
OG0017240	1	1	1	1	4
OG0017241	1	1	1	1	4
OG0017242	1	1	0	2	4
OG0017243	1	1	1	1	4
OG0017244	1	1	1	1	4
OG0017245	1	1	1	1	4
OG0017246	1	1	1	1	4
OG0017247	1	1	1	1	4
OG0017248	2	0	1	1	4
OG0017249	1	1	1	1	4
OG0017250	1	1	1	1	4
OG0017251	1	1	1	1	4
OG0017252	1	1	1	1	4
OG0017253	1	1	1	1	4
OG0017254	1	1	1	1	4
OG0017255	1	1	1	1	4
OG0017256	1	1	1	1	4
OG0017257	1	1	1	1	4
OG0017258	1	1	1	1	4
OG0017259	1	1	1	1	4
OG0017260	1	1	1	1	4
OG0017261	1	1	1	1	4
OG0017262	1	1	1	1	4
OG0017263	1	1	1	1	4
OG0017264	1	1	1	1	4
OG0017265	1	1	1	1	4
OG0017266	1	1	1	1	4
OG0017267	1	1	1	1	4
OG0017268	1	1	1	1	4
OG0017269	1	1	1	1	4
OG0017270	1	1	1	1	4
OG0017271	1	1	1	1	4
OG0017272	1	1	1	1	4
OG0017273	1	1	1	1	4
OG0017274	1	1	1	1	4
OG0017275	1	1	1	1	4
OG0017276	1	1	1	1	4
OG0017277	1	1	1	1	4
OG0017278	1	1	1	1	4
OG0017279	1	1	1	1	4
OG0017280	1	1	1	1	4
OG0017281	1	1	1	1	4
OG0017282	1	1	1	1	4
OG0017283	1	1	1	1	4
OG0017284	1	1	1	1	4
OG0017285	1	1	1	1	4
OG0017286	1	1	1	1	4
OG0017287	1	1	1	1	4
OG0017288	1	1	1	1	4
OG0017289	1	1	1	1	4
OG0017290	1	1	1	1	4
OG0017291	1	1	1	1	4
OG0017292	1	1	1	1	4
OG0017293	1	1	1	1	4
OG0017294	1	1	1	1	4
OG0017295	1	0	1	2	4
OG0017296	1	1	1	1	4
OG0017297	1	1	1	1	4
OG0017298	1	1	1	1	4
OG0017299	1	1	1	1	4
OG0017300	1	1	1	1	4
OG0017301	1	1	1	1	4
OG0017302	2	1	1	0	4
OG0017303	1	1	1	1	4
OG0017304	1	1	1	1	4
OG0017305	1	1	1	1	4
OG0017306	1	1	1	1	4
OG0017307	1	1	1	1	4
OG0017308	1	1	1	1	4
OG0017309	1	1	1	1	4
OG0017310	1	1	1	1	4
OG0017311	1	1	1	1	4
OG0017312	1	1	1	1	4
OG0017313	1	1	1	1	4
OG0017314	1	1	1	1	4
OG0017315	1	1	1	1	4
OG0017316	1	1	1	1	4
OG0017317	1	1	1	1	4
OG0017318	1	1	1	1	4
OG0017319	4	0	0	0	4
OG0017320	1	1	1	1	4
OG0017321	1	1	1	1	4
OG0017322	1	1	1	1	4
OG0017323	1	1	1	1	4
OG0017324	1	1	1	1	4
OG0017325	1	1	1	1	4
OG0017326	1	1	1	1	4
OG0017327	1	1	1	1	4
OG0017328	1	1	1	1	4
OG0017329	1	1	1	1	4
OG0017330	1	1	1	1	4
OG0017331	1	1	1	1	4
OG0017332	1	1	1	1	4
OG0017333	1	1	1	1	4
OG0017334	1	1	1	1	4
OG0017335	1	1	1	1	4
OG0017336	1	1	1	1	4
OG0017337	1	1	1	1	4
OG0017338	1	1	1	1	4
OG0017339	1	1	1	1	4
OG0017340	1	1	1	1	4
OG0017341	1	1	1	1	4
OG0017342	1	1	1	1	4
OG0017343	1	1	1	1	4
OG0017344	1	1	1	1	4
OG0017345	1	1	1	1	4
OG0017346	1	1	1	1	4
OG0017347	1	1	1	1	4
OG0017348	1	1	1	1	4
OG0017349	3	0	0	1	4
OG0017350	1	1	1	1	4
OG0017351	1	1	1	1	4
OG0017352	1	1	1	1	4
OG0017353	1	1	1	1	4
OG0017354	1	1	1	1	4
OG0017355	1	1	1	1	4
OG0017356	1	1	1	1	4
OG0017357	1	0	3	0	4
OG0017358	1	1	1	1	4
OG0017359	1	1	1	1	4
OG0017360	1	1	1	1	4
OG0017361	1	1	1	1	4
OG0017362	1	1	1	1	4
OG0017363	1	1	1	1	4
OG0017364	1	1	1	1	4
OG0017365	1	1	1	1	4
OG0017366	1	1	1	1	4
OG0017367	1	1	1	1	4
OG0017368	1	1	1	1	4
OG0017369	1	1	1	1	4
OG0017370	1	1	1	1	4
OG0017371	1	1	1	1	4
OG0017372	1	1	2	0	4
OG0017373	1	1	1	1	4
OG0017374	1	1	1	1	4
OG0017375	1	1	1	1	4
OG0017376	1	1	1	1	4
OG0017377	1	1	1	1	4
OG0017378	1	1	1	1	4
OG0017379	1	1	1	1	4
OG0017380	1	1	1	1	4
OG0017381	1	1	1	1	4
OG0017382	1	0	2	1	4
OG0017383	1	1	1	1	4
OG0017384	1	1	1	1	4
OG0017385	1	0	2	1	4
OG0017386	4	0	0	0	4
OG0017387	1	1	2	0	4
OG0017388	3	1	0	0	4
OG0017389	1	1	1	1	4
OG0017390	1	1	1	1	4
OG0017391	1	1	1	1	4
OG0017392	1	1	1	1	4
OG0017393	1	1	1	1	4
OG0017394	1	1	1	1	4
OG0017395	1	0	1	2	4
OG0017396	1	1	1	1	4
OG0017397	1	1	1	1	4
OG0017398	1	1	1	1	4
OG0017399	1	1	1	1	4
OG0017400	1	1	1	1	4
OG0017401	1	1	1	1	4
OG0017402	1	1	1	1	4
OG0017403	1	1	1	1	4
OG0017404	1	1	1	1	4
OG0017405	1	1	1	1	4
OG0017406	1	1	1	1	4
OG0017407	1	1	1	1	4
OG0017408	2	1	1	0	4
OG0017409	1	1	1	1	4
OG0017410	1	1	1	1	4
OG0017411	1	1	1	1	4
OG0017412	1	1	1	1	4
OG0017413	1	1	1	1	4
OG0017414	1	1	1	1	4
OG0017415	1	1	1	1	4
OG0017416	1	1	1	1	4
OG0017417	1	1	1	1	4
OG0017418	1	1	1	1	4
OG0017419	1	1	1	1	4
OG0017420	1	1	1	1	4
OG0017421	1	1	1	1	4
OG0017422	1	1	1	1	4
OG0017423	1	1	1	1	4
OG0017424	1	1	1	1	4
OG0017425	1	1	1	1	4
OG0017426	1	1	1	1	4
OG0017427	1	1	1	1	4
OG0017428	1	1	1	1	4
OG0017429	1	1	1	1	4
OG0017430	1	1	1	1	4
OG0017431	1	1	1	1	4
OG0017432	1	1	1	1	4
OG0017433	1	1	1	1	4
OG0017434	1	1	1	1	4
OG0017435	1	1	1	1	4
OG0017436	1	1	1	1	4
OG0017437	1	1	1	1	4
OG0017438	1	1	1	1	4
OG0017439	1	1	1	1	4
OG0017440	1	1	1	1	4
OG0017441	1	1	1	1	4
OG0017442	1	1	1	1	4
OG0017443	1	1	1	1	4
OG0017444	1	1	1	1	4
OG0017445	3	1	0	0	4
OG0017446	1	1	1	1	4
OG0017447	1	1	1	1	4
OG0017448	1	1	1	1	4
OG0017449	1	1	1	1	4
OG0017450	1	1	1	1	4
OG0017451	1	1	1	1	4
OG0017452	1	1	1	1	4
OG0017453	1	1	1	1	4
OG0017454	1	1	1	1	4
OG0017455	1	1	1	1	4
OG0017456	1	1	1	1	4
OG0017457	1	1	1	1	4
OG0017458	1	1	1	1	4
OG0017459	1	1	1	1	4
OG0017460	1	1	1	1	4
OG0017461	1	1	1	1	4
OG0017462	1	1	1	1	4
OG0017463	1	1	1	1	4
OG0017464	1	1	1	1	4
OG0017465	1	1	1	1	4
OG0017466	1	1	1	1	4
OG0017467	1	1	1	1	4
OG0017468	1	1	1	1	4
OG0017469	1	1	1	1	4
OG0017470	1	1	1	1	4
OG0017471	1	1	1	1	4
OG0017472	1	1	1	1	4
OG0017473	1	1	1	1	4
OG0017474	1	1	1	1	4
OG0017475	1	1	1	1	4
OG0017476	1	1	1	1	4
OG0017477	1	1	1	1	4
OG0017478	1	1	1	1	4
OG0017479	1	1	1	1	4
OG0017480	1	1	1	1	4
OG0017481	1	2	1	0	4
OG0017482	1	1	1	1	4
OG0017483	1	1	1	1	4
OG0017484	1	1	1	1	4
OG0017485	1	1	1	1	4
OG0017486	1	1	1	1	4
OG0017487	1	1	1	1	4
OG0017488	1	1	1	1	4
OG0017489	1	1	1	1	4
OG0017490	1	1	1	1	4
OG0017491	1	1	1	1	4
OG0017492	1	1	1	1	4
OG0017493	1	1	1	1	4
OG0017494	1	1	1	1	4
OG0017495	1	1	1	1	4
OG0017496	1	1	1	1	4
OG0017497	1	1	1	1	4
OG0017498	1	1	2	0	4
OG0017499	1	1	1	1	4
OG0017500	1	1	1	1	4
OG0017501	1	1	1	1	4
OG0017502	1	1	1	1	4
OG0017503	1	1	1	1	4
OG0017504	1	1	1	1	4
OG0017505	1	1	1	1	4
OG0017506	1	1	1	1	4
OG0017507	1	1	1	1	4
OG0017508	1	1	1	1	4
OG0017509	1	1	1	1	4
OG0017510	1	1	1	1	4
OG0017511	1	1	1	1	4
OG0017512	1	1	1	1	4
OG0017513	1	1	1	1	4
OG0017514	1	1	1	1	4
OG0017515	1	1	1	1	4
OG0017516	1	1	1	1	4
OG0017517	1	1	1	1	4
OG0017518	1	1	1	1	4
OG0017519	1	1	1	1	4
OG0017520	1	1	1	1	4
OG0017521	1	1	1	1	4
OG0017522	1	1	1	1	4
OG0017523	1	1	1	1	4
OG0017524	1	1	1	1	4
OG0017525	1	1	1	1	4
OG0017526	1	1	1	1	4
OG0017527	1	1	1	1	4
OG0017528	1	1	1	1	4
OG0017529	1	1	1	1	4
OG0017530	1	1	1	1	4
OG0017531	1	1	1	1	4
OG0017532	1	1	1	1	4
OG0017533	1	1	1	1	4
OG0017534	1	1	1	1	4
OG0017535	1	1	1	1	4
OG0017536	1	1	1	1	4
OG0017537	1	1	1	1	4
OG0017538	1	1	1	1	4
OG0017539	1	1	1	1	4
OG0017540	1	1	1	1	4
OG0017541	1	1	1	1	4
OG0017542	1	1	1	1	4
OG0017543	1	1	1	1	4
OG0017544	1	1	1	1	4
OG0017545	1	1	1	1	4
OG0017546	1	1	1	1	4
OG0017547	1	1	1	1	4
OG0017548	1	1	1	1	4
OG0017549	1	1	1	1	4
OG0017550	1	1	1	1	4
OG0017551	1	1	1	1	4
OG0017552	1	1	1	1	4
OG0017553	1	1	1	1	4
OG0017554	1	1	1	1	4
OG0017555	1	1	1	1	4
OG0017556	1	1	1	1	4
OG0017557	1	1	1	1	4
OG0017558	1	1	1	1	4
OG0017559	1	1	1	1	4
OG0017560	1	1	1	1	4
OG0017561	1	1	1	1	4
OG0017562	1	1	1	1	4
OG0017563	1	1	1	1	4
OG0017564	1	1	1	1	4
OG0017565	1	1	1	1	4
OG0017566	1	1	1	1	4
OG0017567	1	1	1	1	4
OG0017568	1	1	1	1	4
OG0017569	1	1	1	1	4
OG0017570	1	1	1	1	4
OG0017571	1	1	1	1	4
OG0017572	1	1	1	1	4
OG0017573	1	1	1	1	4
OG0017574	1	1	1	1	4
OG0017575	1	1	1	1	4
OG0017576	1	1	1	1	4
OG0017577	1	1	1	1	4
OG0017578	1	1	1	1	4
OG0017579	1	1	1	1	4
OG0017580	1	1	1	1	4
OG0017581	1	1	1	1	4
OG0017582	1	1	1	1	4
OG0017583	1	1	1	1	4
OG0017584	1	1	1	1	4
OG0017585	1	1	1	1	4
OG0017586	1	1	1	1	4
OG0017587	1	1	1	1	4
OG0017588	1	1	1	1	4
OG0017589	1	1	1	1	4
OG0017590	1	1	1	1	4
OG0017591	2	1	1	0	4
OG0017592	1	1	1	1	4
OG0017593	1	1	1	1	4
OG0017594	1	1	1	1	4
OG0017595	1	1	1	1	4
OG0017596	1	1	1	1	4
OG0017597	1	1	1	1	4
OG0017598	1	1	1	1	4
OG0017599	1	1	1	1	4
OG0017600	1	1	1	1	4
OG0017601	1	1	1	1	4
OG0017602	1	1	1	1	4
OG0017603	1	1	1	1	4
OG0017604	1	1	1	1	4
OG0017605	1	1	1	1	4
OG0017606	1	1	1	1	4
OG0017607	1	1	1	1	4
OG0017608	1	1	1	1	4
OG0017609	1	1	1	1	4
OG0017610	1	1	1	1	4
OG0017611	1	1	1	1	4
OG0017612	1	1	1	1	4
OG0017613	1	1	1	1	4
OG0017614	1	1	1	1	4
OG0017615	1	1	1	1	4
OG0017616	1	1	1	1	4
OG0017617	1	1	1	1	4
OG0017618	1	1	1	1	4
OG0017619	1	1	1	1	4
OG0017620	1	1	1	1	4
OG0017621	1	1	1	1	4
OG0017622	1	1	1	1	4
OG0017623	1	1	1	1	4
OG0017624	1	1	1	1	4
OG0017625	1	1	1	1	4
OG0017626	1	1	1	1	4
OG0017627	1	1	1	1	4
OG0017628	1	1	1	1	4
OG0017629	1	1	1	1	4
OG0017630	1	1	1	1	4
OG0017631	1	1	1	1	4
OG0017632	1	1	1	1	4
OG0017633	1	1	1	1	4
OG0017634	1	1	1	1	4
OG0017635	1	1	1	1	4
OG0017636	1	1	1	1	4
OG0017637	1	1	1	1	4
OG0017638	1	1	1	1	4
OG0017639	1	1	1	1	4
OG0017640	1	1	1	1	4
OG0017641	1	1	1	1	4
OG0017642	1	1	1	1	4
OG0017643	1	1	1	1	4
OG0017644	1	1	1	1	4
OG0017645	1	0	1	2	4
OG0017646	1	1	1	1	4
OG0017647	1	1	1	1	4
OG0017648	1	1	1	1	4
OG0017649	1	1	1	1	4
OG0017650	1	1	1	1	4
OG0017651	1	1	1	1	4
OG0017652	1	1	1	1	4
OG0017653	1	1	1	1	4
OG0017654	1	1	1	1	4
OG0017655	1	1	1	1	4
OG0017656	1	1	0	2	4
OG0017657	1	1	1	1	4
OG0017658	1	1	1	1	4
OG0017659	1	1	1	1	4
OG0017660	1	1	1	1	4
OG0017661	1	1	1	1	4
OG0017662	1	1	1	1	4
OG0017663	1	1	1	1	4
OG0017664	1	1	1	1	4
OG0017665	1	1	1	1	4
OG0017666	1	1	1	1	4
OG0017667	1	1	1	1	4
OG0017668	1	1	1	1	4
OG0017669	1	1	1	1	4
OG0017670	1	1	1	1	4
OG0017671	1	1	1	1	4
OG0017672	1	1	1	1	4
OG0017673	1	1	1	1	4
OG0017674	1	1	1	1	4
OG0017675	1	0	1	2	4
OG0017676	1	1	1	1	4
OG0017677	1	1	1	1	4
OG0017678	1	1	1	1	4
OG0017679	1	1	1	1	4
OG0017680	1	1	1	1	4
OG0017681	1	0	2	1	4
OG0017682	1	1	1	1	4
OG0017683	1	1	1	1	4
OG0017684	1	1	1	1	4
OG0017685	1	1	1	1	4
OG0017686	1	1	1	1	4
OG0017687	1	1	1	1	4
OG0017688	1	1	1	1	4
OG0017689	1	1	1	1	4
OG0017690	1	1	1	1	4
OG0017691	1	1	1	1	4
OG0017692	1	1	1	1	4
OG0017693	1	1	1	1	4
OG0017694	1	1	1	1	4
OG0017695	1	1	1	1	4
OG0017696	1	1	1	1	4
OG0017697	1	1	1	1	4
OG0017698	1	1	1	1	4
OG0017699	1	1	1	1	4
OG0017700	1	0	1	2	4
OG0017701	1	1	1	1	4
OG0017702	1	1	1	1	4
OG0017703	1	1	1	1	4
OG0017704	1	1	1	1	4
OG0017705	1	1	1	1	4
OG0017706	1	1	1	1	4
OG0017707	1	1	1	1	4
OG0017708	1	0	2	1	4
OG0017709	1	1	1	1	4
OG0017710	1	1	1	1	4
OG0017711	1	1	1	1	4
OG0017712	1	1	1	1	4
OG0017713	1	1	1	1	4
OG0017714	1	1	1	1	4
OG0017715	1	1	1	1	4
OG0017716	1	1	1	1	4
OG0017717	1	1	1	1	4
OG0017718	1	1	1	1	4
OG0017719	1	1	1	1	4
OG0017720	1	1	1	1	4
OG0017721	1	1	1	1	4
OG0017722	1	1	1	1	4
OG0017723	1	1	1	1	4
OG0017724	1	1	1	1	4
OG0017725	1	1	1	1	4
OG0017726	1	1	1	1	4
OG0017727	1	0	1	2	4
OG0017728	1	1	1	1	4
OG0017729	1	1	1	1	4
OG0017730	1	1	1	1	4
OG0017731	1	1	1	1	4
OG0017732	1	1	1	1	4
OG0017733	1	0	2	1	4
OG0017734	1	1	1	1	4
OG0017735	1	1	1	1	4
OG0017736	1	1	1	1	4
OG0017737	1	1	1	1	4
OG0017738	1	1	1	1	4
OG0017739	1	1	0	2	4
OG0017740	1	1	1	1	4
OG0017741	1	1	1	1	4
OG0017742	1	1	1	1	4
OG0017743	1	1	1	1	4
OG0017744	1	1	1	1	4
OG0017745	1	1	1	1	4
OG0017746	1	1	1	1	4
OG0017747	1	1	1	1	4
OG0017748	1	1	1	1	4
OG0017749	1	1	1	1	4
OG0017750	1	1	1	1	4
OG0017751	1	1	1	1	4
OG0017752	1	1	1	1	4
OG0017753	1	1	1	1	4
OG0017754	1	1	1	1	4
OG0017755	1	1	1	1	4
OG0017756	1	1	1	1	4
OG0017757	1	1	1	1	4
OG0017758	1	1	1	1	4
OG0017759	1	1	1	1	4
OG0017760	1	1	1	1	4
OG0017761	1	1	1	1	4
OG0017762	1	0	1	2	4
OG0017763	1	1	1	1	4
OG0017764	1	1	1	1	4
OG0017765	1	1	1	1	4
OG0017766	1	1	1	1	4
OG0017767	1	1	1	1	4
OG0017768	1	1	1	1	4
OG0017769	1	1	1	1	4
OG0017770	1	1	1	1	4
OG0017771	1	1	1	1	4
OG0017772	1	1	1	1	4
OG0017773	1	1	1	1	4
OG0017774	1	1	1	1	4
OG0017775	1	1	1	1	4
OG0017776	1	1	1	1	4
OG0017777	1	1	1	1	4
OG0017778	1	0	1	2	4
OG0017779	1	1	1	1	4
OG0017780	1	1	1	1	4
OG0017781	1	1	1	1	4
OG0017782	2	1	1	0	4
OG0017783	1	1	1	1	4
OG0017784	1	1	1	1	4
OG0017785	1	1	1	1	4
OG0017786	1	1	1	1	4
OG0017787	1	0	2	1	4
OG0017788	1	1	1	1	4
OG0017789	1	1	1	1	4
OG0017790	1	1	1	1	4
OG0017791	1	1	1	1	4
OG0017792	1	1	1	1	4
OG0017793	1	1	1	1	4
OG0017794	1	1	1	1	4
OG0017795	1	1	1	1	4
OG0017796	1	1	1	1	4
OG0017797	1	1	1	1	4
OG0017798	1	1	1	1	4
OG0017799	1	1	1	1	4
OG0017800	1	0	1	2	4
OG0017801	3	0	1	0	4
OG0017802	1	1	1	1	4
OG0017803	1	1	1	1	4
OG0017804	1	1	1	1	4
OG0017805	1	1	1	1	4
OG0017806	1	1	1	1	4
OG0017807	1	1	1	1	4
OG0017808	1	0	1	2	4
OG0017809	1	1	1	1	4
OG0017810	1	1	1	1	4
OG0017811	1	1	1	1	4
OG0017812	1	1	1	1	4
OG0017813	1	1	1	1	4
OG0017814	1	1	1	1	4
OG0017815	1	1	1	1	4
OG0017816	1	1	1	1	4
OG0017817	1	1	1	1	4
OG0017818	1	1	1	1	4
OG0017819	1	1	1	1	4
OG0017820	1	1	1	1	4
OG0017821	1	1	1	1	4
OG0017822	1	1	1	1	4
OG0017823	1	1	1	1	4
OG0017824	1	1	1	1	4
OG0017825	1	1	1	1	4
OG0017826	1	1	1	1	4
OG0017827	1	1	1	1	4
OG0017828	1	1	1	1	4
OG0017829	1	1	1	1	4
OG0017830	1	1	1	1	4
OG0017831	1	1	1	1	4
OG0017832	1	1	1	1	4
OG0017833	1	1	1	1	4
OG0017834	1	1	1	1	4
OG0017835	1	1	1	1	4
OG0017836	1	1	1	1	4
OG0017837	1	1	1	1	4
OG0017838	1	1	1	1	4
OG0017839	1	1	1	1	4
OG0017840	1	1	1	1	4
OG0017841	1	1	1	1	4
OG0017842	1	1	1	1	4
OG0017843	1	1	1	1	4
OG0017844	1	1	1	1	4
OG0017845	1	1	1	1	4
OG0017846	1	1	1	1	4
OG0017847	1	1	1	1	4
OG0017848	1	1	1	1	4
OG0017849	1	1	1	1	4
OG0017850	1	1	1	1	4
OG0017851	2	1	0	1	4
OG0017852	1	1	1	1	4
OG0017853	1	1	1	1	4
OG0017854	1	1	1	1	4
OG0017855	1	1	1	1	4
OG0017856	1	1	1	1	4
OG0017857	1	1	1	1	4
OG0017858	1	1	1	1	4
OG0017859	1	1	1	1	4
OG0017860	1	1	1	1	4
OG0017861	1	1	1	1	4
OG0017862	1	1	1	1	4
OG0017863	1	1	1	1	4
OG0017864	1	1	1	1	4
OG0017865	1	1	1	1	4
OG0017866	1	1	1	1	4
OG0017867	1	1	1	1	4
OG0017868	1	1	1	1	4
OG0017869	1	1	1	1	4
OG0017870	1	1	1	1	4
OG0017871	1	1	1	1	4
OG0017872	1	1	1	1	4
OG0017873	1	1	1	1	4
OG0017874	1	1	1	1	4
OG0017875	1	1	1	1	4
OG0017876	1	1	1	1	4
OG0017877	1	1	1	1	4
OG0017878	1	1	1	1	4
OG0017879	1	1	1	1	4
OG0017880	1	1	1	1	4
OG0017881	1	1	1	1	4
OG0017882	1	1	1	1	4
OG0017883	1	1	1	1	4
OG0017884	1	1	1	1	4
OG0017885	1	1	1	1	4
OG0017886	1	1	1	1	4
OG0017887	1	1	1	1	4
OG0017888	1	2	0	1	4
OG0017889	1	1	1	1	4
OG0017890	1	1	1	1	4
OG0017891	1	0	1	2	4
OG0017892	1	1	1	1	4
OG0017893	1	1	1	1	4
OG0017894	1	1	1	1	4
OG0017895	1	1	1	1	4
OG0017896	1	1	1	1	4
OG0017897	1	1	1	1	4
OG0017898	1	1	1	1	4
OG0017899	1	1	1	1	4
OG0017900	2	2	0	0	4
OG0017901	1	1	1	1	4
OG0017902	1	1	2	0	4
OG0017903	1	1	1	1	4
OG0017904	1	1	1	1	4
OG0017905	1	1	1	1	4
OG0017906	1	1	1	1	4
OG0017907	1	1	1	1	4
OG0017908	1	1	1	1	4
OG0017909	1	1	1	1	4
OG0017910	1	1	1	1	4
OG0017911	1	1	1	1	4
OG0017912	1	0	2	1	4
OG0017913	1	1	1	1	4
OG0017914	1	1	1	1	4
OG0017915	1	1	1	1	4
OG0017916	1	1	1	1	4
OG0017917	1	1	1	1	4
OG0017918	1	1	1	1	4
OG0017919	1	1	1	1	4
OG0017920	1	1	1	1	4
OG0017921	1	1	1	1	4
OG0017922	1	0	1	2	4
OG0017923	1	1	1	1	4
OG0017924	1	1	1	1	4
OG0017925	1	1	1	1	4
OG0017926	1	0	1	2	4
OG0017927	1	1	1	1	4
OG0017928	1	1	1	1	4
OG0017929	1	1	1	1	4
OG0017930	1	1	1	1	4
OG0017931	1	3	0	0	4
OG0017932	1	1	1	1	4
OG0017933	1	1	1	1	4
OG0017934	1	1	1	1	4
OG0017935	1	1	1	1	4
OG0017936	1	1	1	1	4
OG0017937	1	1	1	1	4
OG0017938	1	1	1	1	4
OG0017939	1	1	1	1	4
OG0017940	1	1	1	1	4
OG0017941	1	1	1	1	4
OG0017942	1	1	1	1	4
OG0017943	1	1	1	1	4
OG0017944	1	1	1	1	4
OG0017945	2	0	1	1	4
OG0017946	1	1	1	1	4
OG0017947	1	1	1	1	4
OG0017948	1	1	1	1	4
OG0017949	1	1	1	1	4
OG0017950	1	1	1	1	4
OG0017951	1	1	1	1	4
OG0017952	1	0	1	2	4
OG0017953	1	1	1	1	4
OG0017954	1	1	1	1	4
OG0017955	2	2	0	0	4
OG0017956	1	1	1	1	4
OG0017957	1	1	1	1	4
OG0017958	1	1	1	1	4
OG0017959	1	1	1	1	4
OG0017960	1	1	1	1	4
OG0017961	1	1	1	1	4
OG0017962	1	1	1	1	4
OG0017963	1	1	1	1	4
OG0017964	2	2	0	0	4
OG0017965	1	1	1	1	4
OG0017966	1	1	1	1	4
OG0017967	1	1	1	1	4
OG0017968	1	1	1	1	4
OG0017969	1	1	1	1	4
OG0017970	3	1	0	0	4
OG0017971	1	1	1	1	4
OG0017972	1	1	1	1	4
OG0017973	1	1	1	1	4
OG0017974	1	1	1	1	4
OG0017975	1	1	1	1	4
OG0017976	1	1	1	1	4
OG0017977	1	1	1	1	4
OG0017978	1	1	1	1	4
OG0017979	1	1	1	1	4
OG0017980	1	1	1	1	4
OG0017981	1	1	1	1	4
OG0017982	1	1	1	1	4
OG0017983	1	1	1	1	4
OG0017984	2	2	0	0	4
OG0017985	1	1	1	1	4
OG0017986	1	1	1	1	4
OG0017987	1	1	1	1	4
OG0017988	2	2	0	0	4
OG0017989	1	1	1	1	4
OG0017990	1	1	1	1	4
OG0017991	1	1	1	1	4
OG0017992	3	1	0	0	4
OG0017993	1	1	1	1	4
OG0017994	3	1	0	0	4
OG0017995	1	1	1	1	4
OG0017996	1	1	1	1	4
OG0017997	1	1	1	1	4
OG0017998	1	1	1	1	4
OG0017999	1	1	1	1	4
OG0018000	1	1	1	1	4
OG0018001	1	1	1	1	4
OG0018002	1	1	1	1	4
OG0018003	1	1	1	1	4
OG0018004	1	1	1	1	4
OG0018005	1	1	1	1	4
OG0018006	1	1	1	1	4
OG0018007	3	1	0	0	4
OG0018008	4	0	0	0	4
OG0018009	1	1	1	1	4
OG0018010	1	1	1	1	4
OG0018011	1	1	1	1	4
OG0018012	3	1	0	0	4
OG0018013	1	1	1	1	4
OG0018014	1	1	1	1	4
OG0018015	1	3	0	0	4
OG0018016	1	1	1	1	4
OG0018017	1	1	1	1	4
OG0018018	1	1	1	1	4
OG0018019	1	1	1	1	4
OG0018020	1	1	1	1	4
OG0018021	1	1	1	1	4
OG0018022	1	1	1	1	4
OG0018023	1	1	1	1	4
OG0018024	1	1	1	1	4
OG0018025	2	0	1	1	4
OG0018026	1	1	1	1	4
OG0018027	1	1	1	1	4
OG0018028	1	1	1	1	4
OG0018029	1	1	1	1	4
OG0018030	1	1	1	1	4
OG0018031	1	1	1	1	4
OG0018032	1	1	1	1	4
OG0018033	1	1	1	1	4
OG0018034	1	1	1	1	4
OG0018035	1	1	1	1	4
OG0018036	1	3	0	0	4
OG0018037	1	1	1	1	4
OG0018038	1	3	0	0	4
OG0018039	1	1	1	1	4
OG0018040	1	1	1	1	4
OG0018041	1	1	1	1	4
OG0018042	1	0	2	1	4
OG0018043	1	1	1	1	4
OG0018044	1	1	1	1	4
OG0018045	3	1	0	0	4
OG0018046	1	1	1	1	4
OG0018047	1	1	1	1	4
OG0018048	2	2	0	0	4
OG0018049	1	1	1	1	4
OG0018050	1	1	1	1	4
OG0018051	1	1	1	1	4
OG0018052	1	1	1	1	4
OG0018053	1	1	1	1	4
OG0018054	1	1	1	1	4
OG0018055	1	1	1	1	4
OG0018056	1	1	1	1	4
OG0018057	1	1	1	1	4
OG0018058	1	1	1	1	4
OG0018059	1	1	1	1	4
OG0018060	1	1	1	1	4
OG0018061	1	1	1	1	4
OG0018062	1	1	1	1	4
OG0018063	1	1	1	1	4
OG0018064	1	1	1	1	4
OG0018065	1	1	1	1	4
OG0018066	1	1	1	1	4
OG0018067	1	1	1	1	4
OG0018068	1	1	1	1	4
OG0018069	1	1	1	1	4
OG0018070	1	1	1	1	4
OG0018071	1	1	1	1	4
OG0018072	1	1	1	1	4
OG0018073	1	1	1	1	4
OG0018074	1	1	1	1	4
OG0018075	1	1	1	1	4
OG0018076	1	1	1	1	4
OG0018077	1	1	1	1	4
OG0018078	1	2	0	1	4
OG0018079	1	1	1	1	4
OG0018080	1	1	1	1	4
OG0018081	1	1	1	1	4
OG0018082	1	1	1	1	4
OG0018083	1	1	1	1	4
OG0018084	1	1	1	1	4
OG0018085	1	1	1	1	4
OG0018086	1	1	1	1	4
OG0018087	1	1	1	1	4
OG0018088	1	1	1	1	4
OG0018089	1	1	1	1	4
OG0018090	1	1	1	1	4
OG0018091	1	1	1	1	4
OG0018092	1	1	1	1	4
OG0018093	1	1	1	1	4
OG0018094	1	1	1	1	4
OG0018095	1	1	1	1	4
OG0018096	1	1	1	1	4
OG0018097	1	1	1	1	4
OG0018098	3	1	0	0	4
OG0018099	1	1	1	1	4
OG0018100	1	1	1	1	4
OG0018101	1	1	1	1	4
OG0018102	1	1	1	1	4
OG0018103	1	1	1	1	4
OG0018104	1	1	1	1	4
OG0018105	1	1	1	1	4
OG0018106	1	1	1	1	4
OG0018107	1	1	1	1	4
OG0018108	1	1	1	1	4
OG0018109	1	1	1	1	4
OG0018110	1	1	1	1	4
OG0018111	1	1	1	1	4
OG0018112	1	1	1	1	4
OG0018113	1	1	1	1	4
OG0018114	1	0	2	1	4
OG0018115	1	0	2	1	4
OG0018116	1	1	1	1	4
OG0018117	1	1	1	1	4
OG0018118	1	1	1	1	4
OG0018119	1	2	1	0	4
OG0018120	1	2	1	0	4
OG0018121	1	1	1	1	4
OG0018122	1	1	1	1	4
OG0018123	1	1	1	1	4
OG0018124	1	1	1	1	4
OG0018125	1	1	1	1	4
OG0018126	1	1	1	1	4
OG0018127	1	1	1	1	4
OG0018128	1	1	2	0	4
OG0018129	1	1	1	1	4
OG0018130	1	1	1	1	4
OG0018131	1	1	1	1	4
OG0018132	1	1	1	1	4
OG0018133	1	1	1	1	4
OG0018134	1	1	1	1	4
OG0018135	2	1	0	1	4
OG0018136	1	1	1	1	4
OG0018137	1	1	1	1	4
OG0018138	1	1	1	1	4
OG0018139	1	1	1	1	4
OG0018140	1	1	1	1	4
OG0018141	1	1	1	1	4
OG0018142	1	1	1	1	4
OG0018143	1	1	1	1	4
OG0018144	1	1	1	1	4
OG0018145	1	1	1	1	4
OG0018146	1	1	1	1	4
OG0018147	1	1	1	1	4
OG0018148	1	1	1	1	4
OG0018149	1	1	1	1	4
OG0018150	1	1	1	1	4
OG0018151	1	1	1	1	4
OG0018152	1	1	1	1	4
OG0018153	1	1	1	1	4
OG0018154	1	1	1	1	4
OG0018155	1	1	1	1	4
OG0018156	1	1	1	1	4
OG0018157	1	1	1	1	4
OG0018158	1	1	1	1	4
OG0018159	1	1	1	1	4
OG0018160	1	1	1	1	4
OG0018161	1	1	1	1	4
OG0018162	1	1	1	1	4
OG0018163	1	1	1	1	4
OG0018164	1	1	1	1	4
OG0018165	1	1	1	1	4
OG0018166	1	1	1	1	4
OG0018167	1	1	1	1	4
OG0018168	1	1	1	1	4
OG0018169	1	1	1	1	4
OG0018170	1	1	1	1	4
OG0018171	1	1	1	1	4
OG0018172	1	1	1	1	4
OG0018173	1	0	2	1	4
OG0018174	1	1	1	1	4
OG0018175	1	1	1	1	4
OG0018176	1	1	1	1	4
OG0018177	1	1	1	1	4
OG0018178	1	1	1	1	4
OG0018179	1	1	1	1	4
OG0018180	1	1	1	1	4
OG0018181	1	1	1	1	4
OG0018182	1	1	1	1	4
OG0018183	1	1	1	1	4
OG0018184	1	1	1	1	4
OG0018185	1	1	1	1	4
OG0018186	1	1	1	1	4
OG0018187	1	1	1	1	4
OG0018188	1	1	1	1	4
OG0018189	1	1	1	1	4
OG0018190	1	1	1	1	4
OG0018191	1	1	1	1	4
OG0018192	1	1	1	1	4
OG0018193	1	1	1	1	4
OG0018194	1	1	1	1	4
OG0018195	1	1	1	1	4
OG0018196	1	1	1	1	4
OG0018197	1	1	1	1	4
OG0018198	1	1	1	1	4
OG0018199	1	1	1	1	4
OG0018200	1	1	1	1	4
OG0018201	1	1	1	1	4
OG0018202	1	1	1	1	4
OG0018203	1	1	1	1	4
OG0018204	1	1	1	1	4
OG0018205	1	1	1	1	4
OG0018206	1	1	1	1	4
OG0018207	1	1	1	1	4
OG0018208	1	1	1	1	4
OG0018209	1	1	1	1	4
OG0018210	1	1	1	1	4
OG0018211	1	1	1	1	4
OG0018212	1	2	1	0	4
OG0018213	1	1	1	1	4
OG0018214	1	1	1	1	4
OG0018215	1	1	1	1	4
OG0018216	1	1	1	1	4
OG0018217	2	0	1	1	4
OG0018218	1	1	1	1	4
OG0018219	1	1	1	1	4
OG0018220	1	1	1	1	4
OG0018221	1	1	1	1	4
OG0018222	1	1	1	1	4
OG0018223	1	1	1	1	4
OG0018224	3	0	1	0	4
OG0018225	1	1	1	1	4
OG0018226	1	1	1	1	4
OG0018227	1	1	1	1	4
OG0018228	1	1	1	1	4
OG0018229	1	1	1	1	4
OG0018230	1	1	1	1	4
OG0018231	1	1	1	1	4
OG0018232	1	1	1	1	4
OG0018233	1	1	1	1	4
OG0018234	1	1	1	1	4
OG0018235	1	1	1	1	4
OG0018236	1	1	1	1	4
OG0018237	1	1	1	1	4
OG0018238	1	1	1	1	4
OG0018239	1	1	1	1	4
OG0018240	1	1	1	1	4
OG0018241	1	1	1	1	4
OG0018242	1	1	1	1	4
OG0018243	1	1	1	1	4
OG0018244	1	1	1	1	4
OG0018245	1	1	1	1	4
OG0018246	1	1	1	1	4
OG0018247	1	1	1	1	4
OG0018248	1	1	1	1	4
OG0018249	1	1	1	1	4
OG0018250	1	1	1	1	4
OG0018251	1	1	1	1	4
OG0018252	1	1	1	1	4
OG0018253	1	1	1	1	4
OG0018254	1	1	1	1	4
OG0018255	1	1	1	1	4
OG0018256	1	1	1	1	4
OG0018257	1	1	1	1	4
OG0018258	1	1	1	1	4
OG0018259	1	1	1	1	4
OG0018260	1	1	1	1	4
OG0018261	1	1	1	1	4
OG0018262	1	1	1	1	4
OG0018263	1	1	1	1	4
OG0018264	1	0	2	1	4
OG0018265	2	0	2	0	4
OG0018266	1	0	2	1	4
OG0018267	1	1	1	1	4
OG0018268	1	1	1	1	4
OG0018269	1	1	1	1	4
OG0018270	1	0	1	2	4
OG0018271	1	0	1	2	4
OG0018272	1	1	1	1	4
OG0018273	1	1	1	1	4
OG0018274	1	1	1	1	4
OG0018275	1	1	1	1	4
OG0018276	1	1	1	1	4
OG0018277	1	1	1	1	4
OG0018278	1	1	1	1	4
OG0018279	1	1	1	1	4
OG0018280	1	1	1	1	4
OG0018281	1	1	1	1	4
OG0018282	1	1	1	1	4
OG0018283	1	1	1	1	4
OG0018284	1	1	1	1	4
OG0018285	1	1	1	1	4
OG0018286	1	1	1	1	4
OG0018287	2	0	1	1	4
OG0018288	1	1	1	1	4
OG0018289	1	1	1	1	4
OG0018290	1	1	1	1	4
OG0018291	1	1	1	1	4
OG0018292	1	1	1	1	4
OG0018293	1	1	1	1	4
OG0018294	2	2	0	0	4
OG0018295	3	1	0	0	4
OG0018296	1	1	1	1	4
OG0018297	1	0	3	0	4
OG0018298	1	1	1	1	4
OG0018299	1	1	1	1	4
OG0018300	1	1	1	1	4
OG0018301	1	1	1	1	4
OG0018302	1	1	1	1	4
OG0018303	1	1	1	1	4
OG0018304	1	1	1	1	4
OG0018305	1	1	1	1	4
OG0018306	1	1	1	1	4
OG0018307	1	1	1	1	4
OG0018308	1	1	1	1	4
OG0018309	1	1	1	1	4
OG0018310	1	3	0	0	4
OG0018311	1	1	1	1	4
OG0018312	1	1	1	1	4
OG0018313	1	1	1	1	4
OG0018314	1	1	1	1	4
OG0018315	1	1	1	1	4
OG0018316	1	1	1	1	4
OG0018317	1	1	1	1	4
OG0018318	1	1	1	1	4
OG0018319	1	1	1	1	4
OG0018320	1	1	1	1	4
OG0018321	1	1	1	1	4
OG0018322	1	1	1	1	4
OG0018323	1	1	1	1	4
OG0018324	1	1	1	1	4
OG0018325	1	1	1	1	4
OG0018326	1	1	1	1	4
OG0018327	1	1	1	1	4
OG0018328	1	1	1	1	4
OG0018329	1	1	1	1	4
OG0018330	1	1	1	1	4
OG0018331	1	1	1	1	4
OG0018332	1	1	1	1	4
OG0018333	1	1	1	1	4
OG0018334	1	1	1	1	4
OG0018335	1	1	1	1	4
OG0018336	1	1	1	1	4
OG0018337	1	1	1	1	4
OG0018338	1	1	1	1	4
OG0018339	1	1	1	1	4
OG0018340	1	1	1	1	4
OG0018341	1	1	1	1	4
OG0018342	1	1	1	1	4
OG0018343	1	1	1	1	4
OG0018344	1	1	1	1	4
OG0018345	1	1	1	1	4
OG0018346	1	1	1	1	4
OG0018347	1	1	1	1	4
OG0018348	1	1	1	1	4
OG0018349	1	1	1	1	4
OG0018350	1	1	1	1	4
OG0018351	1	3	0	0	4
OG0018352	1	1	1	1	4
OG0018353	1	1	1	1	4
OG0018354	1	1	1	1	4
OG0018355	1	1	1	1	4
OG0018356	1	1	1	1	4
OG0018357	1	0	2	1	4
OG0018358	1	1	1	1	4
OG0018359	1	1	1	1	4
OG0018360	1	1	1	1	4
OG0018361	1	1	1	1	4
OG0018362	1	1	1	1	4
OG0018363	2	2	0	0	4
OG0018364	1	1	1	1	4
OG0018365	1	1	1	1	4
OG0018366	2	2	0	0	4
OG0018367	1	1	1	1	4
OG0018368	1	1	1	1	4
OG0018369	1	1	1	1	4
OG0018370	1	1	1	1	4
OG0018371	1	0	2	1	4
OG0018372	1	3	0	0	4
OG0018373	1	1	1	1	4
OG0018374	1	1	1	1	4
OG0018375	2	0	1	1	4
OG0018376	1	1	1	1	4
OG0018377	1	1	1	1	4
OG0018378	1	1	1	1	4
OG0018379	1	1	1	1	4
OG0018380	1	1	1	1	4
OG0018381	1	1	1	1	4
OG0018382	1	1	1	1	4
OG0018383	1	1	1	1	4
OG0018384	1	1	1	1	4
OG0018385	1	1	1	1	4
OG0018386	1	1	1	1	4
OG0018387	1	1	1	1	4
OG0018388	1	1	1	1	4
OG0018389	1	1	1	1	4
OG0018390	1	1	1	1	4
OG0018391	1	1	1	1	4
OG0018392	1	1	1	1	4
OG0018393	1	1	1	1	4
OG0018394	1	1	1	1	4
OG0018395	1	1	1	1	4
OG0018396	1	1	1	1	4
OG0018397	1	1	1	1	4
OG0018398	1	1	1	1	4
OG0018399	1	1	1	1	4
OG0018400	1	1	1	1	4
OG0018401	1	1	1	1	4
OG0018402	1	1	1	1	4
OG0018403	1	1	1	1	4
OG0018404	1	1	1	1	4
OG0018405	1	1	1	1	4
OG0018406	1	1	1	1	4
OG0018407	1	1	1	1	4
OG0018408	1	1	1	1	4
OG0018409	1	1	1	1	4
OG0018410	1	1	1	1	4
OG0018411	1	1	1	1	4
OG0018412	1	1	1	1	4
OG0018413	1	1	1	1	4
OG0018414	1	1	1	1	4
OG0018415	1	1	1	1	4
OG0018416	1	1	1	1	4
OG0018417	1	1	1	1	4
OG0018418	1	1	1	1	4
OG0018419	1	1	1	1	4
OG0018420	1	1	1	1	4
OG0018421	1	1	1	1	4
OG0018422	1	1	1	1	4
OG0018423	1	1	1	1	4
OG0018424	1	1	1	1	4
OG0018425	1	1	1	1	4
OG0018426	1	1	1	1	4
OG0018427	1	1	1	1	4
OG0018428	1	3	0	0	4
OG0018429	1	1	1	1	4
OG0018430	1	1	1	1	4
OG0018431	1	1	1	1	4
OG0018432	1	1	1	1	4
OG0018433	1	1	1	1	4
OG0018434	1	1	1	1	4
OG0018435	1	1	1	1	4
OG0018436	1	1	1	1	4
OG0018437	1	1	1	1	4
OG0018438	1	1	1	1	4
OG0018439	1	1	1	1	4
OG0018440	1	1	1	1	4
OG0018441	1	1	1	1	4
OG0018442	1	1	1	1	4
OG0018443	1	1	1	1	4
OG0018444	1	1	1	1	4
OG0018445	2	1	0	1	4
OG0018446	1	1	1	1	4
OG0018447	3	1	0	0	4
OG0018448	2	2	0	0	4
OG0018449	4	0	0	0	4
OG0018450	1	1	1	1	4
OG0018451	1	1	1	1	4
OG0018452	1	1	1	1	4
OG0018453	1	1	1	1	4
OG0018454	1	1	1	1	4
OG0018455	1	1	1	1	4
OG0018456	1	1	1	1	4
OG0018457	1	1	1	1	4
OG0018458	1	1	1	1	4
OG0018459	1	1	1	1	4
OG0018460	1	1	1	1	4
OG0018461	1	1	1	1	4
OG0018462	1	1	1	1	4
OG0018463	1	1	1	1	4
OG0018464	1	1	1	1	4
OG0018465	1	1	1	1	4
OG0018466	1	1	1	1	4
OG0018467	1	1	1	1	4
OG0018468	3	1	0	0	4
OG0018469	1	1	1	1	4
OG0018470	1	1	1	1	4
OG0018471	1	3	0	0	4
OG0018472	1	1	1	1	4
OG0018473	1	3	0	0	4
OG0018474	1	1	1	1	4
OG0018475	1	1	1	1	4
OG0018476	1	1	1	1	4
OG0018477	1	1	1	1	4
OG0018478	1	1	1	1	4
OG0018479	1	1	1	1	4
OG0018480	1	1	1	1	4
OG0018481	1	1	1	1	4
OG0018482	1	1	1	1	4
OG0018483	1	1	1	1	4
OG0018484	1	1	1	1	4
OG0018485	1	1	1	1	4
OG0018486	1	1	1	1	4
OG0018487	1	1	0	2	4
OG0018488	1	1	1	1	4
OG0018489	1	1	1	1	4
OG0018490	1	1	1	1	4
OG0018491	1	1	1	1	4
OG0018492	3	1	0	0	4
OG0018493	1	1	1	1	4
OG0018494	1	1	1	1	4
OG0018495	1	3	0	0	4
OG0018496	1	1	1	1	4
OG0018497	1	1	1	1	4
OG0018498	1	1	1	1	4
OG0018499	3	1	0	0	4
OG0018500	1	1	1	1	4
OG0018501	1	1	1	1	4
OG0018502	1	1	1	1	4
OG0018503	1	1	1	1	4
OG0018504	1	1	1	1	4
OG0018505	1	1	1	1	4
OG0018506	1	1	1	1	4
OG0018507	1	1	1	1	4
OG0018508	1	1	1	1	4
OG0018509	1	1	1	1	4
OG0018510	1	1	1	1	4
OG0018511	1	1	1	1	4
OG0018512	1	1	1	1	4
OG0018513	1	1	1	1	4
OG0018514	1	1	1	1	4
OG0018515	1	1	1	1	4
OG0018516	1	1	1	1	4
OG0018517	1	3	0	0	4
OG0018518	1	1	1	1	4
OG0018519	1	1	1	1	4
OG0018520	1	1	1	1	4
OG0018521	1	1	1	1	4
OG0018522	1	1	1	1	4
OG0018523	3	0	1	0	4
OG0018524	1	1	1	1	4
OG0018525	1	1	1	1	4
OG0018526	1	1	1	1	4
OG0018527	1	1	1	1	4
OG0018528	1	1	1	1	4
OG0018529	1	1	1	1	4
OG0018530	1	1	1	1	4
OG0018531	1	1	1	1	4
OG0018532	3	0	1	0	4
OG0018533	1	1	1	1	4
OG0018534	1	1	1	1	4
OG0018535	1	1	1	1	4
OG0018536	1	1	1	1	4
OG0018537	2	1	0	1	4
OG0018538	1	1	1	1	4
OG0018539	1	1	1	1	4
OG0018540	1	1	1	1	4
OG0018541	1	1	1	1	4
OG0018542	1	3	0	0	4
OG0018543	1	1	1	1	4
OG0018544	1	1	1	1	4
OG0018545	1	1	1	1	4
OG0018546	1	1	1	1	4
OG0018547	1	1	1	1	4
OG0018548	1	1	1	1	4
OG0018549	1	1	1	1	4
OG0018550	1	1	1	1	4
OG0018551	1	1	1	1	4
OG0018552	2	2	0	0	4
OG0018553	1	1	1	1	4
OG0018554	1	1	1	1	4
OG0018555	1	1	1	1	4
OG0018556	1	1	1	1	4
OG0018557	1	1	1	1	4
OG0018558	1	1	1	1	4
OG0018559	1	1	1	1	4
OG0018560	1	1	1	1	4
OG0018561	1	1	1	1	4
OG0018562	1	1	1	1	4
OG0018563	1	1	1	1	4
OG0018564	1	1	1	1	4
OG0018565	1	1	1	1	4
OG0018566	1	1	1	1	4
OG0018567	1	1	1	1	4
OG0018568	1	1	1	1	4
OG0018569	1	1	1	1	4
OG0018570	1	1	1	1	4
OG0018571	1	1	1	1	4
OG0018572	1	1	1	1	4
OG0018573	1	1	1	1	4
OG0018574	1	1	1	1	4
OG0018575	1	1	1	1	4
OG0018576	1	1	1	1	4
OG0018577	1	1	1	1	4
OG0018578	1	1	1	1	4
OG0018579	1	1	1	1	4
OG0018580	2	2	0	0	4
OG0018581	1	1	1	1	4
OG0018582	1	1	1	1	4
OG0018583	1	1	1	1	4
OG0018584	1	1	1	1	4
OG0018585	1	1	1	1	4
OG0018586	1	1	1	1	4
OG0018587	1	1	1	1	4
OG0018588	1	0	1	2	4
OG0018589	1	1	1	1	4
OG0018590	1	1	1	1	4
OG0018591	1	1	1	1	4
OG0018592	1	1	1	1	4
OG0018593	1	1	1	1	4
OG0018594	1	1	1	1	4
OG0018595	1	1	1	1	4
OG0018596	1	1	1	1	4
OG0018597	1	1	1	1	4
OG0018598	1	1	1	1	4
OG0018599	1	1	1	1	4
OG0018600	1	1	1	1	4
OG0018601	1	1	1	1	4
OG0018602	1	1	1	1	4
OG0018603	1	1	1	1	4
OG0018604	1	1	1	1	4
OG0018605	2	1	1	0	4
OG0018606	1	1	1	1	4
OG0018607	1	0	1	2	4
OG0018608	1	1	1	1	4
OG0018609	1	1	1	1	4
OG0018610	1	1	1	1	4
OG0018611	1	1	1	1	4
OG0018612	1	1	1	1	4
OG0018613	1	1	1	1	4
OG0018614	1	1	1	1	4
OG0018615	1	1	1	1	4
OG0018616	1	1	1	1	4
OG0018617	1	1	1	1	4
OG0018618	1	1	1	1	4
OG0018619	1	1	1	1	4
OG0018620	1	1	1	1	4
OG0018621	1	1	1	1	4
OG0018622	1	1	1	1	4
OG0018623	1	1	1	1	4
OG0018624	1	1	1	1	4
OG0018625	3	0	0	1	4
OG0018626	1	0	1	2	4
OG0018627	4	0	0	0	4
OG0018628	1	1	1	1	4
OG0018629	1	1	1	1	4
OG0018630	1	1	1	1	4
OG0018631	1	1	1	1	4
OG0018632	1	1	1	1	4
OG0018633	1	1	1	1	4
OG0018634	1	1	1	1	4
OG0018635	1	1	1	1	4
OG0018636	1	1	1	1	4
OG0018637	1	0	2	1	4
OG0018638	1	1	1	1	4
OG0018639	1	1	1	1	4
OG0018640	1	1	1	1	4
OG0018641	1	1	1	1	4
OG0018642	1	1	1	1	4
OG0018643	1	1	1	1	4
OG0018644	1	1	1	1	4
OG0018645	1	1	1	1	4
OG0018646	1	1	1	1	4
OG0018647	1	1	1	1	4
OG0018648	1	1	1	1	4
OG0018649	1	1	1	1	4
OG0018650	1	1	1	1	4
OG0018651	1	1	1	1	4
OG0018652	1	1	1	1	4
OG0018653	1	1	1	1	4
OG0018654	1	1	1	1	4
OG0018655	1	1	1	1	4
OG0018656	1	1	1	1	4
OG0018657	1	1	1	1	4
OG0018658	1	1	1	1	4
OG0018659	1	1	1	1	4
OG0018660	1	1	1	1	4
OG0018661	1	1	1	1	4
OG0018662	1	1	1	1	4
OG0018663	1	1	1	1	4
OG0018664	1	1	1	1	4
OG0018665	1	1	1	1	4
OG0018666	1	1	1	1	4
OG0018667	1	1	1	1	4
OG0018668	3	0	1	0	4
OG0018669	1	1	1	1	4
OG0018670	1	1	1	1	4
OG0018671	1	1	1	1	4
OG0018672	1	1	1	1	4
OG0018673	1	1	1	1	4
OG0018674	1	1	1	1	4
OG0018675	2	0	1	1	4
OG0018676	1	1	1	1	4
OG0018677	1	0	1	2	4
OG0018678	1	1	1	1	4
OG0018679	1	1	1	1	4
OG0018680	1	1	1	1	4
OG0018681	1	1	1	1	4
OG0018682	1	1	1	1	4
OG0018683	1	1	1	1	4
OG0018684	1	1	1	1	4
OG0018685	1	1	1	1	4
OG0018686	1	1	1	1	4
OG0018687	1	1	1	1	4
OG0018688	1	1	0	2	4
OG0018689	1	1	1	1	4
OG0018690	1	1	1	1	4
OG0018691	1	1	1	1	4
OG0018692	1	1	1	1	4
OG0018693	1	1	1	1	4
OG0018694	1	1	1	1	4
OG0018695	1	1	1	1	4
OG0018696	1	0	0	3	4
OG0018697	1	1	1	1	4
OG0018698	1	1	1	1	4
OG0018699	1	1	1	1	4
OG0018700	1	1	1	1	4
OG0018701	1	1	1	1	4
OG0018702	1	1	1	1	4
OG0018703	1	1	1	1	4
OG0018704	1	1	1	1	4
OG0018705	1	1	1	1	4
OG0018706	1	1	1	1	4
OG0018707	1	1	1	1	4
OG0018708	1	1	1	1	4
OG0018709	1	1	1	1	4
OG0018710	1	1	1	1	4
OG0018711	1	1	1	1	4
OG0018712	1	1	1	1	4
OG0018713	1	1	1	1	4
OG0018714	1	1	1	1	4
OG0018715	1	1	1	1	4
OG0018716	1	1	1	1	4
OG0018717	1	1	1	1	4
OG0018718	1	1	1	1	4
OG0018719	1	1	1	1	4
OG0018720	1	1	1	1	4
OG0018721	1	1	1	1	4
OG0018722	1	1	1	1	4
OG0018723	1	1	1	1	4
OG0018724	1	1	1	1	4
OG0018725	1	1	1	1	4
OG0018726	1	1	1	1	4
OG0018727	1	1	1	1	4
OG0018728	1	1	1	1	4
OG0018729	1	1	1	1	4
OG0018730	1	1	1	1	4
OG0018731	1	1	1	1	4
OG0018732	1	1	1	1	4
OG0018733	1	1	1	1	4
OG0018734	1	1	1	1	4
OG0018735	1	1	1	1	4
OG0018736	1	1	1	1	4
OG0018737	1	1	1	1	4
OG0018738	1	1	1	1	4
OG0018739	1	1	1	1	4
OG0018740	1	1	1	1	4
OG0018741	1	1	1	1	4
OG0018742	1	1	1	1	4
OG0018743	1	1	1	1	4
OG0018744	1	1	1	1	4
OG0018745	1	1	1	1	4
OG0018746	1	1	1	1	4
OG0018747	1	1	1	1	4
OG0018748	1	1	1	1	4
OG0018749	1	1	1	1	4
OG0018750	1	1	1	1	4
OG0018751	1	1	1	1	4
OG0018752	1	1	1	1	4
OG0018753	1	1	1	1	4
OG0018754	1	1	1	1	4
OG0018755	1	1	1	1	4
OG0018756	1	1	1	1	4
OG0018757	1	1	1	1	4
OG0018758	1	1	1	1	4
OG0018759	1	1	1	1	4
OG0018760	1	1	1	1	4
OG0018761	1	1	1	1	4
OG0018762	1	1	1	1	4
OG0018763	1	1	1	1	4
OG0018764	1	1	1	1	4
OG0018765	1	1	1	1	4
OG0018766	1	1	1	1	4
OG0018767	1	1	1	1	4
OG0018768	1	1	1	1	4
OG0018769	1	1	1	1	4
OG0018770	1	1	1	1	4
OG0018771	1	1	1	1	4
OG0018772	1	1	1	1	4
OG0018773	1	1	1	1	4
OG0018774	1	1	1	1	4
OG0018775	1	0	2	1	4
OG0018776	1	1	1	1	4
OG0018777	1	1	1	1	4
OG0018778	1	1	1	1	4
OG0018779	1	1	1	1	4
OG0018780	1	1	1	1	4
OG0018781	1	1	1	1	4
OG0018782	1	1	1	1	4
OG0018783	1	1	1	1	4
OG0018784	1	1	1	1	4
OG0018785	1	1	1	1	4
OG0018786	2	1	1	0	4
OG0018787	1	1	1	1	4
OG0018788	1	1	1	1	4
OG0018789	1	1	1	1	4
OG0018790	1	1	1	1	4
OG0018791	1	1	1	1	4
OG0018792	1	1	1	1	4
OG0018793	1	1	1	1	4
OG0018794	1	1	1	1	4
OG0018795	1	1	1	1	4
OG0018796	1	1	1	1	4
OG0018797	1	1	1	1	4
OG0018798	1	1	1	1	4
OG0018799	1	1	1	1	4
OG0018800	1	1	1	1	4
OG0018801	1	1	1	1	4
OG0018802	1	1	1	1	4
OG0018803	1	1	1	1	4
OG0018804	1	1	1	1	4
OG0018805	1	1	1	1	4
OG0018806	1	1	1	1	4
OG0018807	1	1	1	1	4
OG0018808	1	1	1	1	4
OG0018809	1	1	1	1	4
OG0018810	1	1	1	1	4
OG0018811	1	1	1	1	4
OG0018812	1	1	1	1	4
OG0018813	1	1	1	1	4
OG0018814	1	1	1	1	4
OG0018815	1	1	1	1	4
OG0018816	1	1	1	1	4
OG0018817	1	1	1	1	4
OG0018818	1	1	1	1	4
OG0018819	1	1	1	1	4
OG0018820	1	1	1	1	4
OG0018821	1	0	1	2	4
OG0018822	1	1	1	1	4
OG0018823	1	1	1	1	4
OG0018824	1	1	1	1	4
OG0018825	1	1	1	1	4
OG0018826	1	1	1	1	4
OG0018827	1	1	1	1	4
OG0018828	1	1	1	1	4
OG0018829	1	1	1	1	4
OG0018830	1	1	1	1	4
OG0018831	1	1	1	1	4
OG0018832	1	1	1	1	4
OG0018833	1	1	1	1	4
OG0018834	1	1	1	1	4
OG0018835	1	1	1	1	4
OG0018836	1	1	1	1	4
OG0018837	1	1	1	1	4
OG0018838	1	1	1	1	4
OG0018839	1	1	1	1	4
OG0018840	1	1	1	1	4
OG0018841	1	1	1	1	4
OG0018842	1	1	1	1	4
OG0018843	1	1	1	1	4
OG0018844	1	1	1	1	4
OG0018845	1	1	1	1	4
OG0018846	1	1	1	1	4
OG0018847	1	1	1	1	4
OG0018848	1	1	1	1	4
OG0018849	1	1	1	1	4
OG0018850	1	1	1	1	4
OG0018851	1	1	1	1	4
OG0018852	1	1	1	1	4
OG0018853	1	1	1	1	4
OG0018854	1	1	1	1	4
OG0018855	1	1	1	1	4
OG0018856	1	1	1	1	4
OG0018857	1	1	1	1	4
OG0018858	1	1	1	1	4
OG0018859	1	1	1	1	4
OG0018860	1	1	1	1	4
OG0018861	1	1	1	1	4
OG0018862	1	1	1	1	4
OG0018863	1	1	1	1	4
OG0018864	1	1	1	1	4
OG0018865	1	1	1	1	4
OG0018866	1	1	1	1	4
OG0018867	1	1	1	1	4
OG0018868	1	1	1	1	4
OG0018869	1	1	2	0	4
OG0018870	1	1	1	1	4
OG0018871	1	1	1	1	4
OG0018872	1	1	1	1	4
OG0018873	1	1	1	1	4
OG0018874	1	1	1	1	4
OG0018875	1	1	1	1	4
OG0018876	1	1	1	1	4
OG0018877	1	1	1	1	4
OG0018878	1	1	1	1	4
OG0018879	1	1	1	1	4
OG0018880	1	1	1	1	4
OG0018881	1	1	1	1	4
OG0018882	1	1	1	1	4
OG0018883	1	1	1	1	4
OG0018884	1	1	1	1	4
OG0018885	1	1	1	1	4
OG0018886	1	1	1	1	4
OG0018887	1	1	1	1	4
OG0018888	1	1	1	1	4
OG0018889	1	1	1	1	4
OG0018890	1	1	1	1	4
OG0018891	1	1	1	1	4
OG0018892	1	1	1	1	4
OG0018893	1	1	1	1	4
OG0018894	1	0	2	1	4
OG0018895	1	1	1	1	4
OG0018896	1	1	1	1	4
OG0018897	1	1	1	1	4
OG0018898	1	1	1	1	4
OG0018899	1	1	1	1	4
OG0018900	1	1	1	1	4
OG0018901	1	1	1	1	4
OG0018902	1	1	1	1	4
OG0018903	1	1	1	1	4
OG0018904	1	1	1	1	4
OG0018905	1	1	1	1	4
OG0018906	1	1	1	1	4
OG0018907	1	1	1	1	4
OG0018908	1	1	1	1	4
OG0018909	1	1	1	1	4
OG0018910	1	1	1	1	4
OG0018911	1	1	1	1	4
OG0018912	1	1	1	1	4
OG0018913	1	1	1	1	4
OG0018914	1	1	1	1	4
OG0018915	1	1	1	1	4
OG0018916	1	1	1	1	4
OG0018917	1	1	1	1	4
OG0018918	1	1	1	1	4
OG0018919	1	1	1	1	4
OG0018920	1	1	1	1	4
OG0018921	1	1	1	1	4
OG0018922	1	1	1	1	4
OG0018923	1	1	1	1	4
OG0018924	1	1	1	1	4
OG0018925	1	1	1	1	4
OG0018926	1	1	1	1	4
OG0018927	1	1	1	1	4
OG0018928	1	1	1	1	4
OG0018929	1	3	0	0	4
OG0018930	1	1	1	1	4
OG0018931	1	1	1	1	4
OG0018932	1	1	1	1	4
OG0018933	1	1	1	1	4
OG0018934	1	1	1	1	4
OG0018935	1	1	1	1	4
OG0018936	1	1	1	1	4
OG0018937	1	1	1	1	4
OG0018938	1	1	1	1	4
OG0018939	1	1	1	1	4
OG0018940	1	1	1	1	4
OG0018941	1	1	1	1	4
OG0018942	1	1	1	1	4
OG0018943	1	1	1	1	4
OG0018944	2	0	1	1	4
OG0018945	1	1	1	1	4
OG0018946	1	1	1	1	4
OG0018947	1	1	1	1	4
OG0018948	1	1	1	1	4
OG0018949	1	1	1	1	4
OG0018950	1	1	1	1	4
OG0018951	1	1	1	1	4
OG0018952	1	1	1	1	4
OG0018953	1	1	1	1	4
OG0018954	1	1	1	1	4
OG0018955	1	1	1	1	4
OG0018956	1	1	1	1	4
OG0018957	1	1	1	1	4
OG0018958	1	1	1	1	4
OG0018959	1	1	1	1	4
OG0018960	1	1	1	1	4
OG0018961	1	1	1	1	4
OG0018962	1	1	1	1	4
OG0018963	1	1	1	1	4
OG0018964	1	1	1	1	4
OG0018965	1	1	1	1	4
OG0018966	1	1	1	1	4
OG0018967	1	1	1	1	4
OG0018968	1	1	1	1	4
OG0018969	1	1	1	1	4
OG0018970	1	1	1	1	4
OG0018971	1	1	1	1	4
OG0018972	1	1	1	1	4
OG0018973	1	1	1	1	4
OG0018974	1	1	1	1	4
OG0018975	1	1	1	1	4
OG0018976	1	1	1	1	4
OG0018977	1	1	1	1	4
OG0018978	1	1	1	1	4
OG0018979	1	1	1	1	4
OG0018980	1	1	1	1	4
OG0018981	1	1	1	1	4
OG0018982	1	1	1	1	4
OG0018983	1	1	1	1	4
OG0018984	1	1	1	1	4
OG0018985	1	1	1	1	4
OG0018986	1	1	1	1	4
OG0018987	1	1	1	1	4
OG0018988	1	1	1	1	4
OG0018989	1	1	1	1	4
OG0018990	1	1	1	1	4
OG0018991	1	3	0	0	4
OG0018992	1	1	1	1	4
OG0018993	2	0	2	0	4
OG0018994	1	1	1	1	4
OG0018995	1	1	1	1	4
OG0018996	1	1	1	1	4
OG0018997	1	1	1	1	4
OG0018998	1	1	1	1	4
OG0018999	1	1	1	1	4
OG0019000	3	1	0	0	4
OG0019001	1	1	1	1	4
OG0019002	2	1	1	0	4
OG0019003	1	1	1	1	4
OG0019004	1	1	1	1	4
OG0019005	1	1	1	1	4
OG0019006	1	1	1	1	4
OG0019007	1	1	1	1	4
OG0019008	1	1	1	1	4
OG0019009	1	1	1	1	4
OG0019010	1	1	1	1	4
OG0019011	1	1	1	1	4
OG0019012	1	1	1	1	4
OG0019013	1	1	0	2	4
OG0019014	1	1	1	1	4
OG0019015	1	1	1	1	4
OG0019016	1	1	1	1	4
OG0019017	1	1	1	1	4
OG0019018	1	1	1	1	4
OG0019019	1	1	1	1	4
OG0019020	1	1	1	1	4
OG0019021	1	1	1	1	4
OG0019022	1	1	1	1	4
OG0019023	3	1	0	0	4
OG0019024	1	1	1	1	4
OG0019025	1	1	1	1	4
OG0019026	1	1	1	1	4
OG0019027	1	1	1	1	4
OG0019028	1	1	1	1	4
OG0019029	3	1	0	0	4
OG0019030	1	1	1	1	4
OG0019031	1	1	1	1	4
OG0019032	1	1	1	1	4
OG0019033	1	1	1	1	4
OG0019034	1	1	1	1	4
OG0019035	1	1	1	1	4
OG0019036	1	1	1	1	4
OG0019037	1	1	1	1	4
OG0019038	1	1	1	1	4
OG0019039	1	1	1	1	4
OG0019040	1	1	1	1	4
OG0019041	1	1	1	1	4
OG0019042	1	1	1	1	4
OG0019043	1	1	1	1	4
OG0019044	1	1	1	1	4
OG0019045	1	1	1	1	4
OG0019046	1	1	1	1	4
OG0019047	1	1	1	1	4
OG0019048	1	1	1	1	4
OG0019049	1	1	1	1	4
OG0019050	1	1	1	1	4
OG0019051	1	1	2	0	4
OG0019052	1	1	1	1	4
OG0019053	1	1	1	1	4
OG0019054	1	1	1	1	4
OG0019055	1	1	1	1	4
OG0019056	1	1	1	1	4
OG0019057	1	1	1	1	4
OG0019058	1	1	1	1	4
OG0019059	1	1	1	1	4
OG0019060	1	1	1	1	4
OG0019061	2	0	1	1	4
OG0019062	1	1	1	1	4
OG0019063	1	1	1	1	4
OG0019064	1	1	1	1	4
OG0019065	1	1	1	1	4
OG0019066	1	1	1	1	4
OG0019067	1	1	1	1	4
OG0019068	1	1	1	1	4
OG0019069	1	1	1	1	4
OG0019070	1	1	1	1	4
OG0019071	1	1	1	1	4
OG0019072	1	1	1	1	4
OG0019073	1	1	1	1	4
OG0019074	1	1	1	1	4
OG0019075	1	1	1	1	4
OG0019076	1	1	1	1	4
OG0019077	1	1	1	1	4
OG0019078	1	1	1	1	4
OG0019079	1	1	1	1	4
OG0019080	1	1	1	1	4
OG0019081	1	1	1	1	4
OG0019082	1	1	1	1	4
OG0019083	1	1	1	1	4
OG0019084	1	3	0	0	4
OG0019085	1	1	1	1	4
OG0019086	1	1	1	1	4
OG0019087	1	1	1	1	4
OG0019088	1	1	1	1	4
OG0019089	1	1	1	1	4
OG0019090	1	1	1	1	4
OG0019091	1	1	1	1	4
OG0019092	1	1	1	1	4
OG0019093	1	1	1	1	4
OG0019094	1	1	1	1	4
OG0019095	1	1	1	1	4
OG0019096	3	0	1	0	4
OG0019097	1	1	1	1	4
OG0019098	1	1	1	1	4
OG0019099	1	1	1	1	4
OG0019100	1	1	1	1	4
OG0019101	1	1	1	1	4
OG0019102	1	1	1	1	4
OG0019103	1	1	1	1	4
OG0019104	1	1	1	1	4
OG0019105	1	1	1	1	4
OG0019106	1	1	1	1	4
OG0019107	2	2	0	0	4
OG0019108	1	1	1	1	4
OG0019109	1	1	1	1	4
OG0019110	4	0	0	0	4
OG0019111	1	1	1	1	4
OG0019112	1	1	1	1	4
OG0019113	1	1	1	1	4
OG0019114	1	1	1	1	4
OG0019115	1	1	1	1	4
OG0019116	1	1	1	1	4
OG0019117	1	1	1	1	4
OG0019118	1	1	1	1	4
OG0019119	1	1	1	1	4
OG0019120	1	1	1	1	4
OG0019121	1	1	1	1	4
OG0019122	1	1	1	1	4
OG0019123	1	1	1	1	4
OG0019124	1	1	1	1	4
OG0019125	1	1	1	1	4
OG0019126	1	0	2	1	4
OG0019127	1	1	1	1	4
OG0019128	1	1	1	1	4
OG0019129	1	1	1	1	4
OG0019130	1	1	1	1	4
OG0019131	1	1	1	1	4
OG0019132	1	1	1	1	4
OG0019133	1	1	1	1	4
OG0019134	1	1	1	1	4
OG0019135	1	1	1	1	4
OG0019136	1	1	1	1	4
OG0019137	1	1	1	1	4
OG0019138	1	1	1	1	4
OG0019139	2	2	0	0	4
OG0019140	1	1	1	1	4
OG0019141	1	1	1	1	4
OG0019142	1	0	1	2	4
OG0019143	1	1	1	1	4
OG0019144	1	0	1	2	4
OG0019145	3	1	0	0	4
OG0019146	1	1	1	1	4
OG0019147	1	1	1	1	4
OG0019148	1	1	1	1	4
OG0019149	1	1	1	1	4
OG0019150	1	1	1	1	4
OG0019151	1	1	1	1	4
OG0019152	1	1	1	1	4
OG0019153	1	1	1	1	4
OG0019154	1	1	1	1	4
OG0019155	1	1	1	1	4
OG0019156	1	1	1	1	4
OG0019157	1	1	1	1	4
OG0019158	1	1	1	1	4
OG0019159	1	1	1	1	4
OG0019160	1	1	1	1	4
OG0019161	1	1	1	1	4
OG0019162	1	1	1	1	4
OG0019163	1	1	1	1	4
OG0019164	1	1	1	1	4
OG0019165	1	1	1	1	4
OG0019166	1	1	1	1	4
OG0019167	1	1	1	1	4
OG0019168	1	1	1	1	4
OG0019169	1	1	1	1	4
OG0019170	1	1	1	1	4
OG0019171	1	1	1	1	4
OG0019172	1	0	2	1	4
OG0019173	1	1	1	1	4
OG0019174	2	0	1	1	4
OG0019175	1	1	1	1	4
OG0019176	1	1	1	1	4
OG0019177	1	1	1	1	4
OG0019178	1	1	1	1	4
OG0019179	1	1	1	1	4
OG0019180	1	1	1	1	4
OG0019181	1	1	1	1	4
OG0019182	1	1	1	1	4
OG0019183	1	1	1	1	4
OG0019184	1	1	1	1	4
OG0019185	1	1	1	1	4
OG0019186	1	1	1	1	4
OG0019187	1	1	1	1	4
OG0019188	1	1	1	1	4
OG0019189	1	1	1	1	4
OG0019190	1	1	1	1	4
OG0019191	1	1	1	1	4
OG0019192	1	1	1	1	4
OG0019193	1	1	1	1	4
OG0019194	1	1	1	1	4
OG0019195	1	1	1	1	4
OG0019196	1	1	1	1	4
OG0019197	1	1	1	1	4
OG0019198	1	1	1	1	4
OG0019199	1	1	1	1	4
OG0019200	1	1	1	1	4
OG0019201	2	0	1	1	4
OG0019202	1	1	1	1	4
OG0019203	1	1	1	1	4
OG0019204	1	1	1	1	4
OG0019205	1	1	1	1	4
OG0019206	1	1	1	1	4
OG0019207	1	1	1	1	4
OG0019208	1	1	1	1	4
OG0019209	1	1	1	1	4
OG0019210	1	1	1	1	4
OG0019211	1	1	1	1	4
OG0019212	1	1	1	1	4
OG0019213	1	0	3	0	4
OG0019214	1	3	0	0	4
OG0019215	1	1	1	1	4
OG0019216	1	1	1	1	4
OG0019217	1	1	1	1	4
OG0019218	1	1	1	1	4
OG0019219	1	1	1	1	4
OG0019220	1	1	1	1	4
OG0019221	1	1	1	1	4
OG0019222	1	1	1	1	4
OG0019223	1	1	1	1	4
OG0019224	1	1	1	1	4
OG0019225	1	1	1	1	4
OG0019226	1	1	1	1	4
OG0019227	1	1	1	1	4
OG0019228	1	1	1	1	4
OG0019229	1	1	1	1	4
OG0019230	1	1	1	1	4
OG0019231	1	1	1	1	4
OG0019232	1	1	1	1	4
OG0019233	1	1	1	1	4
OG0019234	1	1	1	1	4
OG0019235	1	1	1	1	4
OG0019236	1	1	1	1	4
OG0019237	1	1	1	1	4
OG0019238	1	1	1	1	4
OG0019239	1	1	1	1	4
OG0019240	1	1	1	1	4
OG0019241	2	0	1	1	4
OG0019242	1	1	1	1	4
OG0019243	1	1	1	1	4
OG0019244	1	1	1	1	4
OG0019245	1	1	1	1	4
OG0019246	1	1	1	1	4
OG0019247	1	1	1	1	4
OG0019248	1	1	1	1	4
OG0019249	1	1	1	1	4
OG0019250	1	1	1	1	4
OG0019251	1	1	1	1	4
OG0019252	1	1	1	1	4
OG0019253	1	1	1	1	4
OG0019254	1	0	0	3	4
OG0019255	1	1	1	1	4
OG0019256	1	1	1	1	4
OG0019257	1	1	1	1	4
OG0019258	1	0	2	1	4
OG0019259	1	1	1	1	4
OG0019260	1	1	1	1	4
OG0019261	1	1	1	1	4
OG0019262	1	1	1	1	4
OG0019263	1	1	1	1	4
OG0019264	1	1	1	1	4
OG0019265	1	1	1	1	4
OG0019266	2	1	0	1	4
OG0019267	1	1	1	1	4
OG0019268	1	1	1	1	4
OG0019269	1	1	1	1	4
OG0019270	1	1	1	1	4
OG0019271	1	1	1	1	4
OG0019272	1	1	1	1	4
OG0019273	1	1	1	1	4
OG0019274	1	1	1	1	4
OG0019275	1	1	1	1	4
OG0019276	1	1	1	1	4
OG0019277	1	1	1	1	4
OG0019278	1	1	1	1	4
OG0019279	1	1	1	1	4
OG0019280	1	1	1	1	4
OG0019281	1	1	1	1	4
OG0019282	1	1	1	1	4
OG0019283	1	1	1	1	4
OG0019284	1	1	1	1	4
OG0019285	1	1	1	1	4
OG0019286	1	1	1	1	4
OG0019287	1	1	1	1	4
OG0019288	1	1	1	1	4
OG0019289	1	1	1	1	4
OG0019290	1	1	1	1	4
OG0019291	1	1	1	1	4
OG0019292	1	1	1	1	4
OG0019293	1	1	1	1	4
OG0019294	1	1	1	1	4
OG0019295	1	1	1	1	4
OG0019296	1	1	1	1	4
OG0019297	1	1	1	1	4
OG0019298	1	0	1	2	4
OG0019299	1	1	1	1	4
OG0019300	1	1	1	1	4
OG0019301	1	0	1	2	4
OG0019302	1	1	1	1	4
OG0019303	1	1	1	1	4
OG0019304	1	1	1	1	4
OG0019305	1	1	1	1	4
OG0019306	1	1	1	1	4
OG0019307	1	1	1	1	4
OG0019308	1	1	1	1	4
OG0019309	1	1	1	1	4
OG0019310	1	1	1	1	4
OG0019311	1	1	1	1	4
OG0019312	1	1	1	1	4
OG0019313	1	1	1	1	4
OG0019314	1	1	1	1	4
OG0019315	1	1	1	1	4
OG0019316	2	0	1	1	4
OG0019317	1	1	1	1	4
OG0019318	1	1	1	1	4
OG0019319	1	1	1	1	4
OG0019320	1	1	1	1	4
OG0019321	1	1	1	1	4
OG0019322	1	1	1	1	4
OG0019323	1	1	1	1	4
OG0019324	1	1	1	1	4
OG0019325	1	1	2	0	4
OG0019326	1	1	1	1	4
OG0019327	1	1	1	1	4
OG0019328	1	1	1	1	4
OG0019329	1	1	1	1	4
OG0019330	1	1	1	1	4
OG0019331	3	1	0	0	4
OG0019332	1	1	1	1	4
OG0019333	1	1	1	1	4
OG0019334	1	1	1	1	4
OG0019335	1	1	1	1	4
OG0019336	1	1	1	1	4
OG0019337	1	1	1	1	4
OG0019338	1	1	1	1	4
OG0019339	1	1	1	1	4
OG0019340	1	0	1	2	4
OG0019341	1	1	1	1	4
OG0019342	1	1	1	1	4
OG0019343	1	3	0	0	4
OG0019344	1	1	1	1	4
OG0019345	1	1	0	2	4
OG0019346	1	1	1	1	4
OG0019347	1	1	1	1	4
OG0019348	1	1	1	1	4
OG0019349	1	0	2	1	4
OG0019350	1	1	1	1	4
OG0019351	1	1	1	1	4
OG0019352	1	1	1	1	4
OG0019353	1	1	1	1	4
OG0019354	1	1	1	1	4
OG0019355	1	1	1	1	4
OG0019356	1	1	1	1	4
OG0019357	1	1	1	1	4
OG0019358	1	1	1	1	4
OG0019359	1	1	1	1	4
OG0019360	1	1	1	1	4
OG0019361	1	1	1	1	4
OG0019362	1	1	1	1	4
OG0019363	1	1	1	1	4
OG0019364	1	1	1	1	4
OG0019365	1	1	1	1	4
OG0019366	1	1	1	1	4
OG0019367	1	1	1	1	4
OG0019368	1	1	1	1	4
OG0019369	1	1	1	1	4
OG0019370	1	1	1	1	4
OG0019371	1	1	1	1	4
OG0019372	1	1	1	1	4
OG0019373	1	1	1	1	4
OG0019374	1	1	1	1	4
OG0019375	1	1	1	1	4
OG0019376	1	1	1	1	4
OG0019377	1	1	1	1	4
OG0019378	1	1	1	1	4
OG0019379	1	1	1	1	4
OG0019380	1	1	1	1	4
OG0019381	1	1	1	1	4
OG0019382	1	1	1	1	4
OG0019383	1	1	1	1	4
OG0019384	1	1	1	1	4
OG0019385	1	1	1	1	4
OG0019386	1	1	1	1	4
OG0019387	1	1	1	1	4
OG0019388	1	1	1	1	4
OG0019389	1	1	1	1	4
OG0019390	1	1	1	1	4
OG0019391	1	1	1	1	4
OG0019392	1	1	1	1	4
OG0019393	1	1	1	1	4
OG0019394	1	1	1	1	4
OG0019395	1	1	1	1	4
OG0019396	1	1	1	1	4
OG0019397	1	1	1	1	4
OG0019398	1	1	1	1	4
OG0019399	1	1	1	1	4
OG0019400	1	1	1	1	4
OG0019401	1	1	1	1	4
OG0019402	1	1	1	1	4
OG0019403	1	1	1	1	4
OG0019404	1	1	1	1	4
OG0019405	1	1	1	1	4
OG0019406	1	1	1	1	4
OG0019407	1	1	1	1	4
OG0019408	1	1	1	1	4
OG0019409	1	1	1	1	4
OG0019410	1	1	1	1	4
OG0019411	1	1	1	1	4
OG0019412	1	1	1	1	4
OG0019413	1	1	1	1	4
OG0019414	1	1	1	1	4
OG0019415	1	1	1	1	4
OG0019416	1	1	1	1	4
OG0019417	1	1	1	1	4
OG0019418	1	1	1	1	4
OG0019419	1	1	1	1	4
OG0019420	1	1	1	1	4
OG0019421	1	1	1	1	4
OG0019422	1	1	1	1	4
OG0019423	1	1	1	1	4
OG0019424	1	1	1	1	4
OG0019425	1	1	1	1	4
OG0019426	1	1	1	1	4
OG0019427	1	1	1	1	4
OG0019428	1	1	1	1	4
OG0019429	1	1	1	1	4
OG0019430	1	1	1	1	4
OG0019431	1	1	1	1	4
OG0019432	1	1	1	1	4
OG0019433	1	1	1	1	4
OG0019434	1	1	1	1	4
OG0019435	1	1	1	1	4
OG0019436	1	1	1	1	4
OG0019437	1	1	1	1	4
OG0019438	1	1	1	1	4
OG0019439	1	1	1	1	4
OG0019440	1	1	1	1	4
OG0019441	1	1	1	1	4
OG0019442	1	1	1	1	4
OG0019443	1	1	1	1	4
OG0019444	1	1	1	1	4
OG0019445	1	1	1	1	4
OG0019446	1	1	1	1	4
OG0019447	1	1	1	1	4
OG0019448	1	1	1	1	4
OG0019449	1	1	1	1	4
OG0019450	1	1	1	1	4
OG0019451	1	1	1	1	4
OG0019452	1	1	1	1	4
OG0019453	1	1	1	1	4
OG0019454	1	1	1	1	4
OG0019455	1	1	1	1	4
OG0019456	1	1	1	1	4
OG0019457	1	1	1	1	4
OG0019458	1	1	1	1	4
OG0019459	1	1	1	1	4
OG0019460	1	1	1	1	4
OG0019461	1	1	1	1	4
OG0019462	1	1	1	1	4
OG0019463	1	1	1	1	4
OG0019464	1	1	1	1	4
OG0019465	1	1	1	1	4
OG0019466	1	1	1	1	4
OG0019467	1	1	1	1	4
OG0019468	1	1	1	1	4
OG0019469	1	1	1	1	4
OG0019470	1	1	1	1	4
OG0019471	1	1	1	1	4
OG0019472	1	1	1	1	4
OG0019473	1	1	1	1	4
OG0019474	1	1	1	1	4
OG0019475	1	1	1	1	4
OG0019476	1	1	1	1	4
OG0019477	1	1	1	1	4
OG0019478	1	1	1	1	4
OG0019479	1	1	1	1	4
OG0019480	1	1	1	1	4
OG0019481	1	1	1	1	4
OG0019482	1	1	1	1	4
OG0019483	1	1	1	1	4
OG0019484	1	1	1	1	4
OG0019485	1	1	1	1	4
OG0019486	1	1	1	1	4
OG0019487	1	1	1	1	4
OG0019488	1	1	1	1	4
OG0019489	1	1	1	1	4
OG0019490	1	1	1	1	4
OG0019491	1	1	1	1	4
OG0019492	1	1	1	1	4
OG0019493	1	1	1	1	4
OG0019494	1	1	1	1	4
OG0019495	1	1	1	1	4
OG0019496	1	1	1	1	4
OG0019497	1	0	1	2	4
OG0019498	1	1	1	1	4
OG0019499	1	1	1	1	4
OG0019500	1	1	1	1	4
OG0019501	1	1	1	1	4
OG0019502	1	1	1	1	4
OG0019503	1	1	1	1	4
OG0019504	1	0	0	3	4
OG0019505	1	1	1	1	4
OG0019506	1	1	1	1	4
OG0019507	1	1	1	1	4
OG0019508	1	1	1	1	4
OG0019509	1	1	1	1	4
OG0019510	1	1	1	1	4
OG0019511	1	1	1	1	4
OG0019512	1	1	1	1	4
OG0019513	1	1	1	1	4
OG0019514	1	1	1	1	4
OG0019515	1	0	2	1	4
OG0019516	1	1	1	1	4
OG0019517	1	1	1	1	4
OG0019518	1	1	1	1	4
OG0019519	1	0	1	2	4
OG0019520	1	1	1	1	4
OG0019521	1	1	1	1	4
OG0019522	1	1	1	1	4
OG0019523	1	1	1	1	4
OG0019524	1	1	1	1	4
OG0019525	1	1	1	1	4
OG0019526	1	0	1	2	4
OG0019527	1	1	1	1	4
OG0019528	1	1	1	1	4
OG0019529	1	1	1	1	4
OG0019530	1	1	1	1	4
OG0019531	1	1	1	1	4
OG0019532	1	1	1	1	4
OG0019533	1	1	1	1	4
OG0019534	1	1	1	1	4
OG0019535	1	1	1	1	4
OG0019536	1	1	1	1	4
OG0019537	1	1	1	1	4
OG0019538	1	1	1	1	4
OG0019539	1	1	1	1	4
OG0019540	1	1	1	1	4
OG0019541	1	1	0	2	4
OG0019542	1	1	1	1	4
OG0019543	1	1	1	1	4
OG0019544	1	1	1	1	4
OG0019545	1	1	1	1	4
OG0019546	1	1	1	1	4
OG0019547	1	1	1	1	4
OG0019548	1	0	2	1	4
OG0019549	2	0	1	1	4
OG0019550	1	1	1	1	4
OG0019551	1	1	1	1	4
OG0019552	1	1	1	1	4
OG0019553	1	0	1	2	4
OG0019554	1	1	1	1	4
OG0019555	1	1	1	1	4
OG0019556	1	1	1	1	4
OG0019557	1	1	1	1	4
OG0019558	1	1	1	1	4
OG0019559	1	1	1	1	4
OG0019560	1	1	1	1	4
OG0019561	1	1	1	1	4
OG0019562	1	1	1	1	4
OG0019563	1	1	1	1	4
OG0019564	1	1	1	1	4
OG0019565	1	1	1	1	4
OG0019566	1	1	1	1	4
OG0019567	1	1	1	1	4
OG0019568	1	1	1	1	4
OG0019569	1	1	1	1	4
OG0019570	1	1	1	1	4
OG0019571	1	1	1	1	4
OG0019572	1	1	1	1	4
OG0019573	1	1	1	1	4
OG0019574	1	1	1	1	4
OG0019575	1	1	1	1	4
OG0019576	1	1	1	1	4
OG0019577	1	1	1	1	4
OG0019578	1	1	1	1	4
OG0019579	1	1	1	1	4
OG0019580	1	1	1	1	4
OG0019581	1	1	1	1	4
OG0019582	1	1	1	1	4
OG0019583	1	1	1	1	4
OG0019584	1	1	1	1	4
OG0019585	1	1	1	1	4
OG0019586	1	1	1	1	4
OG0019587	1	1	1	1	4
OG0019588	1	1	1	1	4
OG0019589	1	1	1	1	4
OG0019590	1	0	1	2	4
OG0019591	1	1	1	1	4
OG0019592	1	1	1	1	4
OG0019593	1	1	1	1	4
OG0019594	1	1	1	1	4
OG0019595	1	1	1	1	4
OG0019596	1	1	1	1	4
OG0019597	1	1	1	1	4
OG0019598	1	1	1	1	4
OG0019599	1	1	1	1	4
OG0019600	1	1	1	1	4
OG0019601	1	1	1	1	4
OG0019602	1	1	1	1	4
OG0019603	1	1	1	1	4
OG0019604	1	1	1	1	4
OG0019605	1	1	1	1	4
OG0019606	1	1	1	1	4
OG0019607	1	1	1	1	4
OG0019608	1	1	1	1	4
OG0019609	1	1	1	1	4
OG0019610	1	1	1	1	4
OG0019611	1	1	1	1	4
OG0019612	1	1	1	1	4
OG0019613	1	1	1	1	4
OG0019614	1	1	1	1	4
OG0019615	1	1	1	1	4
OG0019616	1	1	1	1	4
OG0019617	1	1	1	1	4
OG0019618	1	1	1	1	4
OG0019619	1	1	1	1	4
OG0019620	1	1	1	1	4
OG0019621	1	1	1	1	4
OG0019622	1	1	1	1	4
OG0019623	1	1	1	1	4
OG0019624	1	1	1	1	4
OG0019625	1	1	1	1	4
OG0019626	1	1	1	1	4
OG0019627	1	1	1	1	4
OG0019628	1	1	1	1	4
OG0019629	1	1	1	1	4
OG0019630	1	1	1	1	4
OG0019631	1	1	1	1	4
OG0019632	1	1	1	1	4
OG0019633	1	1	1	1	4
OG0019634	1	1	1	1	4
OG0019635	1	1	1	1	4
OG0019636	1	1	1	1	4
OG0019637	1	1	1	1	4
OG0019638	1	1	1	1	4
OG0019639	1	1	1	1	4
OG0019640	1	1	1	1	4
OG0019641	1	1	1	1	4
OG0019642	1	1	1	1	4
OG0019643	1	1	1	1	4
OG0019644	1	1	1	1	4
OG0019645	1	1	1	1	4
OG0019646	1	1	1	1	4
OG0019647	1	1	1	1	4
OG0019648	1	1	1	1	4
OG0019649	1	1	1	1	4
OG0019650	1	1	1	1	4
OG0019651	1	1	1	1	4
OG0019652	1	1	1	1	4
OG0019653	1	1	1	1	4
OG0019654	1	1	1	1	4
OG0019655	1	0	1	2	4
OG0019656	1	1	1	1	4
OG0019657	1	1	1	1	4
OG0019658	1	1	1	1	4
OG0019659	1	1	1	1	4
OG0019660	1	1	1	1	4
OG0019661	1	1	1	1	4
OG0019662	1	1	1	1	4
OG0019663	1	1	1	1	4
OG0019664	1	1	1	1	4
OG0019665	1	1	1	1	4
OG0019666	1	1	1	1	4
OG0019667	1	1	1	1	4
OG0019668	1	1	1	1	4
OG0019669	1	1	1	1	4
OG0019670	1	1	1	1	4
OG0019671	1	1	1	1	4
OG0019672	1	1	1	1	4
OG0019673	1	1	1	1	4
OG0019674	1	1	1	1	4
OG0019675	1	1	1	1	4
OG0019676	1	1	1	1	4
OG0019677	1	1	1	1	4
OG0019678	1	1	1	1	4
OG0019679	1	1	1	1	4
OG0019680	1	1	1	1	4
OG0019681	1	1	1	1	4
OG0019682	1	1	1	1	4
OG0019683	1	1	1	1	4
OG0019684	1	1	1	1	4
OG0019685	1	1	1	1	4
OG0019686	1	1	1	1	4
OG0019687	1	1	1	1	4
OG0019688	1	1	1	1	4
OG0019689	2	0	1	1	4
OG0019690	1	1	1	1	4
OG0019691	1	0	1	2	4
OG0019692	1	1	1	1	4
OG0019693	1	1	1	1	4
OG0019694	1	1	1	1	4
OG0019695	1	1	1	1	4
OG0019696	1	1	1	1	4
OG0019697	1	1	1	1	4
OG0019698	1	1	1	1	4
OG0019699	1	1	1	1	4
OG0019700	1	1	1	1	4
OG0019701	1	1	1	1	4
OG0019702	1	1	1	1	4
OG0019703	1	1	1	1	4
OG0019704	1	1	1	1	4
OG0019705	1	1	1	1	4
OG0019706	1	1	1	1	4
OG0019707	1	1	1	1	4
OG0019708	1	1	1	1	4
OG0019709	1	1	1	1	4
OG0019710	1	1	1	1	4
OG0019711	1	1	1	1	4
OG0019712	1	1	1	1	4
OG0019713	1	1	1	1	4
OG0019714	1	1	1	1	4
OG0019715	1	1	1	1	4
OG0019716	1	1	1	1	4
OG0019717	1	1	1	1	4
OG0019718	1	1	1	1	4
OG0019719	1	1	1	1	4
OG0019720	1	1	1	1	4
OG0019721	1	1	1	1	4
OG0019722	1	1	1	1	4
OG0019723	1	1	1	1	4
OG0019724	1	1	1	1	4
OG0019725	1	1	1	1	4
OG0019726	1	1	1	1	4
OG0019727	1	1	1	1	4
OG0019728	1	1	1	1	4
OG0019729	1	1	1	1	4
OG0019730	1	1	1	1	4
OG0019731	1	1	1	1	4
OG0019732	1	1	1	1	4
OG0019733	1	1	1	1	4
OG0019734	1	1	1	1	4
OG0019735	1	0	1	2	4
OG0019736	1	1	1	1	4
OG0019737	1	1	1	1	4
OG0019738	1	1	1	1	4
OG0019739	1	1	1	1	4
OG0019740	1	1	1	1	4
OG0019741	1	1	1	1	4
OG0019742	1	1	1	1	4
OG0019743	1	1	1	1	4
OG0019744	1	1	1	1	4
OG0019745	1	1	1	1	4
OG0019746	1	1	1	1	4
OG0019747	1	1	1	1	4
OG0019748	1	1	1	1	4
OG0019749	1	1	1	1	4
OG0019750	1	1	1	1	4
OG0019751	1	1	1	1	4
OG0019752	1	1	1	1	4
OG0019753	1	1	1	1	4
OG0019754	1	1	1	1	4
OG0019755	1	1	1	1	4
OG0019756	1	1	1	1	4
OG0019757	1	1	1	1	4
OG0019758	1	1	1	1	4
OG0019759	1	1	1	1	4
OG0019760	1	1	1	1	4
OG0019761	1	1	1	1	4
OG0019762	1	1	1	1	4
OG0019763	1	1	1	1	4
OG0019764	1	1	1	1	4
OG0019765	1	1	1	1	4
OG0019766	1	1	1	1	4
OG0019767	1	1	1	1	4
OG0019768	1	1	1	1	4
OG0019769	1	1	1	1	4
OG0019770	1	1	1	1	4
OG0019771	1	1	1	1	4
OG0019772	1	1	1	1	4
OG0019773	1	1	1	1	4
OG0019774	1	1	1	1	4
OG0019775	1	1	1	1	4
OG0019776	2	1	1	0	4
OG0019777	1	1	1	1	4
OG0019778	1	1	1	1	4
OG0019779	1	1	1	1	4
OG0019780	2	2	0	0	4
OG0019781	1	1	1	1	4
OG0019782	1	1	1	1	4
OG0019783	1	1	1	1	4
OG0019784	1	1	1	1	4
OG0019785	1	1	1	1	4
OG0019786	1	1	1	1	4
OG0019787	1	1	1	1	4
OG0019788	1	1	1	1	4
OG0019789	1	1	1	1	4
OG0019790	1	1	1	1	4
OG0019791	1	1	1	1	4
OG0019792	1	1	1	1	4
OG0019793	1	1	1	1	4
OG0019794	1	1	1	1	4
OG0019795	1	1	1	1	4
OG0019796	1	1	1	1	4
OG0019797	1	1	1	1	4
OG0019798	1	1	1	1	4
OG0019799	1	1	1	1	4
OG0019800	1	1	1	1	4
OG0019801	1	1	1	1	4
OG0019802	1	1	1	1	4
OG0019803	1	1	1	1	4
OG0019804	1	1	1	1	4
OG0019805	1	1	1	1	4
OG0019806	1	1	1	1	4
OG0019807	1	1	1	1	4
OG0019808	1	1	1	1	4
OG0019809	1	1	1	1	4
OG0019810	1	1	1	1	4
OG0019811	1	1	1	1	4
OG0019812	1	1	1	1	4
OG0019813	1	1	1	1	4
OG0019814	1	1	1	1	4
OG0019815	1	1	1	1	4
OG0019816	1	1	1	1	4
OG0019817	1	1	1	1	4
OG0019818	1	1	1	1	4
OG0019819	1	1	1	1	4
OG0019820	1	1	1	1	4
OG0019821	1	1	1	1	4
OG0019822	1	1	1	1	4
OG0019823	1	1	1	1	4
OG0019824	1	1	1	1	4
OG0019825	1	1	1	1	4
OG0019826	1	1	1	1	4
OG0019827	1	1	1	1	4
OG0019828	1	0	1	2	4
OG0019829	1	1	1	1	4
OG0019830	1	1	1	1	4
OG0019831	1	1	1	1	4
OG0019832	1	1	1	1	4
OG0019833	1	1	1	1	4
OG0019834	1	1	1	1	4
OG0019835	1	1	1	1	4
OG0019836	1	1	1	1	4
OG0019837	1	1	1	1	4
OG0019838	1	1	1	1	4
OG0019839	1	1	1	1	4
OG0019840	1	1	1	1	4
OG0019841	1	1	1	1	4
OG0019842	1	1	1	1	4
OG0019843	1	1	1	1	4
OG0019844	1	1	1	1	4
OG0019845	1	1	1	1	4
OG0019846	1	1	1	1	4
OG0019847	1	1	1	1	4
OG0019848	1	1	1	1	4
OG0019849	1	1	1	1	4
OG0019850	1	1	1	1	4
OG0019851	1	1	1	1	4
OG0019852	1	1	1	1	4
OG0019853	1	1	1	1	4
OG0019854	1	1	1	1	4
OG0019855	1	1	1	1	4
OG0019856	1	1	1	1	4
OG0019857	1	1	1	1	4
OG0019858	1	1	1	1	4
OG0019859	1	1	1	1	4
OG0019860	1	1	1	1	4
OG0019861	1	1	1	1	4
OG0019862	1	1	1	1	4
OG0019863	1	1	1	1	4
OG0019864	4	0	0	0	4
OG0019865	1	1	1	1	4
OG0019866	1	1	1	1	4
OG0019867	1	1	1	1	4
OG0019868	1	1	1	1	4
OG0019869	1	1	1	1	4
OG0019870	1	1	1	1	4
OG0019871	1	1	1	1	4
OG0019872	1	0	2	1	4
OG0019873	1	1	1	1	4
OG0019874	1	1	1	1	4
OG0019875	1	1	1	1	4
OG0019876	1	1	1	1	4
OG0019877	1	1	1	1	4
OG0019878	1	1	1	1	4
OG0019879	1	1	1	1	4
OG0019880	1	1	1	1	4
OG0019881	1	1	1	1	4
OG0019882	1	1	1	1	4
OG0019883	1	1	1	1	4
OG0019884	1	0	2	1	4
OG0019885	1	1	1	1	4
OG0019886	1	1	1	1	4
OG0019887	1	1	1	1	4
OG0019888	1	1	1	1	4
OG0019889	1	1	1	1	4
OG0019890	1	1	1	1	4
OG0019891	1	1	1	1	4
OG0019892	1	1	1	1	4
OG0019893	1	1	1	1	4
OG0019894	1	1	1	1	4
OG0019895	1	1	1	1	4
OG0019896	1	1	1	1	4
OG0019897	1	1	1	1	4
OG0019898	1	1	1	1	4
OG0019899	1	1	1	1	4
OG0019900	1	1	1	1	4
OG0019901	1	1	1	1	4
OG0019902	1	1	1	1	4
OG0019903	1	1	1	1	4
OG0019904	1	1	1	1	4
OG0019905	1	1	1	1	4
OG0019906	1	1	1	1	4
OG0019907	1	1	1	1	4
OG0019908	1	1	1	1	4
OG0019909	1	1	1	1	4
OG0019910	1	1	1	1	4
OG0019911	1	1	1	1	4
OG0019912	1	1	1	1	4
OG0019913	1	1	1	1	4
OG0019914	1	1	1	1	4
OG0019915	1	0	1	2	4
OG0019916	1	1	1	1	4
OG0019917	1	1	1	1	4
OG0019918	1	1	1	1	4
OG0019919	1	1	1	1	4
OG0019920	1	1	1	1	4
OG0019921	1	1	1	1	4
OG0019922	1	1	1	1	4
OG0019923	1	1	1	1	4
OG0019924	1	1	1	1	4
OG0019925	1	1	1	1	4
OG0019926	1	1	1	1	4
OG0019927	1	1	1	1	4
OG0019928	1	1	1	1	4
OG0019929	1	1	1	1	4
OG0019930	1	1	1	1	4
OG0019931	1	1	1	1	4
OG0019932	1	1	1	1	4
OG0019933	1	1	1	1	4
OG0019934	1	1	1	1	4
OG0019935	1	1	1	1	4
OG0019936	1	1	1	1	4
OG0019937	1	1	1	1	4
OG0019938	1	1	1	1	4
OG0019939	1	1	1	1	4
OG0019940	1	1	1	1	4
OG0019941	1	1	1	1	4
OG0019942	1	1	1	1	4
OG0019943	1	1	1	1	4
OG0019944	1	1	1	1	4
OG0019945	1	1	1	1	4
OG0019946	1	1	1	1	4
OG0019947	1	1	1	1	4
OG0019948	1	1	1	1	4
OG0019949	1	1	1	1	4
OG0019950	1	1	1	1	4
OG0019951	1	1	1	1	4
OG0019952	1	1	1	1	4
OG0019953	1	1	1	1	4
OG0019954	1	1	1	1	4
OG0019955	1	2	1	0	4
OG0019956	1	1	1	1	4
OG0019957	1	1	1	1	4
OG0019958	1	1	1	1	4
OG0019959	1	1	1	1	4
OG0019960	1	0	1	2	4
OG0019961	1	1	1	1	4
OG0019962	1	1	1	1	4
OG0019963	1	1	1	1	4
OG0019964	1	1	1	1	4
OG0019965	1	1	1	1	4
OG0019966	1	1	1	1	4
OG0019967	1	1	1	1	4
OG0019968	1	1	1	1	4
OG0019969	1	1	1	1	4
OG0019970	1	1	1	1	4
OG0019971	1	1	1	1	4
OG0019972	1	1	1	1	4
OG0019973	1	1	1	1	4
OG0019974	1	1	1	1	4
OG0019975	1	1	1	1	4
OG0019976	1	1	1	1	4
OG0019977	1	1	1	1	4
OG0019978	1	1	1	1	4
OG0019979	1	1	1	1	4
OG0019980	1	1	1	1	4
OG0019981	1	1	1	1	4
OG0019982	1	1	1	1	4
OG0019983	1	1	1	1	4
OG0019984	1	1	1	1	4
OG0019985	1	1	1	1	4
OG0019986	1	1	1	1	4
OG0019987	1	1	1	1	4
OG0019988	1	1	1	1	4
OG0019989	1	1	1	1	4
OG0019990	1	1	1	1	4
OG0019991	1	1	1	1	4
OG0019992	1	1	1	1	4
OG0019993	1	1	1	1	4
OG0019994	1	1	1	1	4
OG0019995	1	1	1	1	4
OG0019996	1	1	1	1	4
OG0019997	1	1	1	1	4
OG0019998	1	1	1	1	4
OG0019999	1	1	1	1	4
OG0020000	3	1	0	0	4
OG0020001	1	1	1	1	4
OG0020002	1	1	1	1	4
OG0020003	1	1	1	1	4
OG0020004	1	1	1	1	4
OG0020005	1	1	1	1	4
OG0020006	1	1	1	1	4
OG0020007	1	1	1	1	4
OG0020008	1	1	1	1	4
OG0020009	1	1	1	1	4
OG0020010	1	1	1	1	4
OG0020011	1	1	1	1	4
OG0020012	1	1	1	1	4
OG0020013	1	1	1	1	4
OG0020014	1	1	1	1	4
OG0020015	1	1	1	1	4
OG0020016	1	1	1	1	4
OG0020017	1	1	1	1	4
OG0020018	1	1	1	1	4
OG0020019	1	1	1	1	4
OG0020020	1	1	1	1	4
OG0020021	1	1	1	1	4
OG0020022	1	1	1	1	4
OG0020023	1	1	1	1	4
OG0020024	1	1	1	1	4
OG0020025	1	1	1	1	4
OG0020026	1	1	1	1	4
OG0020027	1	1	1	1	4
OG0020028	1	1	1	1	4
OG0020029	1	1	0	2	4
OG0020030	1	1	1	1	4
OG0020031	1	1	1	1	4
OG0020032	1	1	1	1	4
OG0020033	1	1	1	1	4
OG0020034	1	1	1	1	4
OG0020035	1	1	1	1	4
OG0020036	1	1	1	1	4
OG0020037	1	1	1	1	4
OG0020038	1	1	1	1	4
OG0020039	2	2	0	0	4
OG0020040	1	1	1	1	4
OG0020041	1	1	1	1	4
OG0020042	1	1	1	1	4
OG0020043	1	1	1	1	4
OG0020044	1	1	1	1	4
OG0020045	1	1	1	1	4
OG0020046	1	1	1	1	4
OG0020047	1	1	1	1	4
OG0020048	1	1	1	1	4
OG0020049	1	1	1	1	4
OG0020050	1	1	1	1	4
OG0020051	1	1	1	1	4
OG0020052	1	1	1	1	4
OG0020053	1	1	1	1	4
OG0020054	1	1	1	1	4
OG0020055	1	1	1	1	4
OG0020056	1	1	1	1	4
OG0020057	1	1	1	1	4
OG0020058	4	0	0	0	4
OG0020059	1	1	1	1	4
OG0020060	1	1	1	1	4
OG0020061	1	1	1	1	4
OG0020062	1	1	1	1	4
OG0020063	1	1	1	1	4
OG0020064	1	3	0	0	4
OG0020065	1	1	1	1	4
OG0020066	1	1	1	1	4
OG0020067	1	1	1	1	4
OG0020068	1	1	1	1	4
OG0020069	1	1	1	1	4
OG0020070	1	1	1	1	4
OG0020071	1	1	1	1	4
OG0020072	1	1	1	1	4
OG0020073	1	1	1	1	4
OG0020074	1	1	1	1	4
OG0020075	1	1	1	1	4
OG0020076	1	1	1	1	4
OG0020077	1	1	1	1	4
OG0020078	1	1	1	1	4
OG0020079	1	1	1	1	4
OG0020080	1	1	1	1	4
OG0020081	1	1	1	1	4
OG0020082	1	1	1	1	4
OG0020083	1	1	1	1	4
OG0020084	1	1	1	1	4
OG0020085	1	1	1	1	4
OG0020086	1	1	1	1	4
OG0020087	1	1	1	1	4
OG0020088	1	1	1	1	4
OG0020089	1	1	1	1	4
OG0020090	1	1	1	1	4
OG0020091	1	1	1	1	4
OG0020092	1	1	1	1	4
OG0020093	1	1	1	1	4
OG0020094	1	1	1	1	4
OG0020095	1	1	1	1	4
OG0020096	1	1	1	1	4
OG0020097	2	0	1	1	4
OG0020098	1	1	1	1	4
OG0020099	1	1	1	1	4
OG0020100	1	1	1	1	4
OG0020101	1	1	1	1	4
OG0020102	1	1	1	1	4
OG0020103	1	1	1	1	4
OG0020104	1	1	1	1	4
OG0020105	1	1	1	1	4
OG0020106	1	1	1	1	4
OG0020107	2	1	0	1	4
OG0020108	1	1	1	1	4
OG0020109	1	1	1	1	4
OG0020110	1	0	3	0	4
OG0020111	1	1	2	0	4
OG0020112	1	1	1	1	4
OG0020113	1	1	1	1	4
OG0020114	1	1	1	1	4
OG0020115	1	1	1	1	4
OG0020116	1	1	1	1	4
OG0020117	1	1	1	1	4
OG0020118	1	1	1	1	4
OG0020119	1	1	1	1	4
OG0020120	1	1	1	1	4
OG0020121	2	2	0	0	4
OG0020122	1	1	1	1	4
OG0020123	1	1	1	1	4
OG0020124	1	1	1	1	4
OG0020125	1	1	1	1	4
OG0020126	1	1	1	1	4
OG0020127	1	1	1	1	4
OG0020128	1	1	1	1	4
OG0020129	1	1	1	1	4
OG0020130	1	1	1	1	4
OG0020131	1	1	1	1	4
OG0020132	1	1	1	1	4
OG0020133	1	1	1	1	4
OG0020134	1	1	1	1	4
OG0020135	1	1	0	2	4
OG0020136	1	1	1	1	4
OG0020137	1	1	1	1	4
OG0020138	1	1	1	1	4
OG0020139	1	1	1	1	4
OG0020140	1	1	1	1	4
OG0020141	1	0	1	2	4
OG0020142	1	1	1	1	4
OG0020143	1	1	1	1	4
OG0020144	1	1	1	1	4
OG0020145	1	1	1	1	4
OG0020146	1	1	1	1	4
OG0020147	1	1	1	1	4
OG0020148	1	1	1	1	4
OG0020149	1	1	1	1	4
OG0020150	1	1	1	1	4
OG0020151	1	1	1	1	4
OG0020152	1	1	1	1	4
OG0020153	1	1	1	1	4
OG0020154	1	1	1	1	4
OG0020155	1	1	1	1	4
OG0020156	1	1	1	1	4
OG0020157	1	1	1	1	4
OG0020158	1	1	1	1	4
OG0020159	1	1	1	1	4
OG0020160	1	1	1	1	4
OG0020161	1	1	1	1	4
OG0020162	1	1	1	1	4
OG0020163	1	1	1	1	4
OG0020164	1	1	1	1	4
OG0020165	1	1	1	1	4
OG0020166	1	1	1	1	4
OG0020167	1	1	1	1	4
OG0020168	1	1	1	1	4
OG0020169	1	1	1	1	4
OG0020170	1	1	1	1	4
OG0020171	1	1	1	1	4
OG0020172	1	1	1	1	4
OG0020173	1	1	1	1	4
OG0020174	1	1	1	1	4
OG0020175	1	1	1	1	4
OG0020176	1	1	1	1	4
OG0020177	1	1	1	1	4
OG0020178	1	1	1	1	4
OG0020179	1	1	1	1	4
OG0020180	1	1	1	1	4
OG0020181	1	1	1	1	4
OG0020182	1	1	1	1	4
OG0020183	1	1	1	1	4
OG0020184	1	1	1	1	4
OG0020185	1	1	1	1	4
OG0020186	1	1	1	1	4
OG0020187	1	1	1	1	4
OG0020188	1	1	1	1	4
OG0020189	1	1	1	1	4
OG0020190	1	1	1	1	4
OG0020191	1	1	1	1	4
OG0020192	1	1	1	1	4
OG0020193	1	1	1	1	4
OG0020194	1	1	1	1	4
OG0020195	1	1	1	1	4
OG0020196	1	1	1	1	4
OG0020197	1	1	1	1	4
OG0020198	1	1	1	1	4
OG0020199	1	1	1	1	4
OG0020200	1	1	1	1	4
OG0020201	1	1	1	1	4
OG0020202	1	1	1	1	4
OG0020203	1	1	1	1	4
OG0020204	1	1	1	1	4
OG0020205	1	1	1	1	4
OG0020206	1	1	1	1	4
OG0020207	1	1	1	1	4
OG0020208	1	1	1	1	4
OG0020209	1	1	1	1	4
OG0020210	1	1	1	1	4
OG0020211	1	1	1	1	4
OG0020212	1	1	1	1	4
OG0020213	1	1	1	1	4
OG0020214	1	1	1	1	4
OG0020215	1	3	0	0	4
OG0020216	1	1	2	0	4
OG0020217	1	1	1	1	4
OG0020218	1	1	1	1	4
OG0020219	1	1	1	1	4
OG0020220	1	1	1	1	4
OG0020221	1	1	1	1	4
OG0020222	1	1	1	1	4
OG0020223	1	1	1	1	4
OG0020224	1	1	1	1	4
OG0020225	1	1	1	1	4
OG0020226	1	1	1	1	4
OG0020227	1	1	1	1	4
OG0020228	1	1	1	1	4
OG0020229	1	1	1	1	4
OG0020230	1	1	1	1	4
OG0020231	1	1	1	1	4
OG0020232	1	1	1	1	4
OG0020233	1	1	1	1	4
OG0020234	1	1	1	1	4
OG0020235	1	1	1	1	4
OG0020236	1	1	1	1	4
OG0020237	1	1	1	1	4
OG0020238	1	1	0	2	4
OG0020239	1	1	1	1	4
OG0020240	1	1	1	1	4
OG0020241	1	1	1	1	4
OG0020242	1	1	1	1	4
OG0020243	1	1	1	1	4
OG0020244	1	1	1	1	4
OG0020245	1	1	1	1	4
OG0020246	1	1	1	1	4
OG0020247	1	1	1	1	4
OG0020248	1	1	1	1	4
OG0020249	1	1	1	1	4
OG0020250	1	1	1	1	4
OG0020251	1	1	1	1	4
OG0020252	1	1	1	1	4
OG0020253	1	1	1	1	4
OG0020254	1	0	1	2	4
OG0020255	1	1	1	1	4
OG0020256	1	1	1	1	4
OG0020257	1	1	1	1	4
OG0020258	1	1	1	1	4
OG0020259	1	1	1	1	4
OG0020260	1	1	1	1	4
OG0020261	1	1	1	1	4
OG0020262	1	1	1	1	4
OG0020263	1	1	1	1	4
OG0020264	1	1	1	1	4
OG0020265	1	1	1	1	4
OG0020266	1	1	1	1	4
OG0020267	1	1	1	1	4
OG0020268	1	1	1	1	4
OG0020269	1	1	1	1	4
OG0020270	1	1	1	1	4
OG0020271	1	1	1	1	4
OG0020272	1	1	1	1	4
OG0020273	1	1	1	1	4
OG0020274	1	1	1	1	4
OG0020275	1	1	1	1	4
OG0020276	1	1	1	1	4
OG0020277	1	1	1	1	4
OG0020278	1	1	1	1	4
OG0020279	2	0	1	1	4
OG0020280	1	1	1	1	4
OG0020281	1	1	1	1	4
OG0020282	1	1	1	1	4
OG0020283	1	1	1	1	4
OG0020284	1	1	1	1	4
OG0020285	1	1	1	1	4
OG0020286	1	1	1	1	4
OG0020287	1	1	1	1	4
OG0020288	1	1	1	1	4
OG0020289	1	1	1	1	4
OG0020290	1	1	1	1	4
OG0020291	1	1	1	1	4
OG0020292	1	1	1	1	4
OG0020293	1	1	1	1	4
OG0020294	1	1	1	1	4
OG0020295	1	1	1	1	4
OG0020296	1	1	1	1	4
OG0020297	1	1	1	1	4
OG0020298	1	1	1	1	4
OG0020299	1	1	1	1	4
OG0020300	1	1	1	1	4
OG0020301	1	1	1	1	4
OG0020302	1	1	1	1	4
OG0020303	1	1	1	1	4
OG0020304	1	1	1	1	4
OG0020305	1	1	1	1	4
OG0020306	1	1	1	1	4
OG0020307	1	1	1	1	4
OG0020308	1	1	1	1	4
OG0020309	1	1	1	1	4
OG0020310	1	1	1	1	4
OG0020311	1	1	1	1	4
OG0020312	1	1	1	1	4
OG0020313	1	1	1	1	4
OG0020314	1	1	1	1	4
OG0020315	1	1	1	1	4
OG0020316	1	1	1	1	4
OG0020317	1	1	1	1	4
OG0020318	1	1	1	1	4
OG0020319	1	1	1	1	4
OG0020320	1	1	1	1	4
OG0020321	1	1	1	1	4
OG0020322	1	1	1	1	4
OG0020323	1	1	1	1	4
OG0020324	1	1	1	1	4
OG0020325	2	1	1	0	4
OG0020326	1	1	1	1	4
OG0020327	1	1	1	1	4
OG0020328	1	1	1	1	4
OG0020329	1	1	1	1	4
OG0020330	1	1	1	1	4
OG0020331	1	1	1	1	4
OG0020332	1	1	1	1	4
OG0020333	1	1	1	1	4
OG0020334	1	1	1	1	4
OG0020335	1	1	1	1	4
OG0020336	1	1	1	1	4
OG0020337	1	1	1	1	4
OG0020338	1	1	1	1	4
OG0020339	1	1	1	1	4
OG0020340	1	1	1	1	4
OG0020341	1	1	1	1	4
OG0020342	1	1	1	1	4
OG0020343	1	3	0	0	4
OG0020344	1	1	1	1	4
OG0020345	1	1	1	1	4
OG0020346	1	1	1	1	4
OG0020347	1	1	1	1	4
OG0020348	1	3	0	0	4
OG0020349	1	0	2	1	4
OG0020350	1	1	1	1	4
OG0020351	1	1	1	1	4
OG0020352	1	1	1	1	4
OG0020353	1	1	1	1	4
OG0020354	1	1	1	1	4
OG0020355	1	1	1	1	4
OG0020356	1	1	1	1	4
OG0020357	1	1	1	1	4
OG0020358	1	1	1	1	4
OG0020359	1	1	1	1	4
OG0020360	4	0	0	0	4
OG0020361	1	1	1	1	4
OG0020362	1	1	1	1	4
OG0020363	1	1	1	1	4
OG0020364	1	1	1	1	4
OG0020365	1	1	1	1	4
OG0020366	1	1	1	1	4
OG0020367	1	1	1	1	4
OG0020368	1	1	1	1	4
OG0020369	1	1	1	1	4
OG0020370	1	1	1	1	4
OG0020371	1	1	1	1	4
OG0020372	1	1	1	1	4
OG0020373	1	1	1	1	4
OG0020374	1	1	1	1	4
OG0020375	1	1	1	1	4
OG0020376	1	1	1	1	4
OG0020377	1	1	1	1	4
OG0020378	1	1	1	1	4
OG0020379	1	1	1	1	4
OG0020380	1	1	1	1	4
OG0020381	1	0	1	2	4
OG0020382	1	1	1	1	4
OG0020383	1	1	1	1	4
OG0020384	1	1	1	1	4
OG0020385	1	1	1	1	4
OG0020386	1	1	1	1	4
OG0020387	1	1	1	1	4
OG0020388	1	1	1	1	4
OG0020389	1	1	2	0	4
OG0020390	1	1	1	1	4
OG0020391	1	1	1	1	4
OG0020392	1	1	1	1	4
OG0020393	1	1	1	1	4
OG0020394	1	1	1	1	4
OG0020395	1	0	1	2	4
OG0020396	1	1	1	1	4
OG0020397	1	1	1	1	4
OG0020398	4	0	0	0	4
OG0020399	3	1	0	0	4
OG0020400	1	1	1	1	4
OG0020401	1	1	1	1	4
OG0020402	1	1	1	1	4
OG0020403	1	1	1	1	4
OG0020404	1	1	1	1	4
OG0020405	1	1	1	1	4
OG0020406	1	1	1	1	4
OG0020407	1	3	0	0	4
OG0020408	1	1	1	1	4
OG0020409	1	1	1	1	4
OG0020410	1	1	1	1	4
OG0020411	1	1	1	1	4
OG0020412	1	1	1	1	4
OG0020413	1	3	0	0	4
OG0020414	1	1	1	1	4
OG0020415	1	1	1	1	4
OG0020416	1	1	1	1	4
OG0020417	1	3	0	0	4
OG0020418	2	1	1	0	4
OG0020419	1	1	1	1	4
OG0020420	2	2	0	0	4
OG0020421	1	1	1	1	4
OG0020422	1	1	1	1	4
OG0020423	1	3	0	0	4
OG0020424	1	1	1	1	4
OG0020425	1	1	1	1	4
OG0020426	1	1	1	1	4
OG0020427	1	1	1	1	4
OG0020428	1	1	1	1	4
OG0020429	1	1	1	1	4
OG0020430	1	1	1	1	4
OG0020431	1	1	1	1	4
OG0020432	1	1	1	1	4
OG0020433	1	1	1	1	4
OG0020434	1	1	1	1	4
OG0020435	1	1	1	1	4
OG0020436	1	1	1	1	4
OG0020437	1	1	1	1	4
OG0020438	1	1	1	1	4
OG0020439	1	1	1	1	4
OG0020440	1	1	1	1	4
OG0020441	1	1	1	1	4
OG0020442	1	1	1	1	4
OG0020443	1	1	1	1	4
OG0020444	2	1	0	1	4
OG0020445	1	1	1	1	4
OG0020446	1	1	1	1	4
OG0020447	1	1	1	1	4
OG0020448	1	1	1	1	4
OG0020449	1	0	2	1	4
OG0020450	1	1	1	1	4
OG0020451	1	1	1	1	4
OG0020452	1	1	1	1	4
OG0020453	2	1	0	1	4
OG0020454	1	2	1	0	4
OG0020455	1	1	1	1	4
OG0020456	1	1	1	1	4
OG0020457	1	1	1	1	4
OG0020458	1	0	1	2	4
OG0020459	1	1	1	1	4
OG0020460	1	1	1	1	4
OG0020461	1	1	1	1	4
OG0020462	1	1	1	1	4
OG0020463	1	1	1	1	4
OG0020464	1	1	1	1	4
OG0020465	1	1	1	1	4
OG0020466	1	1	1	1	4
OG0020467	4	0	0	0	4
OG0020468	1	2	1	0	4
OG0020469	1	0	1	2	4
OG0020470	1	1	1	1	4
OG0020471	1	1	1	1	4
OG0020472	1	1	1	1	4
OG0020473	1	1	1	1	4
OG0020474	1	1	1	1	4
OG0020475	1	1	1	1	4
OG0020476	1	1	1	1	4
OG0020477	1	1	1	1	4
OG0020478	1	1	1	1	4
OG0020479	1	1	1	1	4
OG0020480	1	1	1	1	4
OG0020481	1	0	1	2	4
OG0020482	1	1	1	1	4
OG0020483	1	3	0	0	4
OG0020484	1	1	1	1	4
OG0020485	1	1	1	1	4
OG0020486	1	1	1	1	4
OG0020487	1	1	1	1	4
OG0020488	1	1	1	1	4
OG0020489	1	1	1	1	4
OG0020490	2	0	1	1	4
OG0020491	1	1	1	1	4
OG0020492	1	1	1	1	4
OG0020493	1	1	1	1	4
OG0020494	1	1	1	1	4
OG0020495	1	1	1	1	4
OG0020496	1	1	1	1	4
OG0020497	1	3	0	0	4
OG0020498	1	1	1	1	4
OG0020499	1	1	1	1	4
OG0020500	1	1	1	1	4
OG0020501	1	1	1	1	4
OG0020502	1	1	1	1	4
OG0020503	1	3	0	0	4
OG0020504	1	1	1	1	4
OG0020505	1	1	1	1	4
OG0020506	1	1	1	1	4
OG0020507	1	1	1	1	4
OG0020508	1	1	1	1	4
OG0020509	1	1	1	1	4
OG0020510	1	1	1	1	4
OG0020511	1	1	1	1	4
OG0020512	1	1	2	0	4
OG0020513	1	1	2	0	4
OG0020514	1	1	1	1	4
OG0020515	1	1	1	1	4
OG0020516	1	1	1	1	4
OG0020517	1	1	1	1	4
OG0020518	1	1	1	1	4
OG0020519	1	1	1	1	4
OG0020520	1	1	1	1	4
OG0020521	1	1	1	1	4
OG0020522	1	1	1	1	4
OG0020523	1	0	2	1	4
OG0020524	1	1	1	1	4
OG0020525	1	1	1	1	4
OG0020526	1	1	1	1	4
OG0020527	1	1	1	1	4
OG0020528	1	1	1	1	4
OG0020529	1	1	1	1	4
OG0020530	1	1	1	1	4
OG0020531	1	1	1	1	4
OG0020532	1	1	1	1	4
OG0020533	1	1	1	1	4
OG0020534	1	1	1	1	4
OG0020535	1	1	1	1	4
OG0020536	1	1	1	1	4
OG0020537	1	1	1	1	4
OG0020538	1	1	1	1	4
OG0020539	1	1	1	1	4
OG0020540	1	1	1	1	4
OG0020541	1	1	1	1	4
OG0020542	1	1	1	1	4
OG0020543	1	1	1	1	4
OG0020544	1	1	1	1	4
OG0020545	1	1	1	1	4
OG0020546	1	1	1	1	4
OG0020547	1	1	1	1	4
OG0020548	1	1	1	1	4
OG0020549	1	1	1	1	4
OG0020550	1	1	1	1	4
OG0020551	1	0	1	2	4
OG0020552	1	1	1	1	4
OG0020553	1	1	1	1	4
OG0020554	1	1	1	1	4
OG0020555	1	1	1	1	4
OG0020556	1	1	1	1	4
OG0020557	1	1	1	1	4
OG0020558	1	1	1	1	4
OG0020559	1	1	1	1	4
OG0020560	1	1	1	1	4
OG0020561	1	1	1	1	4
OG0020562	1	1	1	1	4
OG0020563	1	1	1	1	4
OG0020564	1	1	1	1	4
OG0020565	1	1	1	1	4
OG0020566	1	1	1	1	4
OG0020567	1	1	1	1	4
OG0020568	1	1	1	1	4
OG0020569	1	1	1	1	4
OG0020570	1	1	1	1	4
OG0020571	1	1	1	1	4
OG0020572	1	1	1	1	4
OG0020573	1	1	1	1	4
OG0020574	1	1	1	1	4
OG0020575	1	1	1	1	4
OG0020576	1	1	1	1	4
OG0020577	1	1	1	1	4
OG0020578	1	1	1	1	4
OG0020579	1	1	1	1	4
OG0020580	1	1	1	1	4
OG0020581	1	1	1	1	4
OG0020582	1	1	1	1	4
OG0020583	1	1	1	1	4
OG0020584	1	1	1	1	4
OG0020585	1	1	1	1	4
OG0020586	1	1	1	1	4
OG0020587	1	1	1	1	4
OG0020588	1	1	1	1	4
OG0020589	1	1	2	0	4
OG0020590	1	1	1	1	4
OG0020591	1	1	1	1	4
OG0020592	1	1	1	1	4
OG0020593	1	1	1	1	4
OG0020594	1	1	1	1	4
OG0020595	1	1	1	1	4
OG0020596	1	1	1	1	4
OG0020597	1	1	1	1	4
OG0020598	1	1	1	1	4
OG0020599	1	1	1	1	4
OG0020600	1	1	1	1	4
OG0020601	1	1	1	1	4
OG0020602	1	1	1	1	4
OG0020603	1	1	1	1	4
OG0020604	1	0	1	2	4
OG0020605	1	1	1	1	4
OG0020606	1	1	1	1	4
OG0020607	1	1	1	1	4
OG0020608	1	1	1	1	4
OG0020609	1	1	1	1	4
OG0020610	1	1	1	1	4
OG0020611	1	1	1	1	4
OG0020612	1	1	1	1	4
OG0020613	1	1	1	1	4
OG0020614	1	1	1	1	4
OG0020615	1	1	1	1	4
OG0020616	1	1	1	1	4
OG0020617	1	1	1	1	4
OG0020618	1	1	1	1	4
OG0020619	1	1	1	1	4
OG0020620	1	1	1	1	4
OG0020621	1	1	1	1	4
OG0020622	1	1	1	1	4
OG0020623	1	1	1	1	4
OG0020624	1	1	1	1	4
OG0020625	1	1	1	1	4
OG0020626	1	1	1	1	4
OG0020627	1	1	1	1	4
OG0020628	1	1	1	1	4
OG0020629	1	1	1	1	4
OG0020630	1	1	1	1	4
OG0020631	1	1	1	1	4
OG0020632	1	1	1	1	4
OG0020633	1	1	1	1	4
OG0020634	1	1	1	1	4
OG0020635	1	1	1	1	4
OG0020636	1	1	1	1	4
OG0020637	1	1	1	1	4
OG0020638	1	1	1	1	4
OG0020639	1	1	1	1	4
OG0020640	1	1	1	1	4
OG0020641	1	1	1	1	4
OG0020642	1	1	1	1	4
OG0020643	1	1	1	1	4
OG0020644	1	1	1	1	4
OG0020645	1	1	1	1	4
OG0020646	1	1	1	1	4
OG0020647	1	1	1	1	4
OG0020648	1	1	1	1	4
OG0020649	1	1	1	1	4
OG0020650	1	1	1	1	4
OG0020651	1	1	1	1	4
OG0020652	1	3	0	0	4
OG0020653	1	1	1	1	4
OG0020654	1	1	1	1	4
OG0020655	1	1	1	1	4
OG0020656	1	1	1	1	4
OG0020657	1	1	1	1	4
OG0020658	1	1	1	1	4
OG0020659	1	1	1	1	4
OG0020660	1	1	1	1	4
OG0020661	1	1	1	1	4
OG0020662	1	1	1	1	4
OG0020663	1	1	1	1	4
OG0020664	1	1	1	1	4
OG0020665	1	1	1	1	4
OG0020666	1	1	1	1	4
OG0020667	1	1	1	1	4
OG0020668	1	0	1	2	4
OG0020669	1	1	1	1	4
OG0020670	1	1	1	1	4
OG0020671	1	1	1	1	4
OG0020672	1	1	1	1	4
OG0020673	1	1	1	1	4
OG0020674	1	1	1	1	4
OG0020675	1	1	1	1	4
OG0020676	1	1	1	1	4
OG0020677	1	1	1	1	4
OG0020678	1	1	1	1	4
OG0020679	1	1	1	1	4
OG0020680	1	1	1	1	4
OG0020681	1	1	1	1	4
OG0020682	1	1	1	1	4
OG0020683	1	1	1	1	4
OG0020684	1	1	1	1	4
OG0020685	1	1	1	1	4
OG0020686	1	1	1	1	4
OG0020687	1	1	1	1	4
OG0020688	1	1	1	1	4
OG0020689	1	1	1	1	4
OG0020690	1	1	1	1	4
OG0020691	2	0	1	1	4
OG0020692	1	1	1	1	4
OG0020693	1	1	0	2	4
OG0020694	1	1	1	1	4
OG0020695	1	1	1	1	4
OG0020696	1	0	1	2	4
OG0020697	1	1	1	1	4
OG0020698	1	1	1	1	4
OG0020699	1	1	1	1	4
OG0020700	3	1	0	0	4
OG0020701	1	1	1	1	4
OG0020702	1	1	1	1	4
OG0020703	1	1	1	1	4
OG0020704	1	1	1	1	4
OG0020705	1	1	1	1	4
OG0020706	1	1	1	1	4
OG0020707	1	1	1	1	4
OG0020708	1	1	1	1	4
OG0020709	1	1	1	1	4
OG0020710	1	1	1	1	4
OG0020711	3	1	0	0	4
OG0020712	1	1	1	1	4
OG0020713	1	1	1	1	4
OG0020714	1	1	1	1	4
OG0020715	1	1	1	1	4
OG0020716	1	1	1	1	4
OG0020717	1	1	1	1	4
OG0020718	1	1	1	1	4
OG0020719	1	1	1	1	4
OG0020720	1	1	1	1	4
OG0020721	1	1	1	1	4
OG0020722	1	1	1	1	4
OG0020723	1	1	1	1	4
OG0020724	1	1	1	1	4
OG0020725	1	1	1	1	4
OG0020726	1	1	1	1	4
OG0020727	1	1	1	1	4
OG0020728	1	1	1	1	4
OG0020729	1	1	1	1	4
OG0020730	1	1	1	1	4
OG0020731	1	1	1	1	4
OG0020732	1	1	1	1	4
OG0020733	1	0	1	2	4
OG0020734	1	1	1	1	4
OG0020735	1	1	1	1	4
OG0020736	1	1	1	1	4
OG0020737	1	1	1	1	4
OG0020738	1	1	1	1	4
OG0020739	1	1	1	1	4
OG0020740	1	1	1	1	4
OG0020741	1	1	1	1	4
OG0020742	1	1	1	1	4
OG0020743	1	1	1	1	4
OG0020744	1	1	1	1	4
OG0020745	1	1	1	1	4
OG0020746	2	1	1	0	4
OG0020747	1	1	1	1	4
OG0020748	1	1	1	1	4
OG0020749	1	1	1	1	4
OG0020750	1	1	1	1	4
OG0020751	1	1	1	1	4
OG0020752	1	1	1	1	4
OG0020753	1	1	1	1	4
OG0020754	1	1	1	1	4
OG0020755	1	0	2	1	4
OG0020756	1	1	1	1	4
OG0020757	1	1	1	1	4
OG0020758	1	1	1	1	4
OG0020759	1	1	1	1	4
OG0020760	1	1	1	1	4
OG0020761	1	1	1	1	4
OG0020762	1	1	1	1	4
OG0020763	1	1	1	1	4
OG0020764	1	1	1	1	4
OG0020765	1	1	1	1	4
OG0020766	1	1	1	1	4
OG0020767	1	1	1	1	4
OG0020768	1	1	1	1	4
OG0020769	1	2	1	0	4
OG0020770	1	1	1	1	4
OG0020771	1	1	1	1	4
OG0020772	1	1	1	1	4
OG0020773	1	1	1	1	4
OG0020774	1	1	1	1	4
OG0020775	1	0	1	2	4
OG0020776	1	1	1	1	4
OG0020777	1	1	1	1	4
OG0020778	1	1	1	1	4
OG0020779	1	1	1	1	4
OG0020780	1	1	1	1	4
OG0020781	1	1	1	1	4
OG0020782	1	1	1	1	4
OG0020783	1	1	1	1	4
OG0020784	1	1	1	1	4
OG0020785	1	1	1	1	4
OG0020786	1	1	1	1	4
OG0020787	1	1	1	1	4
OG0020788	1	1	1	1	4
OG0020789	1	1	1	1	4
OG0020790	1	1	1	1	4
OG0020791	1	1	1	1	4
OG0020792	1	1	1	1	4
OG0020793	1	1	1	1	4
OG0020794	1	1	1	1	4
OG0020795	1	1	1	1	4
OG0020796	1	1	1	1	4
OG0020797	1	1	1	1	4
OG0020798	1	1	1	1	4
OG0020799	1	1	1	1	4
OG0020800	1	1	1	1	4
OG0020801	1	1	1	1	4
OG0020802	1	1	1	1	4
OG0020803	1	1	1	1	4
OG0020804	1	1	1	1	4
OG0020805	1	1	1	1	4
OG0020806	1	1	1	1	4
OG0020807	1	1	1	1	4
OG0020808	1	3	0	0	4
OG0020809	1	1	1	1	4
OG0020810	1	1	1	1	4
OG0020811	1	1	1	1	4
OG0020812	1	1	1	1	4
OG0020813	1	1	1	1	4
OG0020814	1	1	1	1	4
OG0020815	1	1	1	1	4
OG0020816	1	1	1	1	4
OG0020817	1	1	1	1	4
OG0020818	1	0	1	2	4
OG0020819	1	1	1	1	4
OG0020820	1	1	1	1	4
OG0020821	1	1	1	1	4
OG0020822	1	1	1	1	4
OG0020823	1	1	1	1	4
OG0020824	1	1	2	0	4
OG0020825	1	1	1	1	4
OG0020826	1	1	1	1	4
OG0020827	1	1	1	1	4
OG0020828	1	1	1	1	4
OG0020829	1	1	1	1	4
OG0020830	1	1	1	1	4
OG0020831	1	1	1	1	4
OG0020832	1	1	1	1	4
OG0020833	1	1	1	1	4
OG0020834	1	1	1	1	4
OG0020835	1	0	1	2	4
OG0020836	1	1	1	1	4
OG0020837	1	1	1	1	4
OG0020838	1	0	2	1	4
OG0020839	1	1	1	1	4
OG0020840	4	0	0	0	4
OG0020841	1	1	1	1	4
OG0020842	1	1	1	1	4
OG0020843	1	1	1	1	4
OG0020844	1	1	1	1	4
OG0020845	1	1	1	1	4
OG0020846	1	1	1	1	4
OG0020847	1	1	1	1	4
OG0020848	1	1	1	1	4
OG0020849	1	1	1	1	4
OG0020850	1	1	1	1	4
OG0020851	1	1	1	1	4
OG0020852	1	1	1	1	4
OG0020853	1	1	1	1	4
OG0020854	1	1	1	1	4
OG0020855	1	1	1	1	4
OG0020856	1	1	1	1	4
OG0020857	1	1	1	1	4
OG0020858	1	1	1	1	4
OG0020859	1	1	1	1	4
OG0020860	1	1	1	1	4
OG0020861	1	1	1	1	4
OG0020862	1	1	1	1	4
OG0020863	1	1	1	1	4
OG0020864	1	1	1	1	4
OG0020865	2	1	0	1	4
OG0020866	1	1	1	1	4
OG0020867	1	1	1	1	4
OG0020868	1	1	1	1	4
OG0020869	1	1	1	1	4
OG0020870	1	1	1	1	4
OG0020871	1	1	1	1	4
OG0020872	1	1	1	1	4
OG0020873	1	1	1	1	4
OG0020874	1	1	1	1	4
OG0020875	1	1	1	1	4
OG0020876	1	1	1	1	4
OG0020877	1	1	1	1	4
OG0020878	1	1	1	1	4
OG0020879	1	1	1	1	4
OG0020880	1	1	1	1	4
OG0020881	1	1	1	1	4
OG0020882	1	1	1	1	4
OG0020883	1	1	1	1	4
OG0020884	1	1	1	1	4
OG0020885	1	1	1	1	4
OG0020886	3	1	0	0	4
OG0020887	1	1	1	1	4
OG0020888	1	1	1	1	4
OG0020889	1	1	1	1	4
OG0020890	1	1	1	1	4
OG0020891	1	1	1	1	4
OG0020892	1	1	1	1	4
OG0020893	1	1	1	1	4
OG0020894	1	1	1	1	4
OG0020895	1	1	1	1	4
OG0020896	1	1	1	1	4
OG0020897	1	1	1	1	4
OG0020898	1	1	1	1	4
OG0020899	1	0	0	3	4
OG0020900	1	1	1	1	4
OG0020901	1	3	0	0	4
OG0020902	1	1	1	1	4
OG0020903	1	1	1	1	4
OG0020904	1	1	1	1	4
OG0020905	1	1	1	1	4
OG0020906	1	0	2	1	4
OG0020907	1	1	1	1	4
OG0020908	1	1	1	1	4
OG0020909	2	1	0	1	4
OG0020910	1	1	1	1	4
OG0020911	1	1	1	1	4
OG0020912	1	3	0	0	4
OG0020913	1	1	1	1	4
OG0020914	3	1	0	0	4
OG0020915	1	1	1	1	4
OG0020916	1	1	1	1	4
OG0020917	1	1	1	1	4
OG0020918	1	1	1	1	4
OG0020919	1	1	1	1	4
OG0020920	1	1	1	1	4
OG0020921	1	1	1	1	4
OG0020922	1	1	1	1	4
OG0020923	1	1	1	1	4
OG0020924	1	1	1	1	4
OG0020925	1	1	1	1	4
OG0020926	1	0	1	2	4
OG0020927	1	1	1	1	4
OG0020928	1	1	1	1	4
OG0020929	1	1	1	1	4
OG0020930	1	1	1	1	4
OG0020931	1	1	1	1	4
OG0020932	1	1	1	1	4
OG0020933	1	1	1	1	4
OG0020934	1	1	1	1	4
OG0020935	1	1	1	1	4
OG0020936	1	1	1	1	4
OG0020937	1	1	1	1	4
OG0020938	1	1	1	1	4
OG0020939	1	1	1	1	4
OG0020940	1	1	1	1	4
OG0020941	1	1	1	1	4
OG0020942	1	1	1	1	4
OG0020943	1	1	1	1	4
OG0020944	1	1	1	1	4
OG0020945	1	1	1	1	4
OG0020946	1	1	1	1	4
OG0020947	1	1	1	1	4
OG0020948	1	1	1	1	4
OG0020949	1	1	1	1	4
OG0020950	1	1	1	1	4
OG0020951	1	1	1	1	4
OG0020952	1	1	1	1	4
OG0020953	1	1	1	1	4
OG0020954	1	1	1	1	4
OG0020955	1	1	1	1	4
OG0020956	1	1	1	1	4
OG0020957	1	1	1	1	4
OG0020958	1	1	1	1	4
OG0020959	1	1	1	1	4
OG0020960	1	1	1	1	4
OG0020961	1	1	1	1	4
OG0020962	1	1	1	1	4
OG0020963	1	1	1	1	4
OG0020964	1	1	1	1	4
OG0020965	1	1	1	1	4
OG0020966	1	1	1	1	4
OG0020967	1	1	1	1	4
OG0020968	1	1	1	1	4
OG0020969	1	1	1	1	4
OG0020970	1	1	1	1	4
OG0020971	1	1	1	1	4
OG0020972	1	1	1	1	4
OG0020973	1	1	1	1	4
OG0020974	1	1	1	1	4
OG0020975	1	1	1	1	4
OG0020976	1	1	1	1	4
OG0020977	1	1	1	1	4
OG0020978	1	3	0	0	4
OG0020979	1	1	1	1	4
OG0020980	1	1	1	1	4
OG0020981	1	1	1	1	4
OG0020982	1	1	1	1	4
OG0020983	1	1	0	2	4
OG0020984	1	1	1	1	4
OG0020985	1	1	1	1	4
OG0020986	1	1	1	1	4
OG0020987	1	1	1	1	4
OG0020988	1	1	1	1	4
OG0020989	1	1	1	1	4
OG0020990	1	1	1	1	4
OG0020991	2	0	1	1	4
OG0020992	1	1	1	1	4
OG0020993	1	1	1	1	4
OG0020994	1	3	0	0	4
OG0020995	1	1	1	1	4
OG0020996	1	1	1	1	4
OG0020997	1	1	1	1	4
OG0020998	1	1	1	1	4
OG0020999	1	1	1	1	4
OG0021000	1	1	1	1	4
OG0021001	1	1	1	1	4
OG0021002	1	1	1	1	4
OG0021003	1	1	1	1	4
OG0021004	1	1	1	1	4
OG0021005	1	1	1	1	4
OG0021006	1	1	1	1	4
OG0021007	1	1	1	1	4
OG0021008	1	1	1	1	4
OG0021009	1	1	1	1	4
OG0021010	1	1	1	1	4
OG0021011	1	1	1	1	4
OG0021012	1	1	1	1	4
OG0021013	1	1	1	1	4
OG0021014	1	1	1	1	4
OG0021015	1	1	1	1	4
OG0021016	1	1	1	1	4
OG0021017	1	1	1	1	4
OG0021018	1	1	1	1	4
OG0021019	1	1	1	1	4
OG0021020	1	1	1	1	4
OG0021021	1	1	1	1	4
OG0021022	1	1	1	1	4
OG0021023	1	1	1	1	4
OG0021024	1	1	1	1	4
OG0021025	1	1	1	1	4
OG0021026	1	1	1	1	4
OG0021027	1	0	2	1	4
OG0021028	1	1	1	1	4
OG0021029	1	1	1	1	4
OG0021030	1	1	1	1	4
OG0021031	1	1	1	1	4
OG0021032	1	1	1	1	4
OG0021033	1	1	1	1	4
OG0021034	1	1	1	1	4
OG0021035	1	1	1	1	4
OG0021036	1	1	1	1	4
OG0021037	1	1	1	1	4
OG0021038	1	1	1	1	4
OG0021039	1	1	1	1	4
OG0021040	1	1	1	1	4
OG0021041	1	1	2	0	4
OG0021042	1	1	1	1	4
OG0021043	1	1	1	1	4
OG0021044	1	1	1	1	4
OG0021045	1	1	1	1	4
OG0021046	1	1	1	1	4
OG0021047	1	1	1	1	4
OG0021048	1	1	1	1	4
OG0021049	1	1	1	1	4
OG0021050	1	1	1	1	4
OG0021051	1	1	1	1	4
OG0021052	1	1	1	1	4
OG0021053	1	1	1	1	4
OG0021054	1	1	1	1	4
OG0021055	1	1	1	1	4
OG0021056	1	1	1	1	4
OG0021057	1	1	1	1	4
OG0021058	1	1	1	1	4
OG0021059	1	1	1	1	4
OG0021060	1	1	1	1	4
OG0021061	1	1	1	1	4
OG0021062	1	1	1	1	4
OG0021063	1	1	1	1	4
OG0021064	1	1	1	1	4
OG0021065	1	1	1	1	4
OG0021066	1	1	1	1	4
OG0021067	1	1	1	1	4
OG0021068	1	1	1	1	4
OG0021069	1	1	1	1	4
OG0021070	1	0	1	2	4
OG0021071	1	1	1	1	4
OG0021072	1	1	1	1	4
OG0021073	1	1	1	1	4
OG0021074	1	1	1	1	4
OG0021075	1	1	1	1	4
OG0021076	1	1	1	1	4
OG0021077	1	1	1	1	4
OG0021078	1	1	1	1	4
OG0021079	1	1	1	1	4
OG0021080	1	1	1	1	4
OG0021081	1	1	1	1	4
OG0021082	1	1	1	1	4
OG0021083	1	1	1	1	4
OG0021084	1	1	1	1	4
OG0021085	1	1	1	1	4
OG0021086	1	1	1	1	4
OG0021087	1	1	1	1	4
OG0021088	1	1	1	1	4
OG0021089	1	1	1	1	4
OG0021090	1	1	1	1	4
OG0021091	1	1	1	1	4
OG0021092	1	1	1	1	4
OG0021093	1	1	1	1	4
OG0021094	1	1	1	1	4
OG0021095	1	1	1	1	4
OG0021096	1	1	1	1	4
OG0021097	1	1	1	1	4
OG0021098	1	1	1	1	4
OG0021099	1	1	1	1	4
OG0021100	1	1	1	1	4
OG0021101	2	1	0	1	4
OG0021102	1	1	1	1	4
OG0021103	1	1	1	1	4
OG0021104	1	1	1	1	4
OG0021105	1	1	1	1	4
OG0021106	1	1	1	1	4
OG0021107	1	1	1	1	4
OG0021108	1	1	1	1	4
OG0021109	1	1	1	1	4
OG0021110	1	1	1	1	4
OG0021111	1	1	1	1	4
OG0021112	1	1	1	1	4
OG0021113	1	1	1	1	4
OG0021114	1	1	1	1	4
OG0021115	1	1	1	1	4
OG0021116	1	1	1	1	4
OG0021117	1	1	1	1	4
OG0021118	1	1	1	1	4
OG0021119	1	1	1	1	4
OG0021120	1	0	1	2	4
OG0021121	1	1	1	1	4
OG0021122	1	1	1	1	4
OG0021123	1	1	1	1	4
OG0021124	1	1	1	1	4
OG0021125	1	1	1	1	4
OG0021126	1	1	1	1	4
OG0021127	1	1	1	1	4
OG0021128	1	1	1	1	4
OG0021129	1	1	1	1	4
OG0021130	1	1	1	1	4
OG0021131	1	1	1	1	4
OG0021132	1	1	1	1	4
OG0021133	1	1	1	1	4
OG0021134	1	1	1	1	4
OG0021135	1	1	1	1	4
OG0021136	1	1	1	1	4
OG0021137	1	1	1	1	4
OG0021138	1	1	1	1	4
OG0021139	1	1	1	1	4
OG0021140	1	1	1	1	4
OG0021141	1	1	1	1	4
OG0021142	1	2	1	0	4
OG0021143	1	1	1	1	4
OG0021144	1	1	1	1	4
OG0021145	1	1	1	1	4
OG0021146	1	1	1	1	4
OG0021147	1	1	1	1	4
OG0021148	1	1	1	1	4
OG0021149	1	1	1	1	4
OG0021150	1	1	1	1	4
OG0021151	1	1	1	1	4
OG0021152	1	1	1	1	4
OG0021153	1	1	1	1	4
OG0021154	1	1	1	1	4
OG0021155	1	1	1	1	4
OG0021156	1	1	1	1	4
OG0021157	1	1	1	1	4
OG0021158	1	1	1	1	4
OG0021159	1	1	1	1	4
OG0021160	1	1	1	1	4
OG0021161	1	1	1	1	4
OG0021162	1	1	1	1	4
OG0021163	1	1	1	1	4
OG0021164	1	1	1	1	4
OG0021165	1	1	1	1	4
OG0021166	1	1	1	1	4
OG0021167	1	1	1	1	4
OG0021168	1	1	1	1	4
OG0021169	1	1	1	1	4
OG0021170	1	1	1	1	4
OG0021171	1	1	1	1	4
OG0021172	1	1	1	1	4
OG0021173	1	1	1	1	4
OG0021174	1	1	1	1	4
OG0021175	1	1	1	1	4
OG0021176	1	1	1	1	4
OG0021177	1	1	1	1	4
OG0021178	1	1	1	1	4
OG0021179	1	1	1	1	4
OG0021180	1	1	1	1	4
OG0021181	1	1	1	1	4
OG0021182	1	1	1	1	4
OG0021183	1	0	2	1	4
OG0021184	1	1	1	1	4
OG0021185	1	1	1	1	4
OG0021186	1	1	1	1	4
OG0021187	1	1	1	1	4
OG0021188	1	1	1	1	4
OG0021189	1	1	1	1	4
OG0021190	1	1	1	1	4
OG0021191	1	1	1	1	4
OG0021192	1	1	1	1	4
OG0021193	1	1	1	1	4
OG0021194	1	1	1	1	4
OG0021195	1	1	1	1	4
OG0021196	1	1	1	1	4
OG0021197	1	1	1	1	4
OG0021198	1	1	1	1	4
OG0021199	1	1	1	1	4
OG0021200	1	1	1	1	4
OG0021201	1	1	1	1	4
OG0021202	1	1	1	1	4
OG0021203	1	0	2	1	4
OG0021204	1	1	1	1	4
OG0021205	1	1	1	1	4
OG0021206	1	0	2	1	4
OG0021207	1	1	1	1	4
OG0021208	1	1	1	1	4
OG0021209	1	1	1	1	4
OG0021210	1	1	1	1	4
OG0021211	1	1	1	1	4
OG0021212	1	1	1	1	4
OG0021213	1	1	1	1	4
OG0021214	1	1	1	1	4
OG0021215	1	1	1	1	4
OG0021216	1	1	1	1	4
OG0021217	1	1	1	1	4
OG0021218	1	1	1	1	4
OG0021219	1	1	1	1	4
OG0021220	1	1	1	1	4
OG0021221	1	1	1	1	4
OG0021222	1	1	1	1	4
OG0021223	1	1	1	1	4
OG0021224	1	1	1	1	4
OG0021225	1	1	1	1	4
OG0021226	1	1	1	1	4
OG0021227	1	1	1	1	4
OG0021228	1	0	2	1	4
OG0021229	1	1	1	1	4
OG0021230	1	1	1	1	4
OG0021231	1	1	1	1	4
OG0021232	1	1	1	1	4
OG0021233	1	1	1	1	4
OG0021234	1	1	1	1	4
OG0021235	1	1	1	1	4
OG0021236	2	0	1	1	4
OG0021237	1	1	1	1	4
OG0021238	1	1	1	1	4
OG0021239	1	1	1	1	4
OG0021240	1	1	1	1	4
OG0021241	1	1	1	1	4
OG0021242	1	1	1	1	4
OG0021243	1	1	1	1	4
OG0021244	1	1	1	1	4
OG0021245	1	1	1	1	4
OG0021246	1	1	1	1	4
OG0021247	1	1	1	1	4
OG0021248	1	1	1	1	4
OG0021249	1	1	1	1	4
OG0021250	1	1	1	1	4
OG0021251	1	1	1	1	4
OG0021252	1	1	1	1	4
OG0021253	1	1	1	1	4
OG0021254	1	1	1	1	4
OG0021255	1	1	1	1	4
OG0021256	1	1	1	1	4
OG0021257	1	1	2	0	4
OG0021258	1	1	1	1	4
OG0021259	1	1	1	1	4
OG0021260	1	1	1	1	4
OG0021261	1	1	1	1	4
OG0021262	1	1	1	1	4
OG0021263	1	1	1	1	4
OG0021264	1	1	1	1	4
OG0021265	1	1	1	1	4
OG0021266	1	1	1	1	4
OG0021267	1	1	1	1	4
OG0021268	1	1	1	1	4
OG0021269	1	1	1	1	4
OG0021270	1	1	1	1	4
OG0021271	1	1	1	1	4
OG0021272	1	1	1	1	4
OG0021273	1	1	1	1	4
OG0021274	1	1	1	1	4
OG0021275	1	1	1	1	4
OG0021276	1	1	1	1	4
OG0021277	1	1	1	1	4
OG0021278	1	1	1	1	4
OG0021279	1	1	1	1	4
OG0021280	1	1	1	1	4
OG0021281	1	1	1	1	4
OG0021282	1	1	1	1	4
OG0021283	1	1	1	1	4
OG0021284	1	1	1	1	4
OG0021285	1	1	1	1	4
OG0021286	1	1	1	1	4
OG0021287	1	1	1	1	4
OG0021288	1	1	1	1	4
OG0021289	1	1	1	1	4
OG0021290	1	1	1	1	4
OG0021291	1	0	1	2	4
OG0021292	1	1	1	1	4
OG0021293	1	1	1	1	4
OG0021294	1	1	1	1	4
OG0021295	1	1	1	1	4
OG0021296	1	1	1	1	4
OG0021297	1	1	1	1	4
OG0021298	1	1	1	1	4
OG0021299	1	1	1	1	4
OG0021300	1	1	1	1	4
OG0021301	1	1	1	1	4
OG0021302	1	1	1	1	4
OG0021303	1	1	1	1	4
OG0021304	1	1	1	1	4
OG0021305	1	1	1	1	4
OG0021306	1	1	1	1	4
OG0021307	1	1	1	1	4
OG0021308	1	1	1	1	4
OG0021309	1	1	1	1	4
OG0021310	1	1	1	1	4
OG0021311	1	1	1	1	4
OG0021312	1	1	1	1	4
OG0021313	1	1	1	1	4
OG0021314	1	1	1	1	4
OG0021315	1	1	1	1	4
OG0021316	1	1	1	1	4
OG0021317	1	0	1	2	4
OG0021318	1	1	1	1	4
OG0021319	1	1	1	1	4
OG0021320	1	1	1	1	4
OG0021321	1	1	1	1	4
OG0021322	1	1	1	1	4
OG0021323	1	1	1	1	4
OG0021324	1	1	1	1	4
OG0021325	1	1	1	1	4
OG0021326	1	1	1	1	4
OG0021327	1	1	1	1	4
OG0021328	1	1	1	1	4
OG0021329	1	1	1	1	4
OG0021330	1	1	1	1	4
OG0021331	1	1	1	1	4
OG0021332	1	1	1	1	4
OG0021333	1	1	1	1	4
OG0021334	1	1	1	1	4
OG0021335	1	1	1	1	4
OG0021336	1	1	1	1	4
OG0021337	1	1	1	1	4
OG0021338	1	1	1	1	4
OG0021339	1	1	1	1	4
OG0021340	1	1	1	1	4
OG0021341	1	1	1	1	4
OG0021342	1	1	1	1	4
OG0021343	1	1	1	1	4
OG0021344	1	1	1	1	4
OG0021345	1	1	1	1	4
OG0021346	1	0	1	2	4
OG0021347	1	1	1	1	4
OG0021348	1	0	2	1	4
OG0021349	1	0	1	2	4
OG0021350	1	1	1	1	4
OG0021351	1	1	1	1	4
OG0021352	1	1	1	1	4
OG0021353	1	1	1	1	4
OG0021354	1	1	1	1	4
OG0021355	1	1	1	1	4
OG0021356	1	1	1	1	4
OG0021357	1	1	1	1	4
OG0021358	1	1	1	1	4
OG0021359	1	1	1	1	4
OG0021360	1	1	1	1	4
OG0021361	1	1	1	1	4
OG0021362	1	1	1	1	4
OG0021363	1	1	1	1	4
OG0021364	1	1	1	1	4
OG0021365	1	1	1	1	4
OG0021366	1	1	1	1	4
OG0021367	1	1	1	1	4
OG0021368	1	1	1	1	4
OG0021369	1	1	1	1	4
OG0021370	1	1	1	1	4
OG0021371	1	1	1	1	4
OG0021372	1	1	1	1	4
OG0021373	1	1	1	1	4
OG0021374	3	1	0	0	4
OG0021375	1	1	1	1	4
OG0021376	1	1	1	1	4
OG0021377	1	1	1	1	4
OG0021378	1	1	1	1	4
OG0021379	1	1	1	1	4
OG0021380	1	1	1	1	4
OG0021381	1	1	1	1	4
OG0021382	1	1	1	1	4
OG0021383	1	1	1	1	4
OG0021384	1	1	1	1	4
OG0021385	1	0	2	1	4
OG0021386	1	1	1	1	4
OG0021387	1	1	1	1	4
OG0021388	1	1	1	1	4
OG0021389	1	0	2	1	4
OG0021390	1	1	1	1	4
OG0021391	1	1	1	1	4
OG0021392	1	1	1	1	4
OG0021393	1	1	1	1	4
OG0021394	1	1	1	1	4
OG0021395	1	1	1	1	4
OG0021396	1	1	1	1	4
OG0021397	4	0	0	0	4
OG0021398	1	1	1	1	4
OG0021399	1	1	1	1	4
OG0021400	1	1	1	1	4
OG0021401	1	1	1	1	4
OG0021402	1	1	1	1	4
OG0021403	1	1	1	1	4
OG0021404	1	1	1	1	4
OG0021405	1	1	1	1	4
OG0021406	1	1	1	1	4
OG0021407	1	1	1	1	4
OG0021408	1	1	1	1	4
OG0021409	1	1	1	1	4
OG0021410	1	1	1	1	4
OG0021411	1	1	1	1	4
OG0021412	1	1	1	1	4
OG0021413	1	1	1	1	4
OG0021414	1	1	1	1	4
OG0021415	1	1	1	1	4
OG0021416	1	1	1	1	4
OG0021417	1	1	1	1	4
OG0021418	1	1	1	1	4
OG0021419	1	1	1	1	4
OG0021420	1	1	1	1	4
OG0021421	1	1	1	1	4
OG0021422	1	1	1	1	4
OG0021423	1	1	1	1	4
OG0021424	1	1	1	1	4
OG0021425	1	1	1	1	4
OG0021426	1	1	1	1	4
OG0021427	1	1	1	1	4
OG0021428	1	1	1	1	4
OG0021429	1	1	1	1	4
OG0021430	1	1	1	1	4
OG0021431	1	1	1	1	4
OG0021432	1	1	1	1	4
OG0021433	1	1	1	1	4
OG0021434	1	1	1	1	4
OG0021435	1	1	1	1	4
OG0021436	1	1	1	1	4
OG0021437	1	1	1	1	4
OG0021438	1	1	1	1	4
OG0021439	1	1	1	1	4
OG0021440	1	1	1	1	4
OG0021441	1	1	1	1	4
OG0021442	1	1	1	1	4
OG0021443	1	1	1	1	4
OG0021444	1	1	1	1	4
OG0021445	1	1	1	1	4
OG0021446	1	1	1	1	4
OG0021447	1	1	1	1	4
OG0021448	1	1	1	1	4
OG0021449	1	1	1	1	4
OG0021450	1	1	1	1	4
OG0021451	1	1	1	1	4
OG0021452	1	1	1	1	4
OG0021453	1	1	1	1	4
OG0021454	1	1	1	1	4
OG0021455	1	1	1	1	4
OG0021456	1	1	1	1	4
OG0021457	1	1	1	1	4
OG0021458	1	1	1	1	4
OG0021459	1	1	1	1	4
OG0021460	1	1	1	1	4
OG0021461	1	1	1	1	4
OG0021462	1	1	1	1	4
OG0021463	1	1	1	1	4
OG0021464	1	1	1	1	4
OG0021465	1	1	1	1	4
OG0021466	1	1	1	1	4
OG0021467	1	1	1	1	4
OG0021468	1	1	1	1	4
OG0021469	1	1	1	1	4
OG0021470	1	1	1	1	4
OG0021471	1	1	1	1	4
OG0021472	1	1	1	1	4
OG0021473	1	1	1	1	4
OG0021474	1	1	1	1	4
OG0021475	1	1	1	1	4
OG0021476	1	1	1	1	4
OG0021477	1	1	1	1	4
OG0021478	1	1	1	1	4
OG0021479	1	1	1	1	4
OG0021480	1	1	1	1	4
OG0021481	1	1	1	1	4
OG0021482	1	1	1	1	4
OG0021483	1	1	1	1	4
OG0021484	1	1	1	1	4
OG0021485	1	1	1	1	4
OG0021486	1	1	1	1	4
OG0021487	1	1	1	1	4
OG0021488	1	1	1	1	4
OG0021489	1	1	1	1	4
OG0021490	1	1	1	1	4
OG0021491	1	1	1	1	4
OG0021492	1	1	1	1	4
OG0021493	1	1	1	1	4
OG0021494	1	1	1	1	4
OG0021495	1	1	0	2	4
OG0021496	1	1	1	1	4
OG0021497	1	1	1	1	4
OG0021498	1	1	1	1	4
OG0021499	1	1	1	1	4
OG0021500	1	1	1	1	4
OG0021501	1	1	1	1	4
OG0021502	1	1	1	1	4
OG0021503	1	1	1	1	4
OG0021504	1	1	1	1	4
OG0021505	1	1	1	1	4
OG0021506	1	1	1	1	4
OG0021507	1	1	1	1	4
OG0021508	1	1	1	1	4
OG0021509	1	1	1	1	4
OG0021510	1	1	1	1	4
OG0021511	1	1	1	1	4
OG0021512	1	1	1	1	4
OG0021513	1	1	1	1	4
OG0021514	1	1	1	1	4
OG0021515	1	1	1	1	4
OG0021516	1	1	1	1	4
OG0021517	1	1	1	1	4
OG0021518	1	1	1	1	4
OG0021519	1	1	1	1	4
OG0021520	1	1	1	1	4
OG0021521	1	1	1	1	4
OG0021522	1	1	1	1	4
OG0021523	1	1	1	1	4
OG0021524	1	1	1	1	4
OG0021525	1	1	1	1	4
OG0021526	1	1	1	1	4
OG0021527	1	1	1	1	4
OG0021528	1	1	1	1	4
OG0021529	1	1	1	1	4
OG0021530	1	1	1	1	4
OG0021531	1	1	1	1	4
OG0021532	1	1	1	1	4
OG0021533	1	1	1	1	4
OG0021534	1	1	1	1	4
OG0021535	1	1	1	1	4
OG0021536	1	1	1	1	4
OG0021537	1	1	1	1	4
OG0021538	1	1	1	1	4
OG0021539	1	1	1	1	4
OG0021540	1	1	1	1	4
OG0021541	1	1	1	1	4
OG0021542	1	1	1	1	4
OG0021543	1	0	2	1	4
OG0021544	1	1	1	1	4
OG0021545	1	1	1	1	4
OG0021546	1	1	1	1	4
OG0021547	1	1	1	1	4
OG0021548	1	1	1	1	4
OG0021549	1	1	1	1	4
OG0021550	1	1	1	1	4
OG0021551	1	1	1	1	4
OG0021552	1	1	1	1	4
OG0021553	1	0	1	2	4
OG0021554	1	1	1	1	4
OG0021555	1	1	1	1	4
OG0021556	1	1	1	1	4
OG0021557	1	1	1	1	4
OG0021558	1	1	1	1	4
OG0021559	1	1	1	1	4
OG0021560	1	1	1	1	4
OG0021561	1	1	1	1	4
OG0021562	1	1	1	1	4
OG0021563	1	1	1	1	4
OG0021564	1	1	1	1	4
OG0021565	1	1	1	1	4
OG0021566	1	1	1	1	4
OG0021567	1	1	0	2	4
OG0021568	1	1	1	1	4
OG0021569	1	1	1	1	4
OG0021570	1	1	1	1	4
OG0021571	1	1	1	1	4
OG0021572	1	1	1	1	4
OG0021573	1	1	1	1	4
OG0021574	1	1	1	1	4
OG0021575	1	1	1	1	4
OG0021576	1	1	1	1	4
OG0021577	1	1	1	1	4
OG0021578	1	1	1	1	4
OG0021579	1	1	1	1	4
OG0021580	1	1	1	1	4
OG0021581	1	1	1	1	4
OG0021582	1	1	1	1	4
OG0021583	1	1	1	1	4
OG0021584	1	1	1	1	4
OG0021585	1	1	1	1	4
OG0021586	1	1	1	1	4
OG0021587	1	1	1	1	4
OG0021588	1	1	1	1	4
OG0021589	1	1	1	1	4
OG0021590	1	1	1	1	4
OG0021591	1	1	1	1	4
OG0021592	1	1	1	1	4
OG0021593	1	1	1	1	4
OG0021594	1	1	1	1	4
OG0021595	1	1	1	1	4
OG0021596	1	1	1	1	4
OG0021597	1	1	1	1	4
OG0021598	1	1	1	1	4
OG0021599	1	1	1	1	4
OG0021600	1	1	1	1	4
OG0021601	1	1	1	1	4
OG0021602	1	1	1	1	4
OG0021603	1	1	1	1	4
OG0021604	1	1	1	1	4
OG0021605	1	1	1	1	4
OG0021606	1	1	1	1	4
OG0021607	1	1	1	1	4
OG0021608	1	0	1	2	4
OG0021609	1	1	1	1	4
OG0021610	1	1	1	1	4
OG0021611	1	1	1	1	4
OG0021612	1	1	1	1	4
OG0021613	1	1	1	1	4
OG0021614	1	1	1	1	4
OG0021615	1	1	1	1	4
OG0021616	1	1	1	1	4
OG0021617	1	1	1	1	4
OG0021618	1	1	1	1	4
OG0021619	1	1	1	1	4
OG0021620	1	1	1	1	4
OG0021621	1	1	1	1	4
OG0021622	1	1	1	1	4
OG0021623	1	1	1	1	4
OG0021624	1	1	1	1	4
OG0021625	1	1	1	1	4
OG0021626	1	1	1	1	4
OG0021627	1	1	1	1	4
OG0021628	1	1	1	1	4
OG0021629	1	1	1	1	4
OG0021630	1	1	1	1	4
OG0021631	1	1	1	1	4
OG0021632	1	1	1	1	4
OG0021633	1	1	1	1	4
OG0021634	1	1	1	1	4
OG0021635	1	1	1	1	4
OG0021636	1	1	1	1	4
OG0021637	1	1	1	1	4
OG0021638	1	1	1	1	4
OG0021639	1	1	1	1	4
OG0021640	4	0	0	0	4
OG0021641	1	0	1	2	4
OG0021642	1	1	1	1	4
OG0021643	1	1	1	1	4
OG0021644	1	1	1	1	4
OG0021645	1	1	1	1	4
OG0021646	1	1	1	1	4
OG0021647	1	1	1	1	4
OG0021648	1	1	1	1	4
OG0021649	1	1	1	1	4
OG0021650	1	1	1	1	4
OG0021651	1	1	1	1	4
OG0021652	1	1	1	1	4
OG0021653	1	1	1	1	4
OG0021654	1	1	1	1	4
OG0021655	1	1	1	1	4
OG0021656	1	1	1	1	4
OG0021657	1	1	1	1	4
OG0021658	1	1	1	1	4
OG0021659	1	1	1	1	4
OG0021660	1	1	1	1	4
OG0021661	1	1	1	1	4
OG0021662	1	1	1	1	4
OG0021663	1	1	1	1	4
OG0021664	1	1	1	1	4
OG0021665	1	1	1	1	4
OG0021666	1	1	1	1	4
OG0021667	1	1	1	1	4
OG0021668	1	1	1	1	4
OG0021669	1	1	1	1	4
OG0021670	1	1	1	1	4
OG0021671	1	1	1	1	4
OG0021672	1	1	1	1	4
OG0021673	1	1	1	1	4
OG0021674	1	1	1	1	4
OG0021675	1	1	1	1	4
OG0021676	1	1	1	1	4
OG0021677	1	1	1	1	4
OG0021678	2	0	1	1	4
OG0021679	3	1	0	0	4
OG0021680	1	1	1	1	4
OG0021681	1	1	1	1	4
OG0021682	1	1	1	1	4
OG0021683	1	1	1	1	4
OG0021684	1	1	1	1	4
OG0021685	1	1	1	1	4
OG0021686	1	1	1	1	4
OG0021687	1	1	1	1	4
OG0021688	1	1	1	1	4
OG0021689	1	1	1	1	4
OG0021690	1	1	1	1	4
OG0021691	1	1	1	1	4
OG0021692	1	1	1	1	4
OG0021693	1	1	1	1	4
OG0021694	1	1	1	1	4
OG0021695	1	1	1	1	4
OG0021696	1	1	1	1	4
OG0021697	1	1	1	1	4
OG0021698	1	1	1	1	4
OG0021699	1	1	1	1	4
OG0021700	1	1	1	1	4
OG0021701	1	1	1	1	4
OG0021702	1	1	1	1	4
OG0021703	1	1	1	1	4
OG0021704	1	1	1	1	4
OG0021705	1	1	1	1	4
OG0021706	1	1	1	1	4
OG0021707	1	1	1	1	4
OG0021708	1	1	1	1	4
OG0021709	1	1	1	1	4
OG0021710	1	1	1	1	4
OG0021711	1	1	1	1	4
OG0021712	1	1	1	1	4
OG0021713	1	1	1	1	4
OG0021714	1	1	1	1	4
OG0021715	1	1	1	1	4
OG0021716	1	1	1	1	4
OG0021717	1	1	1	1	4
OG0021718	1	1	1	1	4
OG0021719	1	1	1	1	4
OG0021720	1	1	1	1	4
OG0021721	1	1	1	1	4
OG0021722	1	1	1	1	4
OG0021723	1	1	1	1	4
OG0021724	1	1	1	1	4
OG0021725	1	1	1	1	4
OG0021726	1	1	1	1	4
OG0021727	1	1	1	1	4
OG0021728	1	1	1	1	4
OG0021729	1	1	1	1	4
OG0021730	1	1	1	1	4
OG0021731	1	1	1	1	4
OG0021732	1	1	1	1	4
OG0021733	1	1	1	1	4
OG0021734	1	1	1	1	4
OG0021735	1	1	1	1	4
OG0021736	1	1	1	1	4
OG0021737	1	1	1	1	4
OG0021738	1	3	0	0	4
OG0021739	1	1	1	1	4
OG0021740	1	1	1	1	4
OG0021741	1	1	1	1	4
OG0021742	1	1	1	1	4
OG0021743	1	1	1	1	4
OG0021744	1	1	1	1	4
OG0021745	1	1	1	1	4
OG0021746	1	1	1	1	4
OG0021747	1	1	1	1	4
OG0021748	1	1	1	1	4
OG0021749	1	1	1	1	4
OG0021750	1	1	1	1	4
OG0021751	1	1	1	1	4
OG0021752	1	1	1	1	4
OG0021753	3	1	0	0	4
OG0021754	1	1	1	1	4
OG0021755	1	1	1	1	4
OG0021756	1	1	1	1	4
OG0021757	1	1	1	1	4
OG0021758	1	1	1	1	4
OG0021759	1	1	1	1	4
OG0021760	1	1	1	1	4
OG0021761	1	0	1	2	4
OG0021762	1	1	1	1	4
OG0021763	1	1	1	1	4
OG0021764	1	3	0	0	4
OG0021765	1	1	1	1	4
OG0021766	1	1	1	1	4
OG0021767	1	1	1	1	4
OG0021768	1	1	1	1	4
OG0021769	1	1	1	1	4
OG0021770	1	1	1	1	4
OG0021771	1	1	1	1	4
OG0021772	1	1	1	1	4
OG0021773	1	1	1	1	4
OG0021774	1	1	1	1	4
OG0021775	1	3	0	0	4
OG0021776	1	1	1	1	4
OG0021777	1	1	1	1	4
OG0021778	1	1	1	1	4
OG0021779	1	1	1	1	4
OG0021780	1	1	1	1	4
OG0021781	1	3	0	0	4
OG0021782	1	1	1	1	4
OG0021783	1	1	1	1	4
OG0021784	1	1	1	1	4
OG0021785	1	1	1	1	4
OG0021786	1	1	1	1	4
OG0021787	1	1	1	1	4
OG0021788	2	1	1	0	4
OG0021789	1	1	2	0	4
OG0021790	1	1	1	1	4
OG0021791	1	1	1	1	4
OG0021792	1	1	1	1	4
OG0021793	1	1	1	1	4
OG0021794	1	1	1	1	4
OG0021795	1	1	1	1	4
OG0021796	1	1	1	1	4
OG0021797	1	1	1	1	4
OG0021798	1	1	1	1	4
OG0021799	1	1	1	1	4
OG0021800	1	1	1	1	4
OG0021801	1	1	1	1	4
OG0021802	1	1	1	1	4
OG0021803	1	1	1	1	4
OG0021804	1	1	1	1	4
OG0021805	1	1	1	1	4
OG0021806	1	1	1	1	4
OG0021807	1	1	1	1	4
OG0021808	1	1	1	1	4
OG0021809	1	3	0	0	4
OG0021810	1	0	1	2	4
OG0021811	1	1	1	1	4
OG0021812	1	1	1	1	4
OG0021813	1	1	1	1	4
OG0021814	1	1	1	1	4
OG0021815	1	1	1	1	4
OG0021816	1	1	1	1	4
OG0021817	1	1	1	1	4
OG0021818	1	1	1	1	4
OG0021819	1	1	1	1	4
OG0021820	1	1	1	1	4
OG0021821	2	2	0	0	4
OG0021822	1	1	1	1	4
OG0021823	1	1	1	1	4
OG0021824	1	1	1	1	4
OG0021825	1	1	1	1	4
OG0021826	1	1	1	1	4
OG0021827	1	1	1	1	4
OG0021828	1	1	1	1	4
OG0021829	2	0	1	1	4
OG0021830	3	1	0	0	4
OG0021831	1	1	1	1	4
OG0021832	1	1	1	1	4
OG0021833	1	1	1	1	4
OG0021834	1	1	1	1	4
OG0021835	2	2	0	0	4
OG0021836	1	1	1	1	4
OG0021837	1	1	1	1	4
OG0021838	1	1	1	1	4
OG0021839	1	1	1	1	4
OG0021840	1	1	1	1	4
OG0021841	1	1	1	1	4
OG0021842	1	1	1	1	4
OG0021843	1	1	1	1	4
OG0021844	1	1	1	1	4
OG0021845	1	1	1	1	4
OG0021846	1	1	1	1	4
OG0021847	1	1	1	1	4
OG0021848	1	1	1	1	4
OG0021849	1	1	1	1	4
OG0021850	1	1	1	1	4
OG0021851	1	1	1	1	4
OG0021852	1	3	0	0	4
OG0021853	1	1	1	1	4
OG0021854	1	1	1	1	4
OG0021855	1	1	1	1	4
OG0021856	1	1	1	1	4
OG0021857	1	1	1	1	4
OG0021858	1	1	1	1	4
OG0021859	1	1	1	1	4
OG0021860	1	1	1	1	4
OG0021861	1	1	1	1	4
OG0021862	1	1	1	1	4
OG0021863	1	0	1	2	4
OG0021864	1	1	1	1	4
OG0021865	1	0	1	2	4
OG0021866	1	1	1	1	4
OG0021867	1	1	1	1	4
OG0021868	1	1	1	1	4
OG0021869	1	1	1	1	4
OG0021870	1	1	1	1	4
OG0021871	1	1	1	1	4
OG0021872	1	1	1	1	4
OG0021873	1	1	1	1	4
OG0021874	1	1	1	1	4
OG0021875	1	1	1	1	4
OG0021876	1	1	1	1	4
OG0021877	1	1	1	1	4
OG0021878	1	1	1	1	4
OG0021879	1	1	1	1	4
OG0021880	1	1	1	1	4
OG0021881	1	1	1	1	4
OG0021882	1	1	1	1	4
OG0021883	1	1	1	1	4
OG0021884	1	1	1	1	4
OG0021885	1	1	1	1	4
OG0021886	1	1	1	1	4
OG0021887	1	1	1	1	4
OG0021888	1	1	1	1	4
OG0021889	1	1	1	1	4
OG0021890	1	1	1	1	4
OG0021891	1	1	1	1	4
OG0021892	1	1	1	1	4
OG0021893	1	1	1	1	4
OG0021894	1	1	1	1	4
OG0021895	1	1	1	1	4
OG0021896	1	1	1	1	4
OG0021897	1	1	1	1	4
OG0021898	1	1	1	1	4
OG0021899	1	1	1	1	4
OG0021900	1	1	1	1	4
OG0021901	1	1	1	1	4
OG0021902	1	1	1	1	4
OG0021903	1	1	1	1	4
OG0021904	1	1	1	1	4
OG0021905	1	1	1	1	4
OG0021906	1	1	1	1	4
OG0021907	1	1	1	1	4
OG0021908	1	1	0	2	4
OG0021909	1	1	1	1	4
OG0021910	1	1	1	1	4
OG0021911	1	1	1	1	4
OG0021912	1	1	1	1	4
OG0021913	1	1	1	1	4
OG0021914	1	0	1	2	4
OG0021915	1	1	1	1	4
OG0021916	1	1	1	1	4
OG0021917	1	1	1	1	4
OG0021918	1	1	1	1	4
OG0021919	1	1	1	1	4
OG0021920	1	1	1	1	4
OG0021921	1	1	1	1	4
OG0021922	2	2	0	0	4
OG0021923	1	1	1	1	4
OG0021924	1	1	1	1	4
OG0021925	1	1	1	1	4
OG0021926	1	1	1	1	4
OG0021927	1	1	1	1	4
OG0021928	1	1	1	1	4
OG0021929	1	1	1	1	4
OG0021930	1	1	1	1	4
OG0021931	1	3	0	0	4
OG0021932	1	1	1	1	4
OG0021933	1	1	1	1	4
OG0021934	1	1	1	1	4
OG0021935	1	1	1	1	4
OG0021936	1	1	1	1	4
OG0021937	1	1	1	1	4
OG0021938	1	1	1	1	4
OG0021939	1	1	1	1	4
OG0021940	1	1	1	1	4
OG0021941	1	1	1	1	4
OG0021942	1	1	1	1	4
OG0021943	1	1	1	1	4
OG0021944	1	1	1	1	4
OG0021945	1	1	0	2	4
OG0021946	1	1	1	1	4
OG0021947	1	1	1	1	4
OG0021948	1	1	1	1	4
OG0021949	1	1	1	1	4
OG0021950	1	1	1	1	4
OG0021951	1	1	1	1	4
OG0021952	1	3	0	0	4
OG0021953	1	1	1	1	4
OG0021954	1	1	1	1	4
OG0021955	1	1	1	1	4
OG0021956	1	1	1	1	4
OG0021957	1	1	1	1	4
OG0021958	1	1	1	1	4
OG0021959	1	1	1	1	4
OG0021960	1	1	1	1	4
OG0021961	1	1	1	1	4
OG0021962	1	1	1	1	4
OG0021963	1	1	1	1	4
OG0021964	1	1	1	1	4
OG0021965	1	1	1	1	4
OG0021966	1	1	1	1	4
OG0021967	1	1	1	1	4
OG0021968	1	1	1	1	4
OG0021969	1	1	1	1	4
OG0021970	1	1	1	1	4
OG0021971	1	1	1	1	4
OG0021972	1	1	1	1	4
OG0021973	1	1	1	1	4
OG0021974	1	1	1	1	4
OG0021975	1	1	1	1	4
OG0021976	1	1	1	1	4
OG0021977	1	1	1	1	4
OG0021978	1	1	1	1	4
OG0021979	1	1	1	1	4
OG0021980	1	1	1	1	4
OG0021981	1	1	1	1	4
OG0021982	1	1	1	1	4
OG0021983	1	1	1	1	4
OG0021984	1	1	1	1	4
OG0021985	1	1	1	1	4
OG0021986	1	1	1	1	4
OG0021987	1	1	1	1	4
OG0021988	1	1	1	1	4
OG0021989	1	1	1	1	4
OG0021990	1	0	1	2	4
OG0021991	1	1	1	1	4
OG0021992	1	1	1	1	4
OG0021993	1	1	1	1	4
OG0021994	1	1	1	1	4
OG0021995	1	1	1	1	4
OG0021996	1	1	1	1	4
OG0021997	1	1	1	1	4
OG0021998	1	1	1	1	4
OG0021999	1	1	1	1	4
OG0022000	1	1	1	1	4
OG0022001	1	1	1	1	4
OG0022002	1	1	1	1	4
OG0022003	1	1	1	1	4
OG0022004	1	1	1	1	4
OG0022005	1	1	1	1	4
OG0022006	1	1	1	1	4
OG0022007	1	1	1	1	4
OG0022008	1	1	1	1	4
OG0022009	2	1	0	1	4
OG0022010	1	1	1	1	4
OG0022011	1	1	1	1	4
OG0022012	1	1	1	1	4
OG0022013	1	1	1	1	4
OG0022014	1	1	1	1	4
OG0022015	1	1	1	1	4
OG0022016	1	1	1	1	4
OG0022017	1	1	1	1	4
OG0022018	1	1	1	1	4
OG0022019	1	1	1	1	4
OG0022020	1	1	1	1	4
OG0022021	1	1	1	1	4
OG0022022	1	1	1	1	4
OG0022023	1	1	1	1	4
OG0022024	1	1	1	1	4
OG0022025	1	1	1	1	4
OG0022026	1	1	1	1	4
OG0022027	1	1	1	1	4
OG0022028	1	1	1	1	4
OG0022029	1	1	1	1	4
OG0022030	1	1	1	1	4
OG0022031	1	1	1	1	4
OG0022032	1	3	0	0	4
OG0022033	1	1	1	1	4
OG0022034	1	1	1	1	4
OG0022035	1	1	1	1	4
OG0022036	1	1	1	1	4
OG0022037	1	1	1	1	4
OG0022038	1	1	1	1	4
OG0022039	1	1	1	1	4
OG0022040	1	1	1	1	4
OG0022041	1	1	1	1	4
OG0022042	1	1	1	1	4
OG0022043	1	1	1	1	4
OG0022044	1	0	2	1	4
OG0022045	1	1	1	1	4
OG0022046	1	1	1	1	4
OG0022047	1	1	1	1	4
OG0022048	1	1	1	1	4
OG0022049	1	1	1	1	4
OG0022050	1	1	1	1	4
OG0022051	1	1	1	1	4
OG0022052	1	1	1	1	4
OG0022053	1	1	1	1	4
OG0022054	1	2	0	1	4
OG0022055	1	1	1	1	4
OG0022056	1	1	1	1	4
OG0022057	1	1	1	1	4
OG0022058	1	1	2	0	4
OG0022059	1	1	1	1	4
OG0022060	1	1	1	1	4
OG0022061	1	1	1	1	4
OG0022062	1	1	1	1	4
OG0022063	1	1	1	1	4
OG0022064	1	1	1	1	4
OG0022065	1	1	1	1	4
OG0022066	1	1	1	1	4
OG0022067	1	1	1	1	4
OG0022068	1	1	1	1	4
OG0022069	1	1	1	1	4
OG0022070	1	1	1	1	4
OG0022071	1	1	1	1	4
OG0022072	1	1	1	1	4
OG0022073	1	1	1	1	4
OG0022074	1	1	1	1	4
OG0022075	1	1	1	1	4
OG0022076	1	1	1	1	4
OG0022077	1	1	1	1	4
OG0022078	1	1	1	1	4
OG0022079	1	1	1	1	4
OG0022080	1	1	1	1	4
OG0022081	1	1	1	1	4
OG0022082	1	1	0	2	4
OG0022083	1	1	1	1	4
OG0022084	1	1	1	1	4
OG0022085	1	1	1	1	4
OG0022086	1	1	1	1	4
OG0022087	1	1	1	1	4
OG0022088	1	1	1	1	4
OG0022089	1	1	1	1	4
OG0022090	1	1	1	1	4
OG0022091	1	1	1	1	4
OG0022092	1	1	1	1	4
OG0022093	2	1	0	1	4
OG0022094	1	1	1	1	4
OG0022095	1	1	1	1	4
OG0022096	1	1	1	1	4
OG0022097	1	1	1	1	4
OG0022098	1	1	1	1	4
OG0022099	1	1	1	1	4
OG0022100	1	1	1	1	4
OG0022101	1	1	1	1	4
OG0022102	1	3	0	0	4
OG0022103	1	1	1	1	4
OG0022104	1	1	1	1	4
OG0022105	1	1	1	1	4
OG0022106	1	1	1	1	4
OG0022107	1	1	1	1	4
OG0022108	1	1	1	1	4
OG0022109	1	1	1	1	4
OG0022110	1	1	1	1	4
OG0022111	1	1	1	1	4
OG0022112	1	1	1	1	4
OG0022113	1	1	1	1	4
OG0022114	1	1	1	1	4
OG0022115	1	1	1	1	4
OG0022116	1	1	1	1	4
OG0022117	1	1	1	1	4
OG0022118	1	1	1	1	4
OG0022119	1	1	1	1	4
OG0022120	1	1	1	1	4
OG0022121	1	1	1	1	4
OG0022122	1	1	1	1	4
OG0022123	1	1	1	1	4
OG0022124	1	3	0	0	4
OG0022125	1	1	1	1	4
OG0022126	1	1	1	1	4
OG0022127	1	1	1	1	4
OG0022128	1	1	1	1	4
OG0022129	1	1	1	1	4
OG0022130	1	1	1	1	4
OG0022131	1	1	1	1	4
OG0022132	1	1	1	1	4
OG0022133	1	1	1	1	4
OG0022134	1	1	1	1	4
OG0022135	1	1	1	1	4
OG0022136	1	1	1	1	4
OG0022137	1	1	1	1	4
OG0022138	1	1	1	1	4
OG0022139	1	1	1	1	4
OG0022140	1	1	1	1	4
OG0022141	1	1	1	1	4
OG0022142	1	1	1	1	4
OG0022143	1	1	1	1	4
OG0022144	1	1	1	1	4
OG0022145	1	1	1	1	4
OG0022146	1	1	1	1	4
OG0022147	1	1	1	1	4
OG0022148	1	1	1	1	4
OG0022149	1	0	2	1	4
OG0022150	1	1	1	1	4
OG0022151	1	1	1	1	4
OG0022152	1	1	1	1	4
OG0022153	1	1	1	1	4
OG0022154	1	1	1	1	4
OG0022155	1	1	1	1	4
OG0022156	1	1	1	1	4
OG0022157	1	1	1	1	4
OG0022158	2	1	1	0	4
OG0022159	1	1	1	1	4
OG0022160	1	1	1	1	4
OG0022161	1	1	1	1	4
OG0022162	1	1	1	1	4
OG0022163	1	1	1	1	4
OG0022164	1	1	1	1	4
OG0022165	1	1	1	1	4
OG0022166	1	1	1	1	4
OG0022167	1	1	1	1	4
OG0022168	1	3	0	0	4
OG0022169	1	1	1	1	4
OG0022170	1	1	1	1	4
OG0022171	1	1	1	1	4
OG0022172	1	1	1	1	4
OG0022173	1	1	1	1	4
OG0022174	1	0	1	2	4
OG0022175	1	3	0	0	4
OG0022176	1	1	2	0	4
OG0022177	1	1	1	1	4
OG0022178	1	1	1	1	4
OG0022179	1	1	1	1	4
OG0022180	1	1	1	1	4
OG0022181	1	1	1	1	4
OG0022182	1	1	1	1	4
OG0022183	1	1	1	1	4
OG0022184	1	1	1	1	4
OG0022185	1	1	1	1	4
OG0022186	1	1	1	1	4
OG0022187	1	1	1	1	4
OG0022188	1	1	1	1	4
OG0022189	1	1	1	1	4
OG0022190	1	1	1	1	4
OG0022191	1	1	1	1	4
OG0022192	1	1	1	1	4
OG0022193	1	1	1	1	4
OG0022194	1	1	1	1	4
OG0022195	1	1	1	1	4
OG0022196	1	1	1	1	4
OG0022197	1	1	1	1	4
OG0022198	1	1	1	1	4
OG0022199	1	1	1	1	4
OG0022200	1	1	1	1	4
OG0022201	1	1	1	1	4
OG0022202	1	1	1	1	4
OG0022203	1	0	2	1	4
OG0022204	1	1	1	1	4
OG0022205	1	0	1	2	4
OG0022206	1	1	1	1	4
OG0022207	1	1	1	1	4
OG0022208	1	1	1	1	4
OG0022209	1	1	1	1	4
OG0022210	1	1	1	1	4
OG0022211	1	1	1	1	4
OG0022212	1	1	1	1	4
OG0022213	1	1	1	1	4
OG0022214	1	1	1	1	4
OG0022215	1	1	1	1	4
OG0022216	1	1	1	1	4
OG0022217	1	1	1	1	4
OG0022218	1	1	1	1	4
OG0022219	1	3	0	0	4
OG0022220	1	1	1	1	4
OG0022221	1	1	1	1	4
OG0022222	1	1	1	1	4
OG0022223	1	1	1	1	4
OG0022224	1	1	1	1	4
OG0022225	1	1	1	1	4
OG0022226	1	1	1	1	4
OG0022227	1	1	1	1	4
OG0022228	1	1	1	1	4
OG0022229	1	1	1	1	4
OG0022230	1	1	1	1	4
OG0022231	1	1	1	1	4
OG0022232	1	1	1	1	4
OG0022233	1	0	2	1	4
OG0022234	1	2	1	0	4
OG0022235	1	1	1	1	4
OG0022236	1	1	1	1	4
OG0022237	1	1	1	1	4
OG0022238	1	1	1	1	4
OG0022239	1	1	1	1	4
OG0022240	1	1	1	1	4
OG0022241	1	1	1	1	4
OG0022242	1	1	1	1	4
OG0022243	1	1	2	0	4
OG0022244	1	1	1	1	4
OG0022245	1	1	1	1	4
OG0022246	1	1	1	1	4
OG0022247	1	1	1	1	4
OG0022248	1	1	1	1	4
OG0022249	1	1	1	1	4
OG0022250	2	0	1	1	4
OG0022251	1	1	1	1	4
OG0022252	2	0	0	2	4
OG0022253	1	1	1	1	4
OG0022254	1	1	1	1	4
OG0022255	1	1	1	1	4
OG0022256	1	1	1	1	4
OG0022257	1	1	1	1	4
OG0022258	1	1	1	1	4
OG0022259	1	1	1	1	4
OG0022260	1	1	1	1	4
OG0022261	1	1	1	1	4
OG0022262	1	1	1	1	4
OG0022263	1	1	1	1	4
OG0022264	1	1	1	1	4
OG0022265	1	1	1	1	4
OG0022266	1	1	1	1	4
OG0022267	1	1	1	1	4
OG0022268	1	1	1	1	4
OG0022269	1	1	1	1	4
OG0022270	1	1	1	1	4
OG0022271	1	1	1	1	4
OG0022272	1	1	1	1	4
OG0022273	1	1	1	1	4
OG0022274	1	1	1	1	4
OG0022275	1	1	1	1	4
OG0022276	1	1	1	1	4
OG0022277	1	1	1	1	4
OG0022278	1	1	1	1	4
OG0022279	1	1	1	1	4
OG0022280	1	1	1	1	4
OG0022281	1	1	1	1	4
OG0022282	1	1	2	0	4
OG0022283	1	0	2	1	4
OG0022284	1	1	1	1	4
OG0022285	1	1	1	1	4
OG0022286	1	1	1	1	4
OG0022287	1	1	1	1	4
OG0022288	1	1	1	1	4
OG0022289	1	1	1	1	4
OG0022290	1	1	1	1	4
OG0022291	1	1	1	1	4
OG0022292	1	1	1	1	4
OG0022293	1	1	1	1	4
OG0022294	1	1	1	1	4
OG0022295	1	1	1	1	4
OG0022296	1	1	1	1	4
OG0022297	1	1	1	1	4
OG0022298	1	1	1	1	4
OG0022299	1	1	1	1	4
OG0022300	1	1	1	1	4
OG0022301	1	1	1	1	4
OG0022302	1	1	1	1	4
OG0022303	1	1	1	1	4
OG0022304	1	1	1	1	4
OG0022305	1	1	1	1	4
OG0022306	1	1	1	1	4
OG0022307	1	1	1	1	4
OG0022308	1	1	1	1	4
OG0022309	1	1	1	1	4
OG0022310	1	1	1	1	4
OG0022311	1	1	1	1	4
OG0022312	1	1	1	1	4
OG0022313	1	1	1	1	4
OG0022314	1	1	1	1	4
OG0022315	1	1	1	1	4
OG0022316	1	1	1	1	4
OG0022317	1	1	1	1	4
OG0022318	1	1	1	1	4
OG0022319	1	1	1	1	4
OG0022320	1	1	1	1	4
OG0022321	1	1	1	1	4
OG0022322	1	1	1	1	4
OG0022323	1	1	1	1	4
OG0022324	1	1	1	1	4
OG0022325	1	1	1	1	4
OG0022326	1	1	1	1	4
OG0022327	1	1	1	1	4
OG0022328	1	1	1	1	4
OG0022329	1	1	1	1	4
OG0022330	1	1	1	1	4
OG0022331	1	1	1	1	4
OG0022332	1	1	1	1	4
OG0022333	1	1	1	1	4
OG0022334	1	1	1	1	4
OG0022335	1	1	1	1	4
OG0022336	1	1	1	1	4
OG0022337	1	1	1	1	4
OG0022338	1	1	1	1	4
OG0022339	1	1	1	1	4
OG0022340	1	1	1	1	4
OG0022341	1	1	1	1	4
OG0022342	1	1	1	1	4
OG0022343	1	1	1	1	4
OG0022344	1	1	1	1	4
OG0022345	1	1	1	1	4
OG0022346	1	1	1	1	4
OG0022347	1	1	1	1	4
OG0022348	1	1	1	1	4
OG0022349	1	1	1	1	4
OG0022350	1	1	1	1	4
OG0022351	1	1	1	1	4
OG0022352	1	1	1	1	4
OG0022353	1	1	1	1	4
OG0022354	1	1	1	1	4
OG0022355	1	1	1	1	4
OG0022356	1	1	1	1	4
OG0022357	1	1	1	1	4
OG0022358	1	1	1	1	4
OG0022359	1	1	1	1	4
OG0022360	1	1	1	1	4
OG0022361	1	1	1	1	4
OG0022362	1	1	1	1	4
OG0022363	1	1	1	1	4
OG0022364	1	1	1	1	4
OG0022365	1	1	1	1	4
OG0022366	1	1	1	1	4
OG0022367	1	1	1	1	4
OG0022368	1	1	1	1	4
OG0022369	1	1	1	1	4
OG0022370	1	1	1	1	4
OG0022371	1	1	1	1	4
OG0022372	1	1	1	1	4
OG0022373	1	1	1	1	4
OG0022374	1	1	1	1	4
OG0022375	1	0	3	0	4
OG0022376	1	1	1	1	4
OG0022377	1	1	1	1	4
OG0022378	1	1	1	1	4
OG0022379	1	1	1	1	4
OG0022380	1	1	1	1	4
OG0022381	1	1	1	1	4
OG0022382	1	1	1	1	4
OG0022383	1	1	1	1	4
OG0022384	1	1	1	1	4
OG0022385	1	1	1	1	4
OG0022386	1	1	1	1	4
OG0022387	1	1	1	1	4
OG0022388	1	1	1	1	4
OG0022389	1	1	1	1	4
OG0022390	1	1	1	1	4
OG0022391	1	1	1	1	4
OG0022392	1	1	0	2	4
OG0022393	1	1	1	1	4
OG0022394	1	1	1	1	4
OG0022395	1	1	1	1	4
OG0022396	1	1	1	1	4
OG0022397	1	1	1	1	4
OG0022398	1	1	1	1	4
OG0022399	1	1	1	1	4
OG0022400	1	1	1	1	4
OG0022401	1	1	1	1	4
OG0022402	1	1	1	1	4
OG0022403	1	1	1	1	4
OG0022404	1	1	1	1	4
OG0022405	1	1	1	1	4
OG0022406	1	1	1	1	4
OG0022407	1	1	1	1	4
OG0022408	1	1	1	1	4
OG0022409	1	1	1	1	4
OG0022410	1	1	1	1	4
OG0022411	1	1	1	1	4
OG0022412	1	1	1	1	4
OG0022413	1	1	1	1	4
OG0022414	1	1	1	1	4
OG0022415	1	1	1	1	4
OG0022416	1	1	1	1	4
OG0022417	1	1	1	1	4
OG0022418	1	1	1	1	4
OG0022419	1	1	1	1	4
OG0022420	1	1	1	1	4
OG0022421	1	1	1	1	4
OG0022422	1	1	1	1	4
OG0022423	1	1	1	1	4
OG0022424	1	1	1	1	4
OG0022425	1	1	1	1	4
OG0022426	1	1	1	1	4
OG0022427	1	1	1	1	4
OG0022428	1	1	1	1	4
OG0022429	1	1	1	1	4
OG0022430	1	1	1	1	4
OG0022431	1	1	1	1	4
OG0022432	1	1	1	1	4
OG0022433	1	1	1	1	4
OG0022434	1	1	1	1	4
OG0022435	1	1	1	1	4
OG0022436	1	1	1	1	4
OG0022437	1	2	0	1	4
OG0022438	1	1	1	1	4
OG0022439	1	1	1	1	4
OG0022440	1	1	1	1	4
OG0022441	1	1	1	1	4
OG0022442	1	1	1	1	4
OG0022443	1	1	1	1	4
OG0022444	1	1	1	1	4
OG0022445	1	1	1	1	4
OG0022446	1	1	1	1	4
OG0022447	1	1	1	1	4
OG0022448	1	1	1	1	4
OG0022449	1	1	1	1	4
OG0022450	1	1	1	1	4
OG0022451	1	1	1	1	4
OG0022452	1	3	0	0	4
OG0022453	1	1	1	1	4
OG0022454	1	0	1	2	4
OG0022455	1	1	1	1	4
OG0022456	1	1	1	1	4
OG0022457	1	1	1	1	4
OG0022458	1	1	1	1	4
OG0022459	1	1	1	1	4
OG0022460	1	1	1	1	4
OG0022461	1	1	1	1	4
OG0022462	1	1	1	1	4
OG0022463	2	0	1	1	4
OG0022464	1	1	1	1	4
OG0022465	1	1	1	1	4
OG0022466	1	1	1	1	4
OG0022467	1	1	1	1	4
OG0022468	1	0	1	2	4
OG0022469	1	1	1	1	4
OG0022470	1	1	1	1	4
OG0022471	1	1	1	1	4
OG0022472	1	1	1	1	4
OG0022473	1	1	1	1	4
OG0022474	1	1	1	1	4
OG0022475	1	1	1	1	4
OG0022476	1	1	1	1	4
OG0022477	1	1	1	1	4
OG0022478	1	1	1	1	4
OG0022479	1	1	1	1	4
OG0022480	1	1	1	1	4
OG0022481	1	1	1	1	4
OG0022482	1	1	1	1	4
OG0022483	1	1	1	1	4
OG0022484	1	1	1	1	4
OG0022485	1	1	1	1	4
OG0022486	1	1	1	1	4
OG0022487	1	1	1	1	4
OG0022488	1	1	1	1	4
OG0022489	1	1	1	1	4
OG0022490	1	1	1	1	4
OG0022491	1	1	1	1	4
OG0022492	1	1	1	1	4
OG0022493	1	1	1	1	4
OG0022494	1	1	1	1	4
OG0022495	1	1	1	1	4
OG0022496	1	1	1	1	4
OG0022497	1	1	1	1	4
OG0022498	1	1	1	1	4
OG0022499	1	1	1	1	4
OG0022500	1	1	1	1	4
OG0022501	1	3	0	0	4
OG0022502	1	0	2	1	4
OG0022503	1	1	1	1	4
OG0022504	1	1	1	1	4
OG0022505	1	1	1	1	4
OG0022506	1	1	1	1	4
OG0022507	1	1	1	1	4
OG0022508	1	1	1	1	4
OG0022509	1	1	1	1	4
OG0022510	1	1	1	1	4
OG0022511	1	1	1	1	4
OG0022512	1	1	1	1	4
OG0022513	1	1	1	1	4
OG0022514	1	1	1	1	4
OG0022515	1	1	1	1	4
OG0022516	1	1	1	1	4
OG0022517	1	1	1	1	4
OG0022518	1	1	1	1	4
OG0022519	1	1	1	1	4
OG0022520	1	1	1	1	4
OG0022521	1	1	1	1	4
OG0022522	1	1	1	1	4
OG0022523	1	1	1	1	4
OG0022524	1	1	1	1	4
OG0022525	1	0	1	2	4
OG0022526	1	1	1	1	4
OG0022527	1	1	1	1	4
OG0022528	1	1	1	1	4
OG0022529	1	1	1	1	4
OG0022530	1	1	1	1	4
OG0022531	1	0	1	2	4
OG0022532	2	2	0	0	4
OG0022533	1	1	1	1	4
OG0022534	1	1	1	1	4
OG0022535	1	1	1	1	4
OG0022536	1	1	1	1	4
OG0022537	1	1	1	1	4
OG0022538	1	1	1	1	4
OG0022539	1	1	1	1	4
OG0022540	1	1	1	1	4
OG0022541	1	1	1	1	4
OG0022542	1	1	1	1	4
OG0022543	1	1	1	1	4
OG0022544	1	1	1	1	4
OG0022545	1	1	1	1	4
OG0022546	1	1	1	1	4
OG0022547	1	1	1	1	4
OG0022548	1	1	1	1	4
OG0022549	1	1	1	1	4
OG0022550	1	1	1	1	4
OG0022551	1	1	1	1	4
OG0022552	1	1	1	1	4
OG0022553	1	1	1	1	4
OG0022554	1	1	1	1	4
OG0022555	1	1	1	1	4
OG0022556	1	1	1	1	4
OG0022557	1	1	1	1	4
OG0022558	1	1	1	1	4
OG0022559	1	1	1	1	4
OG0022560	1	1	1	1	4
OG0022561	1	1	1	1	4
OG0022562	1	1	1	1	4
OG0022563	1	1	1	1	4
OG0022564	1	1	1	1	4
OG0022565	1	1	1	1	4
OG0022566	1	1	1	1	4
OG0022567	1	1	1	1	4
OG0022568	1	1	1	1	4
OG0022569	1	1	1	1	4
OG0022570	2	0	1	1	4
OG0022571	1	1	1	1	4
OG0022572	1	1	1	1	4
OG0022573	1	1	1	1	4
OG0022574	1	0	1	2	4
OG0022575	1	0	1	2	4
OG0022576	1	1	1	1	4
OG0022577	1	1	1	1	4
OG0022578	1	1	1	1	4
OG0022579	1	1	1	1	4
OG0022580	1	1	1	1	4
OG0022581	1	1	1	1	4
OG0022582	1	1	1	1	4
OG0022583	1	1	1	1	4
OG0022584	1	1	1	1	4
OG0022585	1	1	1	1	4
OG0022586	1	1	1	1	4
OG0022587	1	1	1	1	4
OG0022588	1	1	1	1	4
OG0022589	1	1	1	1	4
OG0022590	1	1	1	1	4
OG0022591	1	1	1	1	4
OG0022592	1	1	1	1	4
OG0022593	1	1	1	1	4
OG0022594	1	1	1	1	4
OG0022595	1	0	1	2	4
OG0022596	1	1	1	1	4
OG0022597	1	1	1	1	4
OG0022598	1	1	1	1	4
OG0022599	1	1	1	1	4
OG0022600	1	1	1	1	4
OG0022601	1	1	1	1	4
OG0022602	1	0	1	2	4
OG0022603	1	1	1	1	4
OG0022604	1	1	1	1	4
OG0022605	1	1	1	1	4
OG0022606	1	1	1	1	4
OG0022607	1	1	2	0	4
OG0022608	1	1	1	1	4
OG0022609	1	1	1	1	4
OG0022610	1	1	1	1	4
OG0022611	1	1	1	1	4
OG0022612	1	1	1	1	4
OG0022613	1	1	1	1	4
OG0022614	1	1	1	1	4
OG0022615	1	1	1	1	4
OG0022616	1	1	1	1	4
OG0022617	1	1	1	1	4
OG0022618	1	1	1	1	4
OG0022619	1	1	1	1	4
OG0022620	1	1	1	1	4
OG0022621	1	1	1	1	4
OG0022622	1	1	1	1	4
OG0022623	1	1	1	1	4
OG0022624	1	1	1	1	4
OG0022625	1	1	1	1	4
OG0022626	1	1	1	1	4
OG0022627	1	1	1	1	4
OG0022628	1	1	1	1	4
OG0022629	1	1	1	1	4
OG0022630	1	1	1	1	4
OG0022631	1	1	1	1	4
OG0022632	1	0	1	2	4
OG0022633	1	0	2	1	4
OG0022634	1	1	1	1	4
OG0022635	1	1	1	1	4
OG0022636	1	1	1	1	4
OG0022637	1	1	1	1	4
OG0022638	1	1	1	1	4
OG0022639	1	1	1	1	4
OG0022640	1	1	1	1	4
OG0022641	1	1	1	1	4
OG0022642	1	1	1	1	4
OG0022643	1	1	1	1	4
OG0022644	1	1	1	1	4
OG0022645	1	1	1	1	4
OG0022646	2	1	1	0	4
OG0022647	1	1	1	1	4
OG0022648	1	1	1	1	4
OG0022649	1	1	1	1	4
OG0022650	1	1	1	1	4
OG0022651	1	1	1	1	4
OG0022652	1	1	1	1	4
OG0022653	1	1	1	1	4
OG0022654	1	1	1	1	4
OG0022655	1	1	1	1	4
OG0022656	1	1	1	1	4
OG0022657	1	1	1	1	4
OG0022658	1	1	1	1	4
OG0022659	1	1	1	1	4
OG0022660	1	1	1	1	4
OG0022661	1	1	1	1	4
OG0022662	1	1	1	1	4
OG0022663	1	1	1	1	4
OG0022664	1	1	1	1	4
OG0022665	1	1	1	1	4
OG0022666	1	1	1	1	4
OG0022667	1	1	1	1	4
OG0022668	1	1	1	1	4
OG0022669	1	1	1	1	4
OG0022670	1	1	1	1	4
OG0022671	1	1	1	1	4
OG0022672	1	1	1	1	4
OG0022673	1	0	2	1	4
OG0022674	1	0	1	2	4
OG0022675	1	1	1	1	4
OG0022676	1	1	1	1	4
OG0022677	1	1	1	1	4
OG0022678	1	1	1	1	4
OG0022679	1	1	1	1	4
OG0022680	1	1	1	1	4
OG0022681	1	1	1	1	4
OG0022682	1	1	1	1	4
OG0022683	1	1	1	1	4
OG0022684	1	1	1	1	4
OG0022685	1	1	1	1	4
OG0022686	1	1	1	1	4
OG0022687	1	1	1	1	4
OG0022688	1	1	1	1	4
OG0022689	1	1	1	1	4
OG0022690	1	1	1	1	4
OG0022691	2	0	1	1	4
OG0022692	1	1	1	1	4
OG0022693	1	1	1	1	4
OG0022694	1	1	1	1	4
OG0022695	1	1	1	1	4
OG0022696	1	1	0	2	4
OG0022697	1	1	1	1	4
OG0022698	1	1	1	1	4
OG0022699	1	1	1	1	4
OG0022700	1	2	0	1	4
OG0022701	2	1	0	1	4
OG0022702	1	1	1	1	4
OG0022703	1	1	1	1	4
OG0022704	1	1	1	1	4
OG0022705	1	1	1	1	4
OG0022706	1	1	1	1	4
OG0022707	1	1	1	1	4
OG0022708	1	1	1	1	4
OG0022709	1	1	1	1	4
OG0022710	1	1	1	1	4
OG0022711	1	1	1	1	4
OG0022712	1	1	1	1	4
OG0022713	1	1	1	1	4
OG0022714	1	1	1	1	4
OG0022715	1	0	1	2	4
OG0022716	1	1	1	1	4
OG0022717	1	1	1	1	4
OG0022718	1	1	1	1	4
OG0022719	1	1	1	1	4
OG0022720	1	1	1	1	4
OG0022721	1	1	1	1	4
OG0022722	1	1	1	1	4
OG0022723	1	1	1	1	4
OG0022724	1	1	1	1	4
OG0022725	1	1	1	1	4
OG0022726	1	1	1	1	4
OG0022727	1	1	1	1	4
OG0022728	1	1	1	1	4
OG0022729	1	1	1	1	4
OG0022730	1	1	1	1	4
OG0022731	1	1	1	1	4
OG0022732	1	1	1	1	4
OG0022733	1	1	1	1	4
OG0022734	1	1	1	1	4
OG0022735	1	1	1	1	4
OG0022736	1	1	1	1	4
OG0022737	1	1	1	1	4
OG0022738	1	1	1	1	4
OG0022739	1	1	1	1	4
OG0022740	1	1	1	1	4
OG0022741	1	1	1	1	4
OG0022742	1	1	1	1	4
OG0022743	1	1	1	1	4
OG0022744	1	1	1	1	4
OG0022745	1	1	1	1	4
OG0022746	1	1	1	1	4
OG0022747	1	1	1	1	4
OG0022748	1	1	1	1	4
OG0022749	1	1	1	1	4
OG0022750	1	1	1	1	4
OG0022751	1	1	1	1	4
OG0022752	1	1	1	1	4
OG0022753	1	1	1	1	4
OG0022754	1	1	1	1	4
OG0022755	1	1	1	1	4
OG0022756	1	1	1	1	4
OG0022757	1	1	1	1	4
OG0022758	1	1	1	1	4
OG0022759	1	1	1	1	4
OG0022760	1	1	1	1	4
OG0022761	1	1	1	1	4
OG0022762	1	1	1	1	4
OG0022763	1	1	1	1	4
OG0022764	1	1	1	1	4
OG0022765	1	1	1	1	4
OG0022766	1	1	1	1	4
OG0022767	1	1	1	1	4
OG0022768	1	1	1	1	4
OG0022769	1	1	1	1	4
OG0022770	1	1	1	1	4
OG0022771	1	1	1	1	4
OG0022772	1	1	1	1	4
OG0022773	1	1	1	1	4
OG0022774	1	1	1	1	4
OG0022775	1	1	1	1	4
OG0022776	1	1	1	1	4
OG0022777	1	1	1	1	4
OG0022778	1	1	1	1	4
OG0022779	1	1	1	1	4
OG0022780	1	1	1	1	4
OG0022781	1	1	1	1	4
OG0022782	1	1	1	1	4
OG0022783	1	1	1	1	4
OG0022784	1	1	1	1	4
OG0022785	1	1	1	1	4
OG0022786	1	1	1	1	4
OG0022787	1	1	1	1	4
OG0022788	1	1	1	1	4
OG0022789	1	1	1	1	4
OG0022790	1	1	1	1	4
OG0022791	1	1	1	1	4
OG0022792	1	1	1	1	4
OG0022793	1	1	1	1	4
OG0022794	1	1	1	1	4
OG0022795	1	1	1	1	4
OG0022796	1	1	1	1	4
OG0022797	1	1	1	1	4
OG0022798	1	0	1	2	4
OG0022799	1	1	1	1	4
OG0022800	1	1	1	1	4
OG0022801	1	1	1	1	4
OG0022802	1	1	1	1	4
OG0022803	1	1	1	1	4
OG0022804	1	1	1	1	4
OG0022805	1	1	1	1	4
OG0022806	1	1	1	1	4
OG0022807	1	1	1	1	4
OG0022808	1	1	1	1	4
OG0022809	1	1	1	1	4
OG0022810	1	1	1	1	4
OG0022811	1	1	1	1	4
OG0022812	1	1	1	1	4
OG0022813	1	1	1	1	4
OG0022814	1	1	1	1	4
OG0022815	1	1	1	1	4
OG0022816	1	1	1	1	4
OG0022817	1	1	1	1	4
OG0022818	1	1	1	1	4
OG0022819	1	1	1	1	4
OG0022820	1	1	1	1	4
OG0022821	1	1	1	1	4
OG0022822	1	1	1	1	4
OG0022823	1	1	1	1	4
OG0022824	1	1	1	1	4
OG0022825	1	1	1	1	4
OG0022826	1	1	1	1	4
OG0022827	1	1	1	1	4
OG0022828	1	1	1	1	4
OG0022829	1	1	1	1	4
OG0022830	4	0	0	0	4
OG0022831	1	1	1	1	4
OG0022832	1	1	1	1	4
OG0022833	1	1	1	1	4
OG0022834	1	1	1	1	4
OG0022835	1	1	1	1	4
OG0022836	1	1	1	1	4
OG0022837	1	1	1	1	4
OG0022838	1	1	1	1	4
OG0022839	1	1	1	1	4
OG0022840	1	1	1	1	4
OG0022841	1	1	1	1	4
OG0022842	1	1	1	1	4
OG0022843	1	1	1	1	4
OG0022844	1	1	1	1	4
OG0022845	1	1	1	1	4
OG0022846	1	1	1	1	4
OG0022847	1	1	1	1	4
OG0022848	1	1	1	1	4
OG0022849	1	1	1	1	4
OG0022850	1	1	1	1	4
OG0022851	1	1	1	1	4
OG0022852	1	1	1	1	4
OG0022853	1	1	1	1	4
OG0022854	1	1	1	1	4
OG0022855	1	1	1	1	4
OG0022856	1	1	1	1	4
OG0022857	1	1	1	1	4
OG0022858	1	1	1	1	4
OG0022859	1	1	1	1	4
OG0022860	1	1	1	1	4
OG0022861	1	1	1	1	4
OG0022862	1	1	1	1	4
OG0022863	1	1	1	1	4
OG0022864	1	1	1	1	4
OG0022865	1	1	1	1	4
OG0022866	3	1	0	0	4
OG0022867	1	1	1	1	4
OG0022868	1	1	1	1	4
OG0022869	1	1	1	1	4
OG0022870	1	1	1	1	4
OG0022871	1	1	1	1	4
OG0022872	2	1	0	1	4
OG0022873	1	0	2	1	4
OG0022874	1	1	1	1	4
OG0022875	1	0	2	1	4
OG0022876	1	1	1	1	4
OG0022877	1	1	1	1	4
OG0022878	1	1	1	1	4
OG0022879	1	1	1	1	4
OG0022880	1	1	1	1	4
OG0022881	1	1	1	1	4
OG0022882	1	1	1	1	4
OG0022883	1	1	1	1	4
OG0022884	1	3	0	0	4
OG0022885	1	1	1	1	4
OG0022886	1	1	1	1	4
OG0022887	2	0	1	1	4
OG0022888	1	1	1	1	4
OG0022889	1	1	1	1	4
OG0022890	1	1	1	1	4
OG0022891	1	1	1	1	4
OG0022892	1	1	1	1	4
OG0022893	1	1	1	1	4
OG0022894	1	1	1	1	4
OG0022895	1	1	1	1	4
OG0022896	1	1	1	1	4
OG0022897	1	1	1	1	4
OG0022898	1	1	1	1	4
OG0022899	1	1	1	1	4
OG0022900	1	3	0	0	4
OG0022901	3	1	0	0	4
OG0022902	1	1	1	1	4
OG0022903	1	1	1	1	4
OG0022904	1	1	1	1	4
OG0022905	1	1	1	1	4
OG0022906	1	1	1	1	4
OG0022907	1	1	1	1	4
OG0022908	1	1	1	1	4
OG0022909	1	1	1	1	4
OG0022910	1	1	1	1	4
OG0022911	1	1	1	1	4
OG0022912	1	1	1	1	4
OG0022913	1	1	1	1	4
OG0022914	1	1	1	1	4
OG0022915	2	2	0	0	4
OG0022916	1	1	1	1	4
OG0022917	1	1	1	1	4
OG0022918	1	1	1	1	4
OG0022919	1	1	1	1	4
OG0022920	1	0	2	1	4
OG0022921	1	1	1	1	4
OG0022922	1	1	1	1	4
OG0022923	1	1	1	1	4
OG0022924	1	1	1	1	4
OG0022925	1	1	1	1	4
OG0022926	1	1	1	1	4
OG0022927	1	1	1	1	4
OG0022928	1	1	1	1	4
OG0022929	1	1	1	1	4
OG0022930	1	1	1	1	4
OG0022931	1	1	1	1	4
OG0022932	1	1	1	1	4
OG0022933	1	1	1	1	4
OG0022934	1	1	1	1	4
OG0022935	1	1	1	1	4
OG0022936	1	3	0	0	4
OG0022937	1	1	1	1	4
OG0022938	1	1	1	1	4
OG0022939	1	1	1	1	4
OG0022940	1	1	1	1	4
OG0022941	1	1	1	1	4
OG0022942	1	1	1	1	4
OG0022943	1	1	1	1	4
OG0022944	1	1	1	1	4
OG0022945	1	1	0	2	4
OG0022946	1	1	1	1	4
OG0022947	1	1	1	1	4
OG0022948	1	3	0	0	4
OG0022949	1	1	1	1	4
OG0022950	1	1	1	1	4
OG0022951	1	1	1	1	4
OG0022952	1	1	1	1	4
OG0022953	1	1	1	1	4
OG0022954	1	1	2	0	4
OG0022955	1	1	1	1	4
OG0022956	1	1	1	1	4
OG0022957	1	1	1	1	4
OG0022958	1	1	1	1	4
OG0022959	1	1	1	1	4
OG0022960	1	1	1	1	4
OG0022961	1	0	1	2	4
OG0022962	1	1	1	1	4
OG0022963	1	2	1	0	4
OG0022964	1	1	1	1	4
OG0022965	1	1	2	0	4
OG0022966	1	1	1	1	4
OG0022967	1	1	1	1	4
OG0022968	1	1	1	1	4
OG0022969	1	1	1	1	4
OG0022970	1	1	1	1	4
OG0022971	1	1	1	1	4
OG0022972	1	1	1	1	4
OG0022973	1	1	1	1	4
OG0022974	1	1	1	1	4
OG0022975	1	1	1	1	4
OG0022976	1	1	1	1	4
OG0022977	1	0	1	2	4
OG0022978	1	1	1	1	4
OG0022979	1	1	1	1	4
OG0022980	1	1	1	1	4
OG0022981	1	1	1	1	4
OG0022982	1	1	1	1	4
OG0022983	1	1	1	1	4
OG0022984	1	1	1	1	4
OG0022985	1	1	1	1	4
OG0022986	1	1	1	1	4
OG0022987	1	1	1	1	4
OG0022988	1	3	0	0	4
OG0022989	1	1	1	1	4
OG0022990	1	1	1	1	4
OG0022991	1	1	1	1	4
OG0022992	1	1	1	1	4
OG0022993	1	1	1	1	4
OG0022994	1	1	1	1	4
OG0022995	1	1	1	1	4
OG0022996	1	1	1	1	4
OG0022997	1	1	1	1	4
OG0022998	1	1	1	1	4
OG0022999	1	1	1	1	4
OG0023000	1	1	1	1	4
OG0023001	1	1	1	1	4
OG0023002	1	1	1	1	4
OG0023003	1	1	1	1	4
OG0023004	1	1	1	1	4
OG0023005	1	1	1	1	4
OG0023006	1	1	1	1	4
OG0023007	1	1	1	1	4
OG0023008	1	1	1	1	4
OG0023009	1	1	1	1	4
OG0023010	1	1	1	1	4
OG0023011	1	1	1	1	4
OG0023012	1	1	1	1	4
OG0023013	1	1	1	1	4
OG0023014	1	1	1	1	4
OG0023015	1	0	1	2	4
OG0023016	1	1	1	1	4
OG0023017	1	1	1	1	4
OG0023018	1	1	1	1	4
OG0023019	1	1	1	1	4
OG0023020	1	1	1	1	4
OG0023021	1	1	1	1	4
OG0023022	1	1	1	1	4
OG0023023	1	1	1	1	4
OG0023024	1	1	1	1	4
OG0023025	1	1	1	1	4
OG0023026	1	1	1	1	4
OG0023027	1	1	1	1	4
OG0023028	1	1	1	1	4
OG0023029	1	1	1	1	4
OG0023030	1	1	1	1	4
OG0023031	1	1	1	1	4
OG0023032	1	1	1	1	4
OG0023033	1	1	1	1	4
OG0023034	1	1	1	1	4
OG0023035	1	1	1	1	4
OG0023036	1	1	1	1	4
OG0023037	1	1	1	1	4
OG0023038	1	1	1	1	4
OG0023039	1	1	1	1	4
OG0023040	1	1	1	1	4
OG0023041	1	1	1	1	4
OG0023042	1	1	1	1	4
OG0023043	1	1	1	1	4
OG0023044	1	1	1	1	4
OG0023045	1	1	1	1	4
OG0023046	1	1	1	1	4
OG0023047	1	1	1	1	4
OG0023048	1	1	1	1	4
OG0023049	1	1	1	1	4
OG0023050	1	1	1	1	4
OG0023051	1	1	1	1	4
OG0023052	1	1	1	1	4
OG0023053	1	1	1	1	4
OG0023054	1	1	1	1	4
OG0023055	1	1	1	1	4
OG0023056	1	1	1	1	4
OG0023057	1	1	1	1	4
OG0023058	1	1	1	1	4
OG0023059	1	1	1	1	4
OG0023060	1	1	1	1	4
OG0023061	1	1	1	1	4
OG0023062	1	1	1	1	4
OG0023063	1	1	1	1	4
OG0023064	1	1	1	1	4
OG0023065	1	1	1	1	4
OG0023066	1	1	1	1	4
OG0023067	1	1	1	1	4
OG0023068	1	1	1	1	4
OG0023069	1	1	1	1	4
OG0023070	1	1	1	1	4
OG0023071	1	1	1	1	4
OG0023072	1	1	1	1	4
OG0023073	1	1	1	1	4
OG0023074	1	1	1	1	4
OG0023075	1	1	1	1	4
OG0023076	1	1	1	1	4
OG0023077	1	1	1	1	4
OG0023078	1	1	1	1	4
OG0023079	1	1	1	1	4
OG0023080	1	1	1	1	4
OG0023081	1	1	1	1	4
OG0023082	1	1	1	1	4
OG0023083	1	1	1	1	4
OG0023084	1	1	1	1	4
OG0023085	1	1	1	1	4
OG0023086	1	1	1	1	4
OG0023087	1	1	1	1	4
OG0023088	1	1	1	1	4
OG0023089	1	1	1	1	4
OG0023090	1	1	1	1	4
OG0023091	1	1	1	1	4
OG0023092	1	1	1	1	4
OG0023093	1	1	1	1	4
OG0023094	1	1	1	1	4
OG0023095	1	1	1	1	4
OG0023096	1	1	1	1	4
OG0023097	1	1	1	1	4
OG0023098	1	1	1	1	4
OG0023099	1	1	1	1	4
OG0023100	1	1	1	1	4
OG0023101	2	1	0	1	4
OG0023102	1	1	1	1	4
OG0023103	1	1	1	1	4
OG0023104	1	1	1	1	4
OG0023105	1	1	1	1	4
OG0023106	1	1	1	1	4
OG0023107	1	1	1	1	4
OG0023108	1	1	1	1	4
OG0023109	1	1	1	1	4
OG0023110	1	1	1	1	4
OG0023111	1	1	1	1	4
OG0023112	1	1	1	1	4
OG0023113	1	1	1	1	4
OG0023114	1	1	1	1	4
OG0023115	1	1	1	1	4
OG0023116	1	1	1	1	4
OG0023117	1	1	1	1	4
OG0023118	1	1	1	1	4
OG0023119	1	1	1	1	4
OG0023120	1	1	1	1	4
OG0023121	1	1	1	1	4
OG0023122	1	1	1	1	4
OG0023123	1	1	1	1	4
OG0023124	1	1	1	1	4
OG0023125	1	1	1	1	4
OG0023126	1	1	1	1	4
OG0023127	1	1	1	1	4
OG0023128	1	1	1	1	4
OG0023129	1	1	1	1	4
OG0023130	1	1	1	1	4
OG0023131	1	1	1	1	4
OG0023132	1	1	1	1	4
OG0023133	1	1	1	1	4
OG0023134	1	0	3	0	4
OG0023135	1	1	1	1	4
OG0023136	1	1	1	1	4
OG0023137	1	1	1	1	4
OG0023138	1	1	1	1	4
OG0023139	1	1	1	1	4
OG0023140	1	1	1	1	4
OG0023141	1	1	1	1	4
OG0023142	1	1	1	1	4
OG0023143	1	1	1	1	4
OG0023144	1	1	1	1	4
OG0023145	1	1	1	1	4
OG0023146	1	1	1	1	4
OG0023147	1	1	1	1	4
OG0023148	1	1	1	1	4
OG0023149	1	1	1	1	4
OG0023150	1	1	1	1	4
OG0023151	1	1	1	1	4
OG0023152	1	1	1	1	4
OG0023153	2	1	0	1	4
OG0023154	1	1	1	1	4
OG0023155	1	1	1	1	4
OG0023156	1	1	1	1	4
OG0023157	1	0	1	2	4
OG0023158	1	1	1	1	4
OG0023159	1	1	1	1	4
OG0023160	1	1	1	1	4
OG0023161	1	1	1	1	4
OG0023162	1	1	1	1	4
OG0023163	1	1	1	1	4
OG0023164	1	1	1	1	4
OG0023165	1	1	1	1	4
OG0023166	1	1	1	1	4
OG0023167	1	1	1	1	4
OG0023168	1	1	1	1	4
OG0023169	1	1	1	1	4
OG0023170	1	1	1	1	4
OG0023171	1	1	1	1	4
OG0023172	1	1	1	1	4
OG0023173	1	1	1	1	4
OG0023174	1	1	1	1	4
OG0023175	1	1	1	1	4
OG0023176	1	1	1	1	4
OG0023177	1	1	1	1	4
OG0023178	1	1	1	1	4
OG0023179	1	1	1	1	4
OG0023180	1	1	1	1	4
OG0023181	1	1	1	1	4
OG0023182	1	1	1	1	4
OG0023183	1	1	1	1	4
OG0023184	1	1	1	1	4
OG0023185	1	1	1	1	4
OG0023186	1	1	1	1	4
OG0023187	1	1	1	1	4
OG0023188	1	1	1	1	4
OG0023189	1	1	1	1	4
OG0023190	1	1	1	1	4
OG0023191	1	1	1	1	4
OG0023192	1	1	1	1	4
OG0023193	1	1	1	1	4
OG0023194	1	1	1	1	4
OG0023195	1	1	1	1	4
OG0023196	1	1	1	1	4
OG0023197	1	1	1	1	4
OG0023198	1	1	1	1	4
OG0023199	1	1	1	1	4
OG0023200	1	1	1	1	4
OG0023201	1	1	1	1	4
OG0023202	1	1	1	1	4
OG0023203	1	1	1	1	4
OG0023204	1	1	1	1	4
OG0023205	1	1	1	1	4
OG0023206	1	1	1	1	4
OG0023207	1	1	1	1	4
OG0023208	1	1	1	1	4
OG0023209	1	1	1	1	4
OG0023210	1	1	1	1	4
OG0023211	1	1	1	1	4
OG0023212	1	1	1	1	4
OG0023213	1	1	1	1	4
OG0023214	1	1	1	1	4
OG0023215	1	1	1	1	4
OG0023216	1	1	1	1	4
OG0023217	1	1	1	1	4
OG0023218	1	1	1	1	4
OG0023219	1	1	1	1	4
OG0023220	1	1	1	1	4
OG0023221	1	1	1	1	4
OG0023222	1	1	1	1	4
OG0023223	1	1	1	1	4
OG0023224	1	1	1	1	4
OG0023225	1	1	1	1	4
OG0023226	1	1	1	1	4
OG0023227	1	1	1	1	4
OG0023228	1	1	1	1	4
OG0023229	1	1	1	1	4
OG0023230	1	1	1	1	4
OG0023231	1	1	1	1	4
OG0023232	1	1	1	1	4
OG0023233	1	1	1	1	4
OG0023234	1	1	1	1	4
OG0023235	1	1	1	1	4
OG0023236	1	1	1	1	4
OG0023237	1	1	1	1	4
OG0023238	1	1	1	1	4
OG0023239	1	1	1	1	4
OG0023240	1	1	1	1	4
OG0023241	1	1	1	1	4
OG0023242	1	1	1	1	4
OG0023243	1	1	1	1	4
OG0023244	1	1	1	1	4
OG0023245	1	1	1	1	4
OG0023246	1	1	1	1	4
OG0023247	1	1	1	1	4
OG0023248	1	1	1	1	4
OG0023249	1	1	1	1	4
OG0023250	1	1	1	1	4
OG0023251	1	1	1	1	4
OG0023252	1	1	1	1	4
OG0023253	1	1	1	1	4
OG0023254	1	1	1	1	4
OG0023255	1	1	1	1	4
OG0023256	1	1	1	1	4
OG0023257	1	1	1	1	4
OG0023258	1	1	1	1	4
OG0023259	1	1	1	1	4
OG0023260	1	1	1	1	4
OG0023261	1	1	1	1	4
OG0023262	1	1	1	1	4
OG0023263	1	1	1	1	4
OG0023264	1	1	1	1	4
OG0023265	1	1	1	1	4
OG0023266	1	1	1	1	4
OG0023267	1	1	1	1	4
OG0023268	1	1	1	1	4
OG0023269	1	1	1	1	4
OG0023270	1	1	1	1	4
OG0023271	1	1	1	1	4
OG0023272	1	1	1	1	4
OG0023273	1	1	1	1	4
OG0023274	1	1	1	1	4
OG0023275	1	1	1	1	4
OG0023276	1	1	1	1	4
OG0023277	1	1	1	1	4
OG0023278	1	1	1	1	4
OG0023279	1	1	1	1	4
OG0023280	1	1	1	1	4
OG0023281	1	1	1	1	4
OG0023282	1	1	1	1	4
OG0023283	2	0	1	1	4
OG0023284	1	1	1	1	4
OG0023285	1	1	1	1	4
OG0023286	1	1	1	1	4
OG0023287	1	1	1	1	4
OG0023288	1	1	1	1	4
OG0023289	1	1	1	1	4
OG0023290	1	1	1	1	4
OG0023291	1	1	1	1	4
OG0023292	1	1	1	1	4
OG0023293	1	1	1	1	4
OG0023294	1	1	1	1	4
OG0023295	1	1	1	1	4
OG0023296	1	1	1	1	4
OG0023297	1	1	1	1	4
OG0023298	1	1	1	1	4
OG0023299	1	1	1	1	4
OG0023300	1	1	1	1	4
OG0023301	1	1	1	1	4
OG0023302	1	0	2	1	4
OG0023303	1	3	0	0	4
OG0023304	1	1	1	1	4
OG0023305	1	1	1	1	4
OG0023306	1	1	1	1	4
OG0023307	1	1	1	1	4
OG0023308	1	2	0	1	4
OG0023309	1	1	1	1	4
OG0023310	1	1	1	1	4
OG0023311	1	1	1	1	4
OG0023312	1	1	1	1	4
OG0023313	1	1	1	1	4
OG0023314	1	1	0	2	4
OG0023315	1	1	1	1	4
OG0023316	1	1	1	1	4
OG0023317	1	1	1	1	4
OG0023318	1	1	1	1	4
OG0023319	1	1	1	1	4
OG0023320	1	1	1	1	4
OG0023321	1	1	1	1	4
OG0023322	1	1	1	1	4
OG0023323	1	1	1	1	4
OG0023324	1	1	1	1	4
OG0023325	1	1	1	1	4
OG0023326	1	1	1	1	4
OG0023327	1	1	1	1	4
OG0023328	1	1	1	1	4
OG0023329	1	1	1	1	4
OG0023330	1	1	1	1	4
OG0023331	1	1	1	1	4
OG0023332	1	1	1	1	4
OG0023333	1	1	1	1	4
OG0023334	1	1	1	1	4
OG0023335	1	1	1	1	4
OG0023336	1	1	1	1	4
OG0023337	1	3	0	0	4
OG0023338	1	1	1	1	4
OG0023339	1	1	1	1	4
OG0023340	1	1	1	1	4
OG0023341	1	1	1	1	4
OG0023342	1	1	1	1	4
OG0023343	1	1	1	1	4
OG0023344	1	1	1	1	4
OG0023345	1	1	1	1	4
OG0023346	1	1	1	1	4
OG0023347	1	1	1	1	4
OG0023348	1	1	1	1	4
OG0023349	1	1	1	1	4
OG0023350	1	1	1	1	4
OG0023351	1	1	1	1	4
OG0023352	1	1	1	1	4
OG0023353	1	1	1	1	4
OG0023354	1	1	1	1	4
OG0023355	1	1	1	1	4
OG0023356	1	1	1	1	4
OG0023357	1	1	1	1	4
OG0023358	1	1	1	1	4
OG0023359	1	1	1	1	4
OG0023360	1	1	1	1	4
OG0023361	1	1	1	1	4
OG0023362	1	1	1	1	4
OG0023363	1	1	1	1	4
OG0023364	1	1	1	1	4
OG0023365	1	1	1	1	4
OG0023366	1	0	1	2	4
OG0023367	1	3	0	0	4
OG0023368	1	1	1	1	4
OG0023369	2	1	1	0	4
OG0023370	1	1	1	1	4
OG0023371	1	1	1	1	4
OG0023372	1	1	1	1	4
OG0023373	1	1	1	1	4
OG0023374	1	1	1	1	4
OG0023375	1	1	1	1	4
OG0023376	1	1	1	1	4
OG0023377	1	1	1	1	4
OG0023378	1	1	1	1	4
OG0023379	1	1	1	1	4
OG0023380	1	1	1	1	4
OG0023381	1	1	1	1	4
OG0023382	1	1	1	1	4
OG0023383	1	1	1	1	4
OG0023384	1	1	1	1	4
OG0023385	1	1	1	1	4
OG0023386	1	1	1	1	4
OG0023387	1	1	1	1	4
OG0023388	1	1	1	1	4
OG0023389	1	1	1	1	4
OG0023390	1	1	1	1	4
OG0023391	1	1	1	1	4
OG0023392	1	1	1	1	4
OG0023393	1	1	1	1	4
OG0023394	1	1	1	1	4
OG0023395	1	0	3	0	4
OG0023396	1	1	1	1	4
OG0023397	1	1	1	1	4
OG0023398	1	1	1	1	4
OG0023399	1	1	1	1	4
OG0023400	1	1	1	1	4
OG0023401	1	1	1	1	4
OG0023402	1	1	1	1	4
OG0023403	1	1	1	1	4
OG0023404	1	1	1	1	4
OG0023405	1	1	1	1	4
OG0023406	1	1	1	1	4
OG0023407	1	1	1	1	4
OG0023408	1	1	1	1	4
OG0023409	1	1	1	1	4
OG0023410	1	1	1	1	4
OG0023411	1	1	1	1	4
OG0023412	1	1	1	1	4
OG0023413	1	1	1	1	4
OG0023414	1	1	1	1	4
OG0023415	1	1	1	1	4
OG0023416	1	1	1	1	4
OG0023417	1	1	1	1	4
OG0023418	1	1	1	1	4
OG0023419	1	1	1	1	4
OG0023420	1	1	1	1	4
OG0023421	1	1	1	1	4
OG0023422	1	1	1	1	4
OG0023423	1	1	1	1	4
OG0023424	1	1	1	1	4
OG0023425	1	1	1	1	4
OG0023426	1	1	1	1	4
OG0023427	1	1	1	1	4
OG0023428	1	1	1	1	4
OG0023429	1	1	1	1	4
OG0023430	1	1	1	1	4
OG0023431	1	1	1	1	4
OG0023432	1	1	1	1	4
OG0023433	1	1	1	1	4
OG0023434	1	1	1	1	4
OG0023435	1	1	1	1	4
OG0023436	1	1	1	1	4
OG0023437	1	1	1	1	4
OG0023438	1	1	1	1	4
OG0023439	1	1	1	1	4
OG0023440	1	1	1	1	4
OG0023441	1	1	1	1	4
OG0023442	1	0	2	1	4
OG0023443	1	1	1	1	4
OG0023444	1	1	1	1	4
OG0023445	1	1	1	1	4
OG0023446	1	1	1	1	4
OG0023447	1	1	1	1	4
OG0023448	1	1	1	1	4
OG0023449	1	1	1	1	4
OG0023450	1	1	1	1	4
OG0023451	1	1	1	1	4
OG0023452	1	1	1	1	4
OG0023453	1	1	1	1	4
OG0023454	1	1	1	1	4
OG0023455	1	1	1	1	4
OG0023456	1	1	1	1	4
OG0023457	1	1	1	1	4
OG0023458	1	1	1	1	4
OG0023459	2	2	0	0	4
OG0023460	1	1	1	1	4
OG0023461	1	1	1	1	4
OG0023462	1	1	1	1	4
OG0023463	1	1	1	1	4
OG0023464	1	1	1	1	4
OG0023465	1	1	1	1	4
OG0023466	1	1	1	1	4
OG0023467	1	1	1	1	4
OG0023468	1	1	1	1	4
OG0023469	2	1	1	0	4
OG0023470	1	1	1	1	4
OG0023471	1	1	1	1	4
OG0023472	1	1	1	1	4
OG0023473	1	1	1	1	4
OG0023474	1	1	1	1	4
OG0023475	1	1	1	1	4
OG0023476	1	1	1	1	4
OG0023477	1	1	1	1	4
OG0023478	1	1	1	1	4
OG0023479	1	1	1	1	4
OG0023480	2	0	1	1	4
OG0023481	1	1	1	1	4
OG0023482	1	1	1	1	4
OG0023483	1	3	0	0	4
OG0023484	1	1	1	1	4
OG0023485	1	1	1	1	4
OG0023486	1	1	1	1	4
OG0023487	1	1	1	1	4
OG0023488	1	1	1	1	4
OG0023489	1	1	1	1	4
OG0023490	1	1	2	0	4
OG0023491	1	1	1	1	4
OG0023492	1	1	1	1	4
OG0023493	1	1	1	1	4
OG0023494	1	1	1	1	4
OG0023495	1	1	1	1	4
OG0023496	1	1	1	1	4
OG0023497	1	1	1	1	4
OG0023498	1	1	1	1	4
OG0023499	1	1	1	1	4
OG0023500	1	1	2	0	4
OG0023501	1	1	1	1	4
OG0023502	1	1	1	1	4
OG0023503	1	1	1	1	4
OG0023504	1	1	1	1	4
OG0023505	1	1	1	1	4
OG0023506	1	1	1	1	4
OG0023507	1	1	1	1	4
OG0023508	1	1	1	1	4
OG0023509	1	1	1	1	4
OG0023510	1	1	1	1	4
OG0023511	1	1	1	1	4
OG0023512	1	1	1	1	4
OG0023513	1	1	1	1	4
OG0023514	1	1	1	1	4
OG0023515	1	1	1	1	4
OG0023516	1	1	1	1	4
OG0023517	1	1	1	1	4
OG0023518	1	1	1	1	4
OG0023519	1	1	1	1	4
OG0023520	1	1	1	1	4
OG0023521	1	1	1	1	4
OG0023522	1	1	1	1	4
OG0023523	1	1	1	1	4
OG0023524	1	1	1	1	4
OG0023525	1	1	1	1	4
OG0023526	1	1	1	1	4
OG0023527	1	1	1	1	4
OG0023528	1	1	1	1	4
OG0023529	1	1	1	1	4
OG0023530	1	1	1	1	4
OG0023531	1	3	0	0	4
OG0023532	1	1	1	1	4
OG0023533	1	1	1	1	4
OG0023534	1	3	0	0	4
OG0023535	1	1	1	1	4
OG0023536	1	1	1	1	4
OG0023537	1	1	1	1	4
OG0023538	1	1	1	1	4
OG0023539	1	1	1	1	4
OG0023540	1	1	1	1	4
OG0023541	1	1	1	1	4
OG0023542	1	1	1	1	4
OG0023543	1	1	1	1	4
OG0023544	1	1	1	1	4
OG0023545	1	3	0	0	4
OG0023546	1	1	1	1	4
OG0023547	1	1	1	1	4
OG0023548	1	1	1	1	4
OG0023549	1	1	1	1	4
OG0023550	1	1	1	1	4
OG0023551	1	1	1	1	4
OG0023552	1	1	1	1	4
OG0023553	1	1	1	1	4
OG0023554	1	1	1	1	4
OG0023555	1	1	1	1	4
OG0023556	1	1	1	1	4
OG0023557	1	1	1	1	4
OG0023558	1	1	1	1	4
OG0023559	1	1	1	1	4
OG0023560	1	1	2	0	4
OG0023561	1	3	0	0	4
OG0023562	1	1	1	1	4
OG0023563	1	1	1	1	4
OG0023564	1	1	1	1	4
OG0023565	1	1	1	1	4
OG0023566	1	1	1	1	4
OG0023567	1	1	1	1	4
OG0023568	1	1	1	1	4
OG0023569	1	1	1	1	4
OG0023570	1	1	1	1	4
OG0023571	1	1	1	1	4
OG0023572	1	1	1	1	4
OG0023573	1	1	1	1	4
OG0023574	1	1	1	1	4
OG0023575	1	1	1	1	4
OG0023576	1	1	1	1	4
OG0023577	1	1	1	1	4
OG0023578	1	1	1	1	4
OG0023579	1	1	1	1	4
OG0023580	1	1	1	1	4
OG0023581	1	1	1	1	4
OG0023582	1	1	1	1	4
OG0023583	1	1	1	1	4
OG0023584	1	1	1	1	4
OG0023585	1	1	1	1	4
OG0023586	1	1	1	1	4
OG0023587	1	1	1	1	4
OG0023588	1	1	1	1	4
OG0023589	1	1	1	1	4
OG0023590	1	1	1	1	4
OG0023591	1	1	1	1	4
OG0023592	1	1	1	1	4
OG0023593	1	1	1	1	4
OG0023594	1	1	1	1	4
OG0023595	1	1	1	1	4
OG0023596	1	1	1	1	4
OG0023597	1	1	1	1	4
OG0023598	1	1	1	1	4
OG0023599	1	1	1	1	4
OG0023600	1	1	1	1	4
OG0023601	1	1	1	1	4
OG0023602	1	1	1	1	4
OG0023603	1	1	1	1	4
OG0023604	1	1	1	1	4
OG0023605	1	1	1	1	4
OG0023606	1	1	1	1	4
OG0023607	1	1	1	1	4
OG0023608	1	1	1	1	4
OG0023609	1	1	1	1	4
OG0023610	1	1	1	1	4
OG0023611	1	1	1	1	4
OG0023612	1	1	1	1	4
OG0023613	1	1	1	1	4
OG0023614	1	1	1	1	4
OG0023615	1	1	1	1	4
OG0023616	1	1	1	1	4
OG0023617	2	0	2	0	4
OG0023618	1	1	1	1	4
OG0023619	1	1	1	1	4
OG0023620	1	1	1	1	4
OG0023621	1	1	1	1	4
OG0023622	1	1	1	1	4
OG0023623	1	1	1	1	4
OG0023624	1	1	1	1	4
OG0023625	1	1	1	1	4
OG0023626	1	1	1	1	4
OG0023627	4	0	0	0	4
OG0023628	1	1	1	1	4
OG0023629	1	1	1	1	4
OG0023630	1	1	1	1	4
OG0023631	1	1	1	1	4
OG0023632	1	1	1	1	4
OG0023633	4	0	0	0	4
OG0023634	1	1	1	1	4
OG0023635	4	0	0	0	4
OG0023636	1	1	1	1	4
OG0023637	1	1	1	1	4
OG0023638	1	1	1	1	4
OG0023639	1	1	1	1	4
OG0023640	1	1	1	1	4
OG0023641	3	1	0	0	4
OG0023642	4	0	0	0	4
OG0023643	1	1	1	1	4
OG0023644	1	1	1	1	4
OG0023645	1	1	1	1	4
OG0023646	1	1	1	1	4
OG0023647	1	1	1	1	4
OG0023648	1	1	1	1	4
OG0023649	1	1	1	1	4
OG0023650	1	1	1	1	4
OG0023651	1	1	1	1	4
OG0023652	1	0	2	1	4
OG0023653	1	1	1	1	4
OG0023654	1	3	0	0	4
OG0023655	1	1	1	1	4
OG0023656	1	1	1	1	4
OG0023657	1	1	1	1	4
OG0023658	1	1	1	1	4
OG0023659	1	1	1	1	4
OG0023660	1	1	1	1	4
OG0023661	1	1	1	1	4
OG0023662	1	1	1	1	4
OG0023663	1	1	1	1	4
OG0023664	1	1	1	1	4
OG0023665	1	1	1	1	4
OG0023666	1	1	1	1	4
OG0023667	1	1	1	1	4
OG0023668	1	1	1	1	4
OG0023669	1	1	1	1	4
OG0023670	3	1	0	0	4
OG0023671	1	3	0	0	4
OG0023672	3	1	0	0	4
OG0023673	1	1	1	1	4
OG0023674	1	1	1	1	4
OG0023675	1	1	1	1	4
OG0023676	1	1	1	1	4
OG0023677	1	1	1	1	4
OG0023678	1	1	1	1	4
OG0023679	1	1	1	1	4
OG0023680	1	1	1	1	4
OG0023681	1	1	1	1	4
OG0023682	1	1	1	1	4
OG0023683	1	1	1	1	4
OG0023684	1	1	1	1	4
OG0023685	1	1	1	1	4
OG0023686	1	1	1	1	4
OG0023687	1	1	1	1	4
OG0023688	1	1	1	1	4
OG0023689	1	1	1	1	4
OG0023690	1	1	1	1	4
OG0023691	1	1	1	1	4
OG0023692	3	1	0	0	4
OG0023693	1	1	1	1	4
OG0023694	2	1	0	1	4
OG0023695	1	1	1	1	4
OG0023696	1	1	1	1	4
OG0023697	1	1	1	1	4
OG0023698	1	3	0	0	4
OG0023699	1	1	1	1	4
OG0023700	1	3	0	0	4
OG0023701	1	1	1	1	4
OG0023702	1	1	1	1	4
OG0023703	1	1	1	1	4
OG0023704	1	1	1	1	4
OG0023705	1	1	1	1	4
OG0023706	1	3	0	0	4
OG0023707	1	1	1	1	4
OG0023708	1	1	1	1	4
OG0023709	1	1	1	1	4
OG0023710	2	0	1	1	4
OG0023711	1	1	1	1	4
OG0023712	1	1	1	1	4
OG0023713	1	1	1	1	4
OG0023714	1	1	1	1	4
OG0023715	1	1	1	1	4
OG0023716	1	1	1	1	4
OG0023717	1	1	1	1	4
OG0023718	1	1	1	1	4
OG0023719	1	1	1	1	4
OG0023720	1	1	1	1	4
OG0023721	1	3	0	0	4
OG0023722	1	0	2	1	4
OG0023723	1	1	1	1	4
OG0023724	1	1	1	1	4
OG0023725	1	1	1	1	4
OG0023726	0	4	0	0	4
OG0023727	0	4	0	0	4
OG0023728	0	4	0	0	4
OG0023729	0	4	0	0	4
OG0023730	0	4	0	0	4
OG0023731	0	4	0	0	4
OG0023732	0	4	0	0	4
OG0023733	0	4	0	0	4
OG0023734	0	4	0	0	4
OG0023735	0	4	0	0	4
OG0023736	0	4	0	0	4
OG0023737	0	4	0	0	4
OG0023738	0	4	0	0	4
OG0023739	0	4	0	0	4
OG0023740	0	4	0	0	4
OG0023741	0	4	0	0	4
OG0023742	0	4	0	0	4
OG0023743	0	4	0	0	4
OG0023744	0	4	0	0	4
OG0023745	0	4	0	0	4
OG0023746	0	4	0	0	4
OG0023747	0	4	0	0	4
OG0023748	0	4	0	0	4
OG0023749	0	4	0	0	4
OG0023750	0	4	0	0	4
OG0023751	0	4	0	0	4
OG0023752	0	4	0	0	4
OG0023753	0	4	0	0	4
OG0023754	0	4	0	0	4
OG0023755	0	4	0	0	4
OG0023756	0	3	1	0	4
OG0023757	0	1	3	0	4
OG0023758	0	4	0	0	4
OG0023759	0	4	0	0	4
OG0023760	0	4	0	0	4
OG0023761	0	2	1	1	4
OG0023762	0	2	2	0	4
OG0023763	0	4	0	0	4
OG0023764	0	1	1	2	4
OG0023765	0	4	0	0	4
OG0023766	0	1	1	2	4
OG0023767	0	4	0	0	4
OG0023768	0	4	0	0	4
OG0023769	0	4	0	0	4
OG0023770	0	4	0	0	4
OG0023771	0	4	0	0	4
OG0023772	0	4	0	0	4
OG0023773	0	4	0	0	4
OG0023774	0	2	1	1	4
OG0023775	0	4	0	0	4
OG0023776	0	4	0	0	4
OG0023777	0	4	0	0	4
OG0023778	0	2	0	2	4
OG0023779	0	2	1	1	4
OG0023780	0	4	0	0	4
OG0023781	0	4	0	0	4
OG0023782	0	4	0	0	4
OG0023783	0	1	2	1	4
OG0023784	0	1	1	2	4
OG0023785	0	2	1	1	4
OG0023786	0	4	0	0	4
OG0023787	0	3	0	1	4
OG0023788	0	1	1	2	4
OG0023789	0	2	1	1	4
OG0023790	0	3	0	1	4
OG0023791	0	1	1	2	4
OG0023792	0	1	2	1	4
OG0023793	0	1	1	2	4
OG0023794	0	4	0	0	4
OG0023795	0	4	0	0	4
OG0023796	0	2	1	1	4
OG0023797	0	1	1	2	4
OG0023798	0	4	0	0	4
OG0023799	0	4	0	0	4
OG0023800	0	1	2	1	4
OG0023801	0	4	0	0	4
OG0023802	0	1	1	2	4
OG0023803	0	4	0	0	4
OG0023804	0	4	0	0	4
OG0023805	0	4	0	0	4
OG0023806	0	4	0	0	4
OG0023807	0	4	0	0	4
OG0023808	0	4	0	0	4
OG0023809	0	4	0	0	4
OG0023810	0	2	1	1	4
OG0023811	0	4	0	0	4
OG0023812	0	3	1	0	4
OG0023813	0	2	1	1	4
OG0023814	0	2	1	1	4
OG0023815	0	2	1	1	4
OG0023816	0	4	0	0	4
OG0023817	0	4	0	0	4
OG0023818	0	4	0	0	4
OG0023819	0	4	0	0	4
OG0023820	0	4	0	0	4
OG0023821	0	4	0	0	4
OG0023822	0	4	0	0	4
OG0023823	0	4	0	0	4
OG0023824	0	4	0	0	4
OG0023825	0	4	0	0	4
OG0023826	0	4	0	0	4
OG0023827	0	4	0	0	4
OG0023828	0	4	0	0	4
OG0023829	0	4	0	0	4
OG0023830	0	4	0	0	4
OG0023831	0	4	0	0	4
OG0023832	0	4	0	0	4
OG0023833	0	4	0	0	4
OG0023834	0	4	0	0	4
OG0023835	0	4	0	0	4
OG0023836	0	1	1	2	4
OG0023837	0	1	1	2	4
OG0023838	0	2	1	1	4
OG0023839	0	4	0	0	4
OG0023840	0	1	1	2	4
OG0023841	0	1	2	1	4
OG0023842	0	4	0	0	4
OG0023843	0	4	0	0	4
OG0023844	0	3	1	0	4
OG0023845	0	1	2	1	4
OG0023846	0	4	0	0	4
OG0023847	0	4	0	0	4
OG0023848	0	1	1	2	4
OG0023849	0	4	0	0	4
OG0023850	0	4	0	0	4
OG0023851	0	1	0	3	4
OG0023852	0	4	0	0	4
OG0023853	0	4	0	0	4
OG0023854	0	4	0	0	4
OG0023855	0	3	0	1	4
OG0023856	0	4	0	0	4
OG0023857	0	4	0	0	4
OG0023858	0	4	0	0	4
OG0023859	0	4	0	0	4
OG0023860	0	4	0	0	4
OG0023861	0	1	2	1	4
OG0023862	0	1	1	2	4
OG0023863	0	4	0	0	4
OG0023864	0	4	0	0	4
OG0023865	0	4	0	0	4
OG0023866	0	4	0	0	4
OG0023867	0	4	0	0	4
OG0023868	0	4	0	0	4
OG0023869	0	4	0	0	4
OG0023870	0	4	0	0	4
OG0023871	0	4	0	0	4
OG0023872	0	4	0	0	4
OG0023873	0	4	0	0	4
OG0023874	0	4	0	0	4
OG0023875	0	4	0	0	4
OG0023876	0	1	2	1	4
OG0023877	0	4	0	0	4
OG0023878	0	4	0	0	4
OG0023879	0	4	0	0	4
OG0023880	0	2	1	1	4
OG0023881	0	4	0	0	4
OG0023882	0	4	0	0	4
OG0023883	0	4	0	0	4
OG0023884	0	2	0	2	4
OG0023885	0	4	0	0	4
OG0023886	0	4	0	0	4
OG0023887	0	2	1	1	4
OG0023888	0	4	0	0	4
OG0023889	0	3	0	1	4
OG0023890	0	4	0	0	4
OG0023891	0	3	0	1	4
OG0023892	0	1	2	1	4
OG0023893	0	2	1	1	4
OG0023894	0	1	0	3	4
OG0023895	0	1	1	2	4
OG0023896	0	4	0	0	4
OG0023897	0	1	2	1	4
OG0023898	0	4	0	0	4
OG0023899	0	1	2	1	4
OG0023900	0	1	2	1	4
OG0023901	0	1	1	2	4
OG0023902	0	1	2	1	4
OG0023903	0	1	1	2	4
OG0023904	0	4	0	0	4
OG0023905	0	1	2	1	4
OG0023906	0	1	1	2	4
OG0023907	0	4	0	0	4
OG0023908	0	1	2	1	4
OG0023909	0	1	1	2	4
OG0023910	0	4	0	0	4
OG0023911	0	1	1	2	4
OG0023912	0	1	2	1	4
OG0023913	0	1	2	1	4
OG0023914	0	4	0	0	4
OG0023915	0	1	2	1	4
OG0023916	0	4	0	0	4
OG0023917	0	4	0	0	4
OG0023918	0	4	0	0	4
OG0023919	0	1	2	1	4
OG0023920	0	2	1	1	4
OG0023921	0	4	0	0	4
OG0023922	0	4	0	0	4
OG0023923	0	4	0	0	4
OG0023924	0	4	0	0	4
OG0023925	0	1	2	1	4
OG0023926	0	4	0	0	4
OG0023927	0	4	0	0	4
OG0023928	0	1	1	2	4
OG0023929	0	4	0	0	4
OG0023930	0	1	2	1	4
OG0023931	0	4	0	0	4
OG0023932	0	4	0	0	4
OG0023933	0	4	0	0	4
OG0023934	0	2	1	1	4
OG0023935	0	2	1	1	4
OG0023936	0	4	0	0	4
OG0023937	0	4	0	0	4
OG0023938	0	4	0	0	4
OG0023939	0	4	0	0	4
OG0023940	0	2	0	2	4
OG0023941	0	1	3	0	4
OG0023942	0	4	0	0	4
OG0023943	0	4	0	0	4
OG0023944	0	2	1	1	4
OG0023945	0	4	0	0	4
OG0023946	0	2	1	1	4
OG0023947	0	4	0	0	4
OG0023948	0	1	0	3	4
OG0023949	0	1	1	2	4
OG0023950	0	2	1	1	4
OG0023951	0	1	1	2	4
OG0023952	0	4	0	0	4
OG0023953	0	4	0	0	4
OG0023954	0	2	1	1	4
OG0023955	0	1	1	2	4
OG0023956	0	1	2	1	4
OG0023957	0	1	2	1	4
OG0023958	0	4	0	0	4
OG0023959	0	3	0	1	4
OG0023960	0	4	0	0	4
OG0023961	0	1	1	2	4
OG0023962	0	4	0	0	4
OG0023963	0	4	0	0	4
OG0023964	0	4	0	0	4
OG0023965	0	4	0	0	4
OG0023966	0	4	0	0	4
OG0023967	0	1	1	2	4
OG0023968	0	1	3	0	4
OG0023969	0	2	1	1	4
OG0023970	0	4	0	0	4
OG0023971	0	2	1	1	4
OG0023972	0	1	2	1	4
OG0023973	0	3	0	1	4
OG0023974	0	4	0	0	4
OG0023975	0	2	1	1	4
OG0023976	0	1	1	2	4
OG0023977	0	4	0	0	4
OG0023978	0	2	0	2	4
OG0023979	0	4	0	0	4
OG0023980	0	4	0	0	4
OG0023981	0	2	1	1	4
OG0023982	0	4	0	0	4
OG0023983	0	4	0	0	4
OG0023984	0	4	0	0	4
OG0023985	0	1	2	1	4
OG0023986	0	4	0	0	4
OG0023987	0	1	2	1	4
OG0023988	0	1	1	2	4
OG0023989	0	1	1	2	4
OG0023990	0	1	2	1	4
OG0023991	0	4	0	0	4
OG0023992	0	2	1	1	4
OG0023993	0	2	1	1	4
OG0023994	0	1	2	1	4
OG0023995	0	4	0	0	4
OG0023996	0	2	1	1	4
OG0023997	0	4	0	0	4
OG0023998	0	4	0	0	4
OG0023999	0	1	2	1	4
OG0024000	0	4	0	0	4
OG0024001	0	4	0	0	4
OG0024002	0	4	0	0	4
OG0024003	0	4	0	0	4
OG0024004	0	4	0	0	4
OG0024005	0	4	0	0	4
OG0024006	0	4	0	0	4
OG0024007	0	4	0	0	4
OG0024008	0	1	2	1	4
OG0024009	0	3	1	0	4
OG0024010	0	1	2	1	4
OG0024011	0	1	1	2	4
OG0024012	0	1	0	3	4
OG0024013	0	4	0	0	4
OG0024014	0	2	1	1	4
OG0024015	0	1	1	2	4
OG0024016	0	1	2	1	4
OG0024017	0	1	2	1	4
OG0024018	0	1	2	1	4
OG0024019	0	2	1	1	4
OG0024020	0	4	0	0	4
OG0024021	0	2	1	1	4
OG0024022	0	4	0	0	4
OG0024023	0	4	0	0	4
OG0024024	0	4	0	0	4
OG0024025	0	4	0	0	4
OG0024026	0	4	0	0	4
OG0024027	0	4	0	0	4
OG0024028	0	1	1	2	4
OG0024029	0	4	0	0	4
OG0024030	0	4	0	0	4
OG0024031	0	2	2	0	4
OG0024032	0	4	0	0	4
OG0024033	0	4	0	0	4
OG0024034	0	2	2	0	4
OG0024035	0	1	2	1	4
OG0024036	0	4	0	0	4
OG0024037	0	2	1	1	4
OG0024038	0	1	2	1	4
OG0024039	0	1	1	2	4
OG0024040	0	2	1	1	4
OG0024041	0	1	2	1	4
OG0024042	0	4	0	0	4
OG0024043	0	1	2	1	4
OG0024044	0	4	0	0	4
OG0024045	0	2	1	1	4
OG0024046	0	1	2	1	4
OG0024047	0	2	1	1	4
OG0024048	0	1	2	1	4
OG0024049	0	4	0	0	4
OG0024050	0	1	1	2	4
OG0024051	0	1	2	1	4
OG0024052	0	1	1	2	4
OG0024053	0	1	2	1	4
OG0024054	0	1	3	0	4
OG0024055	0	4	0	0	4
OG0024056	0	4	0	0	4
OG0024057	0	2	1	1	4
OG0024058	0	2	1	1	4
OG0024059	0	1	2	1	4
OG0024060	0	1	1	2	4
OG0024061	0	1	2	1	4
OG0024062	0	4	0	0	4
OG0024063	0	3	0	1	4
OG0024064	0	1	2	1	4
OG0024065	0	3	0	1	4
OG0024066	0	1	0	3	4
OG0024067	0	2	1	1	4
OG0024068	0	4	0	0	4
OG0024069	0	1	2	1	4
OG0024070	0	1	1	2	4
OG0024071	0	1	2	1	4
OG0024072	0	4	0	0	4
OG0024073	0	4	0	0	4
OG0024074	0	1	0	3	4
OG0024075	0	4	0	0	4
OG0024076	0	4	0	0	4
OG0024077	0	4	0	0	4
OG0024078	0	3	1	0	4
OG0024079	0	1	0	3	4
OG0024080	0	1	1	2	4
OG0024081	0	1	2	1	4
OG0024082	0	1	1	2	4
OG0024083	0	4	0	0	4
OG0024084	0	1	2	1	4
OG0024085	0	1	1	2	4
OG0024086	0	3	1	0	4
OG0024087	0	1	1	2	4
OG0024088	0	1	2	1	4
OG0024089	0	1	1	2	4
OG0024090	0	1	1	2	4
OG0024091	0	1	1	2	4
OG0024092	0	1	3	0	4
OG0024093	0	1	1	2	4
OG0024094	0	1	3	0	4
OG0024095	0	4	0	0	4
OG0024096	0	1	2	1	4
OG0024097	0	1	2	1	4
OG0024098	0	4	0	0	4
OG0024099	0	2	1	1	4
OG0024100	0	1	1	2	4
OG0024101	0	2	1	1	4
OG0024102	0	1	1	2	4
OG0024103	0	1	2	1	4
OG0024104	0	1	2	1	4
OG0024105	0	1	1	2	4
OG0024106	0	1	1	2	4
OG0024107	0	1	2	1	4
OG0024108	0	1	2	1	4
OG0024109	0	1	1	2	4
OG0024110	0	1	1	2	4
OG0024111	0	2	1	1	4
OG0024112	0	1	2	1	4
OG0024113	0	1	3	0	4
OG0024114	0	1	2	1	4
OG0024115	0	1	2	1	4
OG0024116	0	4	0	0	4
OG0024117	0	1	1	2	4
OG0024118	0	1	3	0	4
OG0024119	0	4	0	0	4
OG0024120	0	1	2	1	4
OG0024121	0	0	3	1	4
OG0024122	0	0	1	3	4
OG0024123	0	0	3	1	4
OG0024124	0	0	2	2	4
OG0024125	0	0	3	1	4
OG0024126	0	0	4	0	4
OG0024127	0	0	4	0	4
OG0024128	0	0	4	0	4
OG0024129	0	0	4	0	4
OG0024130	0	0	4	0	4
OG0024131	0	0	4	0	4
OG0024132	0	0	3	1	4
OG0024133	0	0	2	2	4
OG0024134	0	0	2	2	4
OG0024135	0	0	4	0	4
OG0024136	0	0	2	2	4
OG0024137	0	0	4	0	4
OG0024138	0	0	3	1	4
OG0024139	0	0	1	3	4
OG0024140	0	0	2	2	4
OG0024141	0	0	4	0	4
OG0024142	0	0	2	2	4
OG0024143	0	0	4	0	4
OG0024144	0	0	3	1	4
OG0024145	0	0	2	2	4
OG0024146	0	0	2	2	4
OG0024147	0	0	4	0	4
OG0024148	0	0	3	1	4
OG0024149	0	0	3	1	4
OG0024150	0	0	4	0	4
OG0024151	0	0	1	3	4
OG0024152	0	0	2	2	4
OG0024153	0	0	2	2	4
OG0024154	0	0	2	2	4
OG0024155	0	0	2	2	4
OG0024156	0	0	1	3	4
OG0024157	0	0	4	0	4
OG0024158	0	0	2	2	4
OG0024159	0	0	2	2	4
OG0024160	0	0	4	0	4
OG0024161	0	0	4	0	4
OG0024162	0	0	1	3	4
OG0024163	0	0	4	0	4
OG0024164	0	0	3	1	4
OG0024165	0	0	2	2	4
OG0024166	0	0	3	1	4
OG0024167	0	0	2	2	4
OG0024168	0	0	3	1	4
OG0024169	0	0	3	1	4
OG0024170	0	0	3	1	4
OG0024171	0	0	3	1	4
OG0024172	0	0	3	1	4
OG0024173	0	0	2	2	4
OG0024174	0	0	1	3	4
OG0024175	0	0	4	0	4
OG0024176	0	0	3	1	4
OG0024177	0	0	1	3	4
OG0024178	0	0	2	2	4
OG0024179	0	0	4	0	4
OG0024180	0	0	1	3	4
OG0024181	0	0	2	2	4
OG0024182	0	0	2	2	4
OG0024183	0	0	3	1	4
OG0024184	0	0	3	1	4
OG0024185	0	0	3	1	4
OG0024186	0	0	2	2	4
OG0024187	0	0	2	2	4
OG0024188	0	0	2	2	4
OG0024189	0	0	2	2	4
OG0024190	0	0	2	2	4
OG0024191	0	0	1	3	4
OG0024192	0	0	1	3	4
OG0024193	0	0	2	2	4
OG0024194	0	0	2	2	4
OG0024195	0	0	1	3	4
OG0024196	0	0	2	2	4
OG0024197	0	0	2	2	4
OG0024198	0	0	3	1	4
OG0024199	0	0	2	2	4
OG0024200	0	0	1	3	4
OG0024201	0	0	3	1	4
OG0024202	0	0	4	0	4
OG0024203	0	0	3	1	4
OG0024204	0	0	2	2	4
OG0024205	0	0	2	2	4
OG0024206	0	0	1	3	4
OG0024207	0	0	3	1	4
OG0024208	0	0	3	1	4
OG0024209	0	0	4	0	4
OG0024210	0	0	1	3	4
OG0024211	0	0	4	0	4
OG0024212	0	0	4	0	4
OG0024213	0	0	2	2	4
OG0024214	0	0	1	3	4
OG0024215	0	0	3	1	4
OG0024216	0	0	4	0	4
OG0024217	0	0	2	2	4
OG0024218	0	0	4	0	4
OG0024219	0	0	3	1	4
OG0024220	0	0	1	3	4
OG0024221	0	0	3	1	4
OG0024222	0	0	3	1	4
OG0024223	0	0	2	2	4
OG0024224	0	0	2	2	4
OG0024225	0	0	4	0	4
OG0024226	0	0	4	0	4
OG0024227	0	0	4	0	4
OG0024228	0	0	3	1	4
OG0024229	0	0	3	1	4
OG0024230	0	0	2	2	4
OG0024231	0	0	3	1	4
OG0024232	0	0	1	3	4
OG0024233	0	0	2	2	4
OG0024234	0	0	2	2	4
OG0024235	0	0	4	0	4
OG0024236	0	0	3	1	4
OG0024237	0	0	3	1	4
OG0024238	0	0	2	2	4
OG0024239	0	0	2	2	4
OG0024240	0	0	3	1	4
OG0024241	0	0	3	1	4
OG0024242	0	0	2	2	4
OG0024243	0	0	4	0	4
OG0024244	0	0	1	3	4
OG0024245	0	0	1	3	4
OG0024246	0	0	2	2	4
OG0024247	0	0	3	1	4
OG0024248	0	0	3	1	4
OG0024249	0	0	2	2	4
OG0024250	0	0	3	1	4
OG0024251	0	0	3	1	4
OG0024252	0	0	3	1	4
OG0024253	0	0	2	2	4
OG0024254	0	0	3	1	4
OG0024255	0	0	2	2	4
OG0024256	0	0	4	0	4
OG0024257	0	0	2	2	4
OG0024258	0	0	1	3	4
OG0024259	0	0	2	2	4
OG0024260	0	0	1	3	4
OG0024261	0	0	2	2	4
OG0024262	0	0	1	3	4
OG0024263	0	0	2	2	4
OG0024264	0	0	1	3	4
OG0024265	0	0	2	2	4
OG0024266	0	0	1	3	4
OG0024267	0	0	1	3	4
OG0024268	0	0	3	1	4
OG0024269	0	0	4	0	4
OG0024270	0	0	1	3	4
OG0024271	0	0	1	3	4
OG0024272	0	0	1	3	4
OG0024273	0	0	4	0	4
OG0024274	0	0	1	3	4
OG0024275	0	0	3	1	4
OG0024276	0	0	1	3	4
OG0024277	0	0	1	3	4
OG0024278	0	0	1	3	4
OG0024279	0	0	1	3	4
OG0024280	0	0	3	1	4
OG0024281	0	0	2	2	4
OG0024282	0	0	1	3	4
OG0024283	0	0	2	2	4
OG0024284	0	0	4	0	4
OG0024285	0	0	4	0	4
OG0024286	0	0	1	3	4
OG0024287	0	0	3	1	4
OG0024288	0	0	2	2	4
OG0024289	0	0	4	0	4
OG0024290	0	0	1	3	4
OG0024291	0	0	2	2	4
OG0024292	0	0	2	2	4
OG0024293	0	0	4	0	4
OG0024294	0	0	3	1	4
OG0024295	0	0	1	3	4
OG0024296	0	0	2	2	4
OG0024297	0	0	2	2	4
OG0024298	0	0	1	3	4
OG0024299	0	0	1	3	4
OG0024300	0	0	4	0	4
OG0024301	0	0	4	0	4
OG0024302	0	0	3	1	4
OG0024303	0	0	4	0	4
OG0024304	0	0	2	2	4
OG0024305	0	0	1	3	4
OG0024306	0	0	1	3	4
OG0024307	0	0	2	2	4
OG0024308	0	0	1	3	4
OG0024309	0	0	3	1	4
OG0024310	0	0	2	2	4
OG0024311	0	0	4	0	4
OG0024312	0	0	1	3	4
OG0024313	0	0	2	2	4
OG0024314	0	0	2	2	4
OG0024315	0	0	1	3	4
OG0024316	0	0	2	2	4
OG0024317	0	0	3	1	4
OG0024318	0	0	4	0	4
OG0024319	0	0	2	2	4
OG0024320	0	0	4	0	4
OG0024321	0	0	1	3	4
OG0024322	0	0	1	3	4
OG0024323	0	0	1	3	4
OG0024324	0	0	3	1	4
OG0024325	0	0	1	3	4
OG0024326	0	0	3	1	4
OG0024327	0	0	3	1	4
OG0024328	0	0	2	2	4
OG0024329	0	0	2	2	4
OG0024330	0	0	1	3	4
OG0024331	0	0	3	1	4
OG0024332	0	0	3	1	4
OG0024333	0	0	3	1	4
OG0024334	0	0	2	2	4
OG0024335	0	0	1	3	4
OG0024336	0	0	3	1	4
OG0024337	0	0	2	2	4
OG0024338	0	0	2	2	4
OG0024339	0	0	1	3	4
OG0024340	0	0	1	3	4
OG0024341	0	0	2	2	4
OG0024342	0	0	4	0	4
OG0024343	0	0	2	2	4
OG0024344	0	0	2	2	4
OG0024345	0	0	2	2	4
OG0024346	0	0	3	1	4
OG0024347	0	0	2	2	4
OG0024348	0	0	4	0	4
OG0024349	0	0	1	3	4
OG0024350	0	0	2	2	4
OG0024351	0	0	3	1	4
OG0024352	0	0	2	2	4
OG0024353	0	0	4	0	4
OG0024354	0	0	4	0	4
OG0024355	0	0	4	0	4
OG0024356	0	0	1	3	4
OG0024357	0	0	1	3	4
OG0024358	0	0	1	3	4
OG0024359	0	0	2	2	4
OG0024360	0	0	1	3	4
OG0024361	0	0	2	2	4
OG0024362	0	0	1	3	4
OG0024363	0	0	3	1	4
OG0024364	0	0	3	1	4
OG0024365	0	0	1	3	4
OG0024366	0	0	1	3	4
OG0024367	0	0	3	1	4
OG0024368	0	0	1	3	4
OG0024369	0	0	4	0	4
OG0024370	0	0	2	2	4
OG0024371	0	0	2	2	4
OG0024372	0	0	3	1	4
OG0024373	0	0	1	3	4
OG0024374	0	0	2	2	4
OG0024375	0	0	2	2	4
OG0024376	0	0	3	1	4
OG0024377	0	0	2	2	4
OG0024378	0	0	2	2	4
OG0024379	0	0	1	3	4
OG0024380	0	0	0	4	4
OG0024381	0	0	0	4	4
OG0024382	0	0	0	4	4
OG0024383	0	0	0	4	4
OG0024384	0	0	0	4	4
OG0024385	0	0	0	4	4
OG0024386	0	0	0	4	4
OG0024387	0	0	0	4	4
OG0024388	0	0	0	4	4
OG0024389	0	0	0	4	4
OG0024390	0	0	0	4	4
OG0024391	0	0	0	4	4
OG0024392	0	0	0	4	4
OG0024393	0	0	0	4	4
OG0024394	0	0	0	4	4
OG0024395	0	0	0	4	4
OG0024396	0	0	0	4	4
OG0024397	0	0	0	4	4
OG0024398	0	0	0	4	4
OG0024399	0	0	0	4	4
OG0024400	0	0	0	4	4
OG0024401	0	0	0	4	4
OG0024402	0	0	0	4	4
OG0024403	0	0	0	4	4
OG0024404	0	0	0	4	4
OG0024405	0	0	0	4	4
OG0024406	0	0	0	4	4
OG0024407	0	0	0	4	4
OG0024408	0	0	0	4	4
OG0024409	0	0	0	4	4
OG0024410	0	0	0	4	4
OG0024411	0	0	0	4	4
OG0024412	0	0	0	4	4
OG0024413	0	0	0	4	4
OG0024414	0	0	0	4	4
OG0024415	0	0	0	4	4
OG0024416	0	0	0	4	4
OG0024417	0	0	0	4	4
OG0024418	0	0	0	4	4
OG0024419	0	0	0	4	4
OG0024420	0	0	0	4	4
OG0024421	0	0	0	4	4
OG0024422	0	0	0	4	4
OG0024423	0	0	0	4	4
OG0024424	0	0	0	4	4
OG0024425	0	0	0	4	4
OG0024426	0	0	0	4	4
OG0024427	0	0	0	4	4
OG0024428	0	0	0	4	4
OG0024429	0	0	0	4	4
OG0024430	0	0	0	4	4
OG0024431	0	0	0	4	4
OG0024432	0	0	0	4	4
OG0024433	0	0	0	4	4
OG0024434	0	0	0	4	4
OG0024435	0	0	0	4	4
OG0024436	0	0	0	4	4
OG0024437	0	0	0	4	4
OG0024438	0	0	0	4	4
OG0024439	0	0	0	4	4
OG0024440	0	0	0	4	4
OG0024441	0	0	0	4	4
OG0024442	2	1	0	0	3
OG0024443	3	0	0	0	3
OG0024444	1	2	0	0	3
OG0024445	2	1	0	0	3
OG0024446	2	0	1	0	3
OG0024447	2	1	0	0	3
OG0024448	3	0	0	0	3
OG0024449	1	0	1	1	3
OG0024450	2	0	0	1	3
OG0024451	3	0	0	0	3
OG0024452	1	1	0	1	3
OG0024453	3	0	0	0	3
OG0024454	3	0	0	0	3
OG0024455	1	0	1	1	3
OG0024456	3	0	0	0	3
OG0024457	2	1	0	0	3
OG0024458	1	1	1	0	3
OG0024459	1	1	1	0	3
OG0024460	3	0	0	0	3
OG0024461	2	1	0	0	3
OG0024462	2	1	0	0	3
OG0024463	1	2	0	0	3
OG0024464	1	1	1	0	3
OG0024465	1	0	1	1	3
OG0024466	3	0	0	0	3
OG0024467	2	1	0	0	3
OG0024468	1	1	0	1	3
OG0024469	1	2	0	0	3
OG0024470	2	1	0	0	3
OG0024471	1	1	0	1	3
OG0024472	2	1	0	0	3
OG0024473	1	0	1	1	3
OG0024474	1	1	1	0	3
OG0024475	3	0	0	0	3
OG0024476	3	0	0	0	3
OG0024477	3	0	0	0	3
OG0024478	2	1	0	0	3
OG0024479	1	0	2	0	3
OG0024480	2	0	1	0	3
OG0024481	3	0	0	0	3
OG0024482	1	0	1	1	3
OG0024483	1	2	0	0	3
OG0024484	2	1	0	0	3
OG0024485	1	1	0	1	3
OG0024486	1	1	1	0	3
OG0024487	1	2	0	0	3
OG0024488	1	2	0	0	3
OG0024489	1	0	1	1	3
OG0024490	3	0	0	0	3
OG0024491	2	1	0	0	3
OG0024492	2	1	0	0	3
OG0024493	1	2	0	0	3
OG0024494	3	0	0	0	3
OG0024495	1	1	0	1	3
OG0024496	3	0	0	0	3
OG0024497	2	1	0	0	3
OG0024498	3	0	0	0	3
OG0024499	1	2	0	0	3
OG0024500	2	1	0	0	3
OG0024501	3	0	0	0	3
OG0024502	2	0	1	0	3
OG0024503	1	0	1	1	3
OG0024504	3	0	0	0	3
OG0024505	1	1	1	0	3
OG0024506	1	1	1	0	3
OG0024507	2	1	0	0	3
OG0024508	2	1	0	0	3
OG0024509	1	1	1	0	3
OG0024510	2	1	0	0	3
OG0024511	1	0	1	1	3
OG0024512	3	0	0	0	3
OG0024513	1	1	1	0	3
OG0024514	1	2	0	0	3
OG0024515	1	0	1	1	3
OG0024516	1	0	1	1	3
OG0024517	1	0	1	1	3
OG0024518	1	0	0	2	3
OG0024519	1	0	1	1	3
OG0024520	1	1	0	1	3
OG0024521	1	1	1	0	3
OG0024522	1	0	1	1	3
OG0024523	1	0	1	1	3
OG0024524	1	0	1	1	3
OG0024525	1	1	1	0	3
OG0024526	1	1	1	0	3
OG0024527	1	0	1	1	3
OG0024528	1	2	0	0	3
OG0024529	1	0	1	1	3
OG0024530	2	1	0	0	3
OG0024531	1	2	0	0	3
OG0024532	3	0	0	0	3
OG0024533	1	0	1	1	3
OG0024534	2	1	0	0	3
OG0024535	2	1	0	0	3
OG0024536	2	1	0	0	3
OG0024537	2	1	0	0	3
OG0024538	1	1	0	1	3
OG0024539	1	0	1	1	3
OG0024540	1	0	1	1	3
OG0024541	1	2	0	0	3
OG0024542	1	1	1	0	3
OG0024543	2	1	0	0	3
OG0024544	3	0	0	0	3
OG0024545	2	1	0	0	3
OG0024546	1	0	1	1	3
OG0024547	1	1	1	0	3
OG0024548	1	0	1	1	3
OG0024549	1	1	1	0	3
OG0024550	1	0	1	1	3
OG0024551	1	0	1	1	3
OG0024552	1	0	1	1	3
OG0024553	1	0	1	1	3
OG0024554	1	0	1	1	3
OG0024555	1	0	1	1	3
OG0024556	2	1	0	0	3
OG0024557	1	1	0	1	3
OG0024558	2	1	0	0	3
OG0024559	1	1	0	1	3
OG0024560	2	1	0	0	3
OG0024561	1	0	1	1	3
OG0024562	1	1	0	1	3
OG0024563	2	1	0	0	3
OG0024564	1	0	1	1	3
OG0024565	1	1	0	1	3
OG0024566	1	0	1	1	3
OG0024567	1	1	1	0	3
OG0024568	3	0	0	0	3
OG0024569	1	0	0	2	3
OG0024570	3	0	0	0	3
OG0024571	1	0	1	1	3
OG0024572	1	1	1	0	3
OG0024573	1	1	1	0	3
OG0024574	1	1	0	1	3
OG0024575	1	0	1	1	3
OG0024576	1	2	0	0	3
OG0024577	1	0	1	1	3
OG0024578	1	0	1	1	3
OG0024579	1	1	0	1	3
OG0024580	1	0	1	1	3
OG0024581	1	1	1	0	3
OG0024582	1	0	1	1	3
OG0024583	1	0	1	1	3
OG0024584	1	0	1	1	3
OG0024585	1	0	0	2	3
OG0024586	1	0	1	1	3
OG0024587	1	0	0	2	3
OG0024588	1	0	1	1	3
OG0024589	1	0	1	1	3
OG0024590	1	1	0	1	3
OG0024591	2	1	0	0	3
OG0024592	1	0	1	1	3
OG0024593	2	1	0	0	3
OG0024594	1	2	0	0	3
OG0024595	1	0	1	1	3
OG0024596	1	0	1	1	3
OG0024597	1	1	1	0	3
OG0024598	1	1	1	0	3
OG0024599	1	1	1	0	3
OG0024600	1	1	1	0	3
OG0024601	1	0	1	1	3
OG0024602	1	1	0	1	3
OG0024603	1	0	1	1	3
OG0024604	1	1	1	0	3
OG0024605	1	1	1	0	3
OG0024606	1	0	1	1	3
OG0024607	1	0	1	1	3
OG0024608	1	0	1	1	3
OG0024609	1	1	1	0	3
OG0024610	1	0	1	1	3
OG0024611	1	1	0	1	3
OG0024612	1	1	0	1	3
OG0024613	1	1	1	0	3
OG0024614	1	1	0	1	3
OG0024615	1	1	0	1	3
OG0024616	1	0	1	1	3
OG0024617	1	1	1	0	3
OG0024618	2	1	0	0	3
OG0024619	1	1	1	0	3
OG0024620	1	0	1	1	3
OG0024621	1	1	1	0	3
OG0024622	1	1	0	1	3
OG0024623	1	1	1	0	3
OG0024624	1	2	0	0	3
OG0024625	1	0	1	1	3
OG0024626	1	0	1	1	3
OG0024627	2	1	0	0	3
OG0024628	1	0	1	1	3
OG0024629	1	0	1	1	3
OG0024630	1	0	1	1	3
OG0024631	1	2	0	0	3
OG0024632	3	0	0	0	3
OG0024633	3	0	0	0	3
OG0024634	1	0	1	1	3
OG0024635	1	0	1	1	3
OG0024636	1	1	0	1	3
OG0024637	1	1	1	0	3
OG0024638	1	0	1	1	3
OG0024639	2	0	1	0	3
OG0024640	1	1	1	0	3
OG0024641	2	1	0	0	3
OG0024642	1	1	0	1	3
OG0024643	2	1	0	0	3
OG0024644	3	0	0	0	3
OG0024645	1	1	1	0	3
OG0024646	1	1	0	1	3
OG0024647	1	0	0	2	3
OG0024648	1	0	1	1	3
OG0024649	3	0	0	0	3
OG0024650	2	1	0	0	3
OG0024651	2	1	0	0	3
OG0024652	2	1	0	0	3
OG0024653	2	1	0	0	3
OG0024654	1	0	1	1	3
OG0024655	3	0	0	0	3
OG0024656	1	0	1	1	3
OG0024657	2	1	0	0	3
OG0024658	3	0	0	0	3
OG0024659	1	1	1	0	3
OG0024660	1	0	1	1	3
OG0024661	1	0	1	1	3
OG0024662	1	0	1	1	3
OG0024663	1	0	2	0	3
OG0024664	3	0	0	0	3
OG0024665	1	0	1	1	3
OG0024666	1	1	1	0	3
OG0024667	2	1	0	0	3
OG0024668	1	1	0	1	3
OG0024669	1	0	1	1	3
OG0024670	1	0	1	1	3
OG0024671	1	1	1	0	3
OG0024672	2	1	0	0	3
OG0024673	2	1	0	0	3
OG0024674	1	0	1	1	3
OG0024675	3	0	0	0	3
OG0024676	2	1	0	0	3
OG0024677	1	0	1	1	3
OG0024678	3	0	0	0	3
OG0024679	2	1	0	0	3
OG0024680	2	1	0	0	3
OG0024681	2	1	0	0	3
OG0024682	3	0	0	0	3
OG0024683	1	1	0	1	3
OG0024684	2	1	0	0	3
OG0024685	1	0	1	1	3
OG0024686	3	0	0	0	3
OG0024687	2	1	0	0	3
OG0024688	1	0	1	1	3
OG0024689	2	1	0	0	3
OG0024690	2	1	0	0	3
OG0024691	3	0	0	0	3
OG0024692	2	1	0	0	3
OG0024693	3	0	0	0	3
OG0024694	2	1	0	0	3
OG0024695	1	2	0	0	3
OG0024696	2	1	0	0	3
OG0024697	1	0	1	1	3
OG0024698	2	1	0	0	3
OG0024699	1	2	0	0	3
OG0024700	1	2	0	0	3
OG0024701	2	1	0	0	3
OG0024702	2	0	0	1	3
OG0024703	2	1	0	0	3
OG0024704	1	2	0	0	3
OG0024705	1	1	0	1	3
OG0024706	1	2	0	0	3
OG0024707	3	0	0	0	3
OG0024708	1	1	0	1	3
OG0024709	1	1	1	0	3
OG0024710	3	0	0	0	3
OG0024711	1	1	1	0	3
OG0024712	2	1	0	0	3
OG0024713	2	1	0	0	3
OG0024714	1	2	0	0	3
OG0024715	1	2	0	0	3
OG0024716	1	2	0	0	3
OG0024717	2	1	0	0	3
OG0024718	1	0	1	1	3
OG0024719	1	1	0	1	3
OG0024720	3	0	0	0	3
OG0024721	1	2	0	0	3
OG0024722	2	1	0	0	3
OG0024723	2	1	0	0	3
OG0024724	1	0	1	1	3
OG0024725	2	1	0	0	3
OG0024726	1	2	0	0	3
OG0024727	1	0	1	1	3
OG0024728	3	0	0	0	3
OG0024729	3	0	0	0	3
OG0024730	1	2	0	0	3
OG0024731	2	1	0	0	3
OG0024732	1	2	0	0	3
OG0024733	2	1	0	0	3
OG0024734	1	1	0	1	3
OG0024735	2	1	0	0	3
OG0024736	2	1	0	0	3
OG0024737	1	1	1	0	3
OG0024738	1	2	0	0	3
OG0024739	1	2	0	0	3
OG0024740	3	0	0	0	3
OG0024741	1	2	0	0	3
OG0024742	2	1	0	0	3
OG0024743	2	1	0	0	3
OG0024744	2	1	0	0	3
OG0024745	1	1	1	0	3
OG0024746	3	0	0	0	3
OG0024747	3	0	0	0	3
OG0024748	2	1	0	0	3
OG0024749	2	1	0	0	3
OG0024750	1	2	0	0	3
OG0024751	1	2	0	0	3
OG0024752	2	0	0	1	3
OG0024753	2	1	0	0	3
OG0024754	1	0	1	1	3
OG0024755	1	1	1	0	3
OG0024756	1	2	0	0	3
OG0024757	1	2	0	0	3
OG0024758	2	1	0	0	3
OG0024759	1	0	1	1	3
OG0024760	1	1	0	1	3
OG0024761	1	1	1	0	3
OG0024762	1	1	1	0	3
OG0024763	1	1	1	0	3
OG0024764	2	1	0	0	3
OG0024765	1	0	2	0	3
OG0024766	1	1	1	0	3
OG0024767	1	0	1	1	3
OG0024768	2	1	0	0	3
OG0024769	1	0	1	1	3
OG0024770	1	1	0	1	3
OG0024771	2	1	0	0	3
OG0024772	1	0	1	1	3
OG0024773	1	0	1	1	3
OG0024774	1	1	0	1	3
OG0024775	1	1	1	0	3
OG0024776	1	0	0	2	3
OG0024777	2	0	1	0	3
OG0024778	1	1	1	0	3
OG0024779	3	0	0	0	3
OG0024780	1	0	1	1	3
OG0024781	1	1	1	0	3
OG0024782	1	0	1	1	3
OG0024783	1	0	1	1	3
OG0024784	1	0	1	1	3
OG0024785	1	0	1	1	3
OG0024786	2	1	0	0	3
OG0024787	1	0	1	1	3
OG0024788	1	1	1	0	3
OG0024789	2	1	0	0	3
OG0024790	3	0	0	0	3
OG0024791	1	1	1	0	3
OG0024792	1	0	1	1	3
OG0024793	1	0	1	1	3
OG0024794	2	1	0	0	3
OG0024795	1	2	0	0	3
OG0024796	1	1	1	0	3
OG0024797	1	1	0	1	3
OG0024798	1	0	1	1	3
OG0024799	1	1	1	0	3
OG0024800	1	1	0	1	3
OG0024801	1	0	1	1	3
OG0024802	1	0	1	1	3
OG0024803	1	0	1	1	3
OG0024804	1	0	1	1	3
OG0024805	3	0	0	0	3
OG0024806	1	0	1	1	3
OG0024807	1	1	0	1	3
OG0024808	1	1	0	1	3
OG0024809	1	1	1	0	3
OG0024810	1	1	1	0	3
OG0024811	1	0	1	1	3
OG0024812	1	0	1	1	3
OG0024813	1	1	0	1	3
OG0024814	1	1	1	0	3
OG0024815	1	1	1	0	3
OG0024816	1	1	1	0	3
OG0024817	1	0	1	1	3
OG0024818	1	0	1	1	3
OG0024819	1	1	0	1	3
OG0024820	1	0	1	1	3
OG0024821	1	0	1	1	3
OG0024822	1	0	1	1	3
OG0024823	1	1	0	1	3
OG0024824	1	1	0	1	3
OG0024825	1	0	1	1	3
OG0024826	3	0	0	0	3
OG0024827	1	0	1	1	3
OG0024828	1	1	0	1	3
OG0024829	1	0	1	1	3
OG0024830	1	1	1	0	3
OG0024831	1	2	0	0	3
OG0024832	1	2	0	0	3
OG0024833	2	1	0	0	3
OG0024834	1	0	1	1	3
OG0024835	1	2	0	0	3
OG0024836	2	1	0	0	3
OG0024837	2	1	0	0	3
OG0024838	1	2	0	0	3
OG0024839	1	0	1	1	3
OG0024840	1	2	0	0	3
OG0024841	1	2	0	0	3
OG0024842	2	1	0	0	3
OG0024843	2	1	0	0	3
OG0024844	2	1	0	0	3
OG0024845	1	2	0	0	3
OG0024846	3	0	0	0	3
OG0024847	1	0	1	1	3
OG0024848	1	0	1	1	3
OG0024849	2	1	0	0	3
OG0024850	1	1	0	1	3
OG0024851	1	0	1	1	3
OG0024852	1	1	0	1	3
OG0024853	3	0	0	0	3
OG0024854	3	0	0	0	3
OG0024855	1	1	1	0	3
OG0024856	1	1	0	1	3
OG0024857	1	1	1	0	3
OG0024858	1	2	0	0	3
OG0024859	1	2	0	0	3
OG0024860	1	1	1	0	3
OG0024861	2	1	0	0	3
OG0024862	1	1	1	0	3
OG0024863	3	0	0	0	3
OG0024864	1	0	1	1	3
OG0024865	1	0	1	1	3
OG0024866	1	0	1	1	3
OG0024867	1	1	1	0	3
OG0024868	2	1	0	0	3
OG0024869	2	1	0	0	3
OG0024870	1	0	1	1	3
OG0024871	1	2	0	0	3
OG0024872	1	2	0	0	3
OG0024873	1	0	1	1	3
OG0024874	1	2	0	0	3
OG0024875	2	1	0	0	3
OG0024876	2	1	0	0	3
OG0024877	1	0	1	1	3
OG0024878	3	0	0	0	3
OG0024879	1	2	0	0	3
OG0024880	2	1	0	0	3
OG0024881	1	1	1	0	3
OG0024882	2	1	0	0	3
OG0024883	2	1	0	0	3
OG0024884	3	0	0	0	3
OG0024885	3	0	0	0	3
OG0024886	1	1	1	0	3
OG0024887	2	1	0	0	3
OG0024888	2	1	0	0	3
OG0024889	2	1	0	0	3
OG0024890	1	2	0	0	3
OG0024891	3	0	0	0	3
OG0024892	2	1	0	0	3
OG0024893	2	1	0	0	3
OG0024894	2	1	0	0	3
OG0024895	1	0	1	1	3
OG0024896	1	2	0	0	3
OG0024897	1	2	0	0	3
OG0024898	2	1	0	0	3
OG0024899	3	0	0	0	3
OG0024900	1	2	0	0	3
OG0024901	3	0	0	0	3
OG0024902	2	1	0	0	3
OG0024903	1	0	1	1	3
OG0024904	1	0	1	1	3
OG0024905	1	2	0	0	3
OG0024906	1	2	0	0	3
OG0024907	1	0	0	2	3
OG0024908	1	1	0	1	3
OG0024909	3	0	0	0	3
OG0024910	1	2	0	0	3
OG0024911	2	1	0	0	3
OG0024912	1	1	1	0	3
OG0024913	3	0	0	0	3
OG0024914	1	1	1	0	3
OG0024915	1	0	2	0	3
OG0024916	1	0	1	1	3
OG0024917	1	0	1	1	3
OG0024918	1	1	1	0	3
OG0024919	1	0	0	2	3
OG0024920	2	0	0	1	3
OG0024921	1	0	1	1	3
OG0024922	1	1	0	1	3
OG0024923	1	1	0	1	3
OG0024924	1	2	0	0	3
OG0024925	1	1	0	1	3
OG0024926	1	1	1	0	3
OG0024927	1	0	1	1	3
OG0024928	1	1	0	1	3
OG0024929	2	1	0	0	3
OG0024930	1	1	0	1	3
OG0024931	2	0	0	1	3
OG0024932	1	0	1	1	3
OG0024933	1	0	1	1	3
OG0024934	1	1	0	1	3
OG0024935	1	0	1	1	3
OG0024936	1	0	1	1	3
OG0024937	1	2	0	0	3
OG0024938	1	0	1	1	3
OG0024939	1	1	0	1	3
OG0024940	1	0	1	1	3
OG0024941	2	1	0	0	3
OG0024942	1	1	0	1	3
OG0024943	1	1	1	0	3
OG0024944	3	0	0	0	3
OG0024945	2	1	0	0	3
OG0024946	1	2	0	0	3
OG0024947	1	1	1	0	3
OG0024948	1	0	1	1	3
OG0024949	1	0	1	1	3
OG0024950	1	0	1	1	3
OG0024951	1	1	1	0	3
OG0024952	1	2	0	0	3
OG0024953	1	0	1	1	3
OG0024954	1	1	0	1	3
OG0024955	1	0	1	1	3
OG0024956	1	1	0	1	3
OG0024957	1	0	1	1	3
OG0024958	2	1	0	0	3
OG0024959	3	0	0	0	3
OG0024960	2	1	0	0	3
OG0024961	1	0	1	1	3
OG0024962	2	1	0	0	3
OG0024963	3	0	0	0	3
OG0024964	1	1	0	1	3
OG0024965	2	1	0	0	3
OG0024966	1	1	1	0	3
OG0024967	1	0	1	1	3
OG0024968	1	2	0	0	3
OG0024969	1	1	1	0	3
OG0024970	1	0	1	1	3
OG0024971	1	2	0	0	3
OG0024972	2	1	0	0	3
OG0024973	1	0	1	1	3
OG0024974	1	1	1	0	3
OG0024975	1	2	0	0	3
OG0024976	1	2	0	0	3
OG0024977	1	1	0	1	3
OG0024978	1	1	1	0	3
OG0024979	1	0	1	1	3
OG0024980	1	1	1	0	3
OG0024981	2	1	0	0	3
OG0024982	2	1	0	0	3
OG0024983	2	1	0	0	3
OG0024984	2	1	0	0	3
OG0024985	1	1	0	1	3
OG0024986	2	1	0	0	3
OG0024987	2	1	0	0	3
OG0024988	3	0	0	0	3
OG0024989	1	0	1	1	3
OG0024990	3	0	0	0	3
OG0024991	2	1	0	0	3
OG0024992	2	1	0	0	3
OG0024993	1	0	1	1	3
OG0024994	2	1	0	0	3
OG0024995	1	0	1	1	3
OG0024996	1	0	1	1	3
OG0024997	1	2	0	0	3
OG0024998	3	0	0	0	3
OG0024999	1	0	2	0	3
OG0025000	1	1	0	1	3
OG0025001	1	0	1	1	3
OG0025002	3	0	0	0	3
OG0025003	1	1	1	0	3
OG0025004	1	2	0	0	3
OG0025005	1	2	0	0	3
OG0025006	1	0	1	1	3
OG0025007	2	1	0	0	3
OG0025008	3	0	0	0	3
OG0025009	1	0	1	1	3
OG0025010	2	1	0	0	3
OG0025011	3	0	0	0	3
OG0025012	3	0	0	0	3
OG0025013	1	2	0	0	3
OG0025014	2	1	0	0	3
OG0025015	1	2	0	0	3
OG0025016	2	1	0	0	3
OG0025017	3	0	0	0	3
OG0025018	2	1	0	0	3
OG0025019	3	0	0	0	3
OG0025020	2	1	0	0	3
OG0025021	2	1	0	0	3
OG0025022	2	1	0	0	3
OG0025023	2	1	0	0	3
OG0025024	2	1	0	0	3
OG0025025	1	2	0	0	3
OG0025026	2	1	0	0	3
OG0025027	1	1	0	1	3
OG0025028	1	0	1	1	3
OG0025029	2	1	0	0	3
OG0025030	1	0	0	2	3
OG0025031	3	0	0	0	3
OG0025032	3	0	0	0	3
OG0025033	2	1	0	0	3
OG0025034	1	2	0	0	3
OG0025035	1	1	1	0	3
OG0025036	3	0	0	0	3
OG0025037	1	2	0	0	3
OG0025038	3	0	0	0	3
OG0025039	1	2	0	0	3
OG0025040	2	1	0	0	3
OG0025041	3	0	0	0	3
OG0025042	1	0	0	2	3
OG0025043	1	2	0	0	3
OG0025044	1	2	0	0	3
OG0025045	1	0	0	2	3
OG0025046	1	0	1	1	3
OG0025047	3	0	0	0	3
OG0025048	3	0	0	0	3
OG0025049	1	2	0	0	3
OG0025050	1	0	1	1	3
OG0025051	1	2	0	0	3
OG0025052	2	1	0	0	3
OG0025053	2	1	0	0	3
OG0025054	1	0	1	1	3
OG0025055	1	2	0	0	3
OG0025056	1	0	1	1	3
OG0025057	1	1	0	1	3
OG0025058	2	1	0	0	3
OG0025059	1	2	0	0	3
OG0025060	1	2	0	0	3
OG0025061	3	0	0	0	3
OG0025062	3	0	0	0	3
OG0025063	1	2	0	0	3
OG0025064	1	1	0	1	3
OG0025065	1	2	0	0	3
OG0025066	3	0	0	0	3
OG0025067	1	0	2	0	3
OG0025068	1	1	0	1	3
OG0025069	1	1	0	1	3
OG0025070	1	0	1	1	3
OG0025071	1	2	0	0	3
OG0025072	1	1	1	0	3
OG0025073	2	1	0	0	3
OG0025074	1	0	1	1	3
OG0025075	2	1	0	0	3
OG0025076	1	2	0	0	3
OG0025077	2	1	0	0	3
OG0025078	2	1	0	0	3
OG0025079	1	2	0	0	3
OG0025080	3	0	0	0	3
OG0025081	2	1	0	0	3
OG0025082	2	1	0	0	3
OG0025083	1	2	0	0	3
OG0025084	1	1	1	0	3
OG0025085	1	0	1	1	3
OG0025086	3	0	0	0	3
OG0025087	1	0	1	1	3
OG0025088	3	0	0	0	3
OG0025089	1	0	1	1	3
OG0025090	1	0	1	1	3
OG0025091	2	1	0	0	3
OG0025092	3	0	0	0	3
OG0025093	1	0	1	1	3
OG0025094	1	0	1	1	3
OG0025095	3	0	0	0	3
OG0025096	3	0	0	0	3
OG0025097	3	0	0	0	3
OG0025098	1	0	1	1	3
OG0025099	1	0	1	1	3
OG0025100	2	1	0	0	3
OG0025101	2	1	0	0	3
OG0025102	1	1	1	0	3
OG0025103	1	0	1	1	3
OG0025104	1	1	1	0	3
OG0025105	1	1	0	1	3
OG0025106	1	1	1	0	3
OG0025107	1	0	1	1	3
OG0025108	1	0	1	1	3
OG0025109	1	0	1	1	3
OG0025110	1	0	1	1	3
OG0025111	1	0	1	1	3
OG0025112	1	0	1	1	3
OG0025113	1	1	1	0	3
OG0025114	1	0	1	1	3
OG0025115	3	0	0	0	3
OG0025116	1	2	0	0	3
OG0025117	1	1	1	0	3
OG0025118	1	2	0	0	3
OG0025119	1	1	1	0	3
OG0025120	1	0	1	1	3
OG0025121	3	0	0	0	3
OG0025122	1	1	0	1	3
OG0025123	1	0	1	1	3
OG0025124	1	0	1	1	3
OG0025125	1	0	1	1	3
OG0025126	1	0	1	1	3
OG0025127	1	0	1	1	3
OG0025128	1	0	1	1	3
OG0025129	1	1	0	1	3
OG0025130	1	0	1	1	3
OG0025131	1	1	1	0	3
OG0025132	2	1	0	0	3
OG0025133	1	0	1	1	3
OG0025134	1	0	1	1	3
OG0025135	1	0	1	1	3
OG0025136	1	0	0	2	3
OG0025137	2	1	0	0	3
OG0025138	1	0	1	1	3
OG0025139	1	0	2	0	3
OG0025140	1	0	1	1	3
OG0025141	1	0	1	1	3
OG0025142	3	0	0	0	3
OG0025143	1	0	1	1	3
OG0025144	1	2	0	0	3
OG0025145	1	0	0	2	3
OG0025146	1	1	0	1	3
OG0025147	1	1	0	1	3
OG0025148	1	1	1	0	3
OG0025149	2	1	0	0	3
OG0025150	1	1	1	0	3
OG0025151	1	0	1	1	3
OG0025152	1	2	0	0	3
OG0025153	1	1	0	1	3
OG0025154	1	0	2	0	3
OG0025155	1	0	1	1	3
OG0025156	1	1	1	0	3
OG0025157	1	0	2	0	3
OG0025158	1	0	1	1	3
OG0025159	1	0	0	2	3
OG0025160	1	0	1	1	3
OG0025161	1	0	1	1	3
OG0025162	1	0	1	1	3
OG0025163	1	1	1	0	3
OG0025164	1	1	0	1	3
OG0025165	1	1	0	1	3
OG0025166	1	0	1	1	3
OG0025167	1	0	1	1	3
OG0025168	1	1	1	0	3
OG0025169	1	1	1	0	3
OG0025170	1	0	1	1	3
OG0025171	1	1	0	1	3
OG0025172	1	0	1	1	3
OG0025173	1	0	1	1	3
OG0025174	1	0	1	1	3
OG0025175	2	1	0	0	3
OG0025176	1	0	1	1	3
OG0025177	1	0	1	1	3
OG0025178	1	1	0	1	3
OG0025179	1	1	0	1	3
OG0025180	1	0	1	1	3
OG0025181	1	1	0	1	3
OG0025182	2	1	0	0	3
OG0025183	1	0	1	1	3
OG0025184	3	0	0	0	3
OG0025185	1	1	1	0	3
OG0025186	1	0	1	1	3
OG0025187	1	0	1	1	3
OG0025188	1	0	1	1	3
OG0025189	1	1	0	1	3
OG0025190	2	1	0	0	3
OG0025191	1	0	1	1	3
OG0025192	2	1	0	0	3
OG0025193	1	0	1	1	3
OG0025194	2	1	0	0	3
OG0025195	1	2	0	0	3
OG0025196	1	2	0	0	3
OG0025197	1	1	0	1	3
OG0025198	1	0	1	1	3
OG0025199	3	0	0	0	3
OG0025200	2	1	0	0	3
OG0025201	1	1	0	1	3
OG0025202	1	1	0	1	3
OG0025203	1	2	0	0	3
OG0025204	2	0	1	0	3
OG0025205	2	1	0	0	3
OG0025206	1	0	1	1	3
OG0025207	1	0	1	1	3
OG0025208	2	1	0	0	3
OG0025209	1	1	1	0	3
OG0025210	1	0	1	1	3
OG0025211	1	2	0	0	3
OG0025212	1	2	0	0	3
OG0025213	1	1	0	1	3
OG0025214	1	1	0	1	3
OG0025215	1	0	1	1	3
OG0025216	2	1	0	0	3
OG0025217	1	1	0	1	3
OG0025218	1	1	0	1	3
OG0025219	1	0	1	1	3
OG0025220	1	2	0	0	3
OG0025221	2	1	0	0	3
OG0025222	2	1	0	0	3
OG0025223	1	2	0	0	3
OG0025224	1	2	0	0	3
OG0025225	1	1	0	1	3
OG0025226	1	2	0	0	3
OG0025227	1	2	0	0	3
OG0025228	1	1	0	1	3
OG0025229	3	0	0	0	3
OG0025230	2	1	0	0	3
OG0025231	2	1	0	0	3
OG0025232	2	1	0	0	3
OG0025233	2	1	0	0	3
OG0025234	3	0	0	0	3
OG0025235	2	1	0	0	3
OG0025236	1	2	0	0	3
OG0025237	1	2	0	0	3
OG0025238	2	1	0	0	3
OG0025239	1	1	0	1	3
OG0025240	3	0	0	0	3
OG0025241	3	0	0	0	3
OG0025242	1	1	1	0	3
OG0025243	1	1	1	0	3
OG0025244	1	2	0	0	3
OG0025245	3	0	0	0	3
OG0025246	3	0	0	0	3
OG0025247	1	1	1	0	3
OG0025248	2	1	0	0	3
OG0025249	2	1	0	0	3
OG0025250	3	0	0	0	3
OG0025251	2	1	0	0	3
OG0025252	2	1	0	0	3
OG0025253	1	2	0	0	3
OG0025254	1	2	0	0	3
OG0025255	2	1	0	0	3
OG0025256	1	0	1	1	3
OG0025257	2	1	0	0	3
OG0025258	1	1	0	1	3
OG0025259	1	0	1	1	3
OG0025260	3	0	0	0	3
OG0025261	1	2	0	0	3
OG0025262	1	1	0	1	3
OG0025263	1	2	0	0	3
OG0025264	1	0	1	1	3
OG0025265	2	0	1	0	3
OG0025266	3	0	0	0	3
OG0025267	2	1	0	0	3
OG0025268	2	0	0	1	3
OG0025269	3	0	0	0	3
OG0025270	2	1	0	0	3
OG0025271	1	2	0	0	3
OG0025272	1	2	0	0	3
OG0025273	1	1	1	0	3
OG0025274	2	1	0	0	3
OG0025275	3	0	0	0	3
OG0025276	2	1	0	0	3
OG0025277	1	2	0	0	3
OG0025278	2	1	0	0	3
OG0025279	2	1	0	0	3
OG0025280	2	1	0	0	3
OG0025281	2	0	1	0	3
OG0025282	2	1	0	0	3
OG0025283	1	1	1	0	3
OG0025284	2	1	0	0	3
OG0025285	3	0	0	0	3
OG0025286	1	1	0	1	3
OG0025287	1	0	1	1	3
OG0025288	1	0	1	1	3
OG0025289	1	0	1	1	3
OG0025290	1	0	1	1	3
OG0025291	1	1	1	0	3
OG0025292	1	1	1	0	3
OG0025293	1	1	1	0	3
OG0025294	1	1	0	1	3
OG0025295	1	1	0	1	3
OG0025296	1	1	0	1	3
OG0025297	1	1	1	0	3
OG0025298	2	1	0	0	3
OG0025299	1	1	1	0	3
OG0025300	1	1	1	0	3
OG0025301	1	1	1	0	3
OG0025302	1	1	0	1	3
OG0025303	2	1	0	0	3
OG0025304	1	0	1	1	3
OG0025305	3	0	0	0	3
OG0025306	1	1	1	0	3
OG0025307	2	1	0	0	3
OG0025308	1	0	1	1	3
OG0025309	1	1	1	0	3
OG0025310	1	1	1	0	3
OG0025311	1	1	0	1	3
OG0025312	1	0	1	1	3
OG0025313	1	0	1	1	3
OG0025314	1	0	1	1	3
OG0025315	1	1	0	1	3
OG0025316	1	2	0	0	3
OG0025317	1	1	1	0	3
OG0025318	3	0	0	0	3
OG0025319	1	2	0	0	3
OG0025320	2	0	1	0	3
OG0025321	1	1	0	1	3
OG0025322	1	0	1	1	3
OG0025323	1	1	0	1	3
OG0025324	2	1	0	0	3
OG0025325	2	1	0	0	3
OG0025326	1	1	0	1	3
OG0025327	2	1	0	0	3
OG0025328	1	0	1	1	3
OG0025329	1	2	0	0	3
OG0025330	3	0	0	0	3
OG0025331	1	1	0	1	3
OG0025332	2	1	0	0	3
OG0025333	2	1	0	0	3
OG0025334	1	1	1	0	3
OG0025335	1	1	0	1	3
OG0025336	1	2	0	0	3
OG0025337	1	0	1	1	3
OG0025338	2	1	0	0	3
OG0025339	1	0	1	1	3
OG0025340	2	1	0	0	3
OG0025341	1	0	1	1	3
OG0025342	3	0	0	0	3
OG0025343	3	0	0	0	3
OG0025344	1	2	0	0	3
OG0025345	1	2	0	0	3
OG0025346	1	2	0	0	3
OG0025347	1	0	1	1	3
OG0025348	2	1	0	0	3
OG0025349	2	1	0	0	3
OG0025350	2	1	0	0	3
OG0025351	1	2	0	0	3
OG0025352	1	0	1	1	3
OG0025353	2	1	0	0	3
OG0025354	2	1	0	0	3
OG0025355	1	2	0	0	3
OG0025356	3	0	0	0	3
OG0025357	2	1	0	0	3
OG0025358	2	1	0	0	3
OG0025359	1	1	0	1	3
OG0025360	1	2	0	0	3
OG0025361	1	2	0	0	3
OG0025362	1	1	1	0	3
OG0025363	1	2	0	0	3
OG0025364	2	1	0	0	3
OG0025365	1	0	1	1	3
OG0025366	1	1	0	1	3
OG0025367	1	2	0	0	3
OG0025368	3	0	0	0	3
OG0025369	2	1	0	0	3
OG0025370	2	1	0	0	3
OG0025371	1	1	1	0	3
OG0025372	1	1	1	0	3
OG0025373	3	0	0	0	3
OG0025374	3	0	0	0	3
OG0025375	1	2	0	0	3
OG0025376	1	0	1	1	3
OG0025377	1	2	0	0	3
OG0025378	1	1	0	1	3
OG0025379	1	0	1	1	3
OG0025380	1	1	1	0	3
OG0025381	1	0	1	1	3
OG0025382	1	1	1	0	3
OG0025383	1	0	1	1	3
OG0025384	1	2	0	0	3
OG0025385	2	0	0	1	3
OG0025386	1	1	0	1	3
OG0025387	1	2	0	0	3
OG0025388	1	0	1	1	3
OG0025389	1	2	0	0	3
OG0025390	1	2	0	0	3
OG0025391	2	1	0	0	3
OG0025392	2	1	0	0	3
OG0025393	1	0	1	1	3
OG0025394	1	0	1	1	3
OG0025395	3	0	0	0	3
OG0025396	1	1	0	1	3
OG0025397	2	1	0	0	3
OG0025398	1	2	0	0	3
OG0025399	1	1	1	0	3
OG0025400	1	1	1	0	3
OG0025401	1	0	0	2	3
OG0025402	2	1	0	0	3
OG0025403	2	1	0	0	3
OG0025404	1	1	1	0	3
OG0025405	2	1	0	0	3
OG0025406	1	0	1	1	3
OG0025407	1	0	1	1	3
OG0025408	1	1	1	0	3
OG0025409	1	1	0	1	3
OG0025410	1	0	1	1	3
OG0025411	1	0	1	1	3
OG0025412	1	2	0	0	3
OG0025413	1	1	1	0	3
OG0025414	1	0	2	0	3
OG0025415	3	0	0	0	3
OG0025416	1	1	0	1	3
OG0025417	1	0	0	2	3
OG0025418	1	1	0	1	3
OG0025419	1	1	1	0	3
OG0025420	2	1	0	0	3
OG0025421	1	1	0	1	3
OG0025422	1	0	1	1	3
OG0025423	1	1	0	1	3
OG0025424	1	1	0	1	3
OG0025425	1	0	1	1	3
OG0025426	1	0	1	1	3
OG0025427	1	2	0	0	3
OG0025428	1	0	1	1	3
OG0025429	1	0	1	1	3
OG0025430	1	1	0	1	3
OG0025431	1	1	0	1	3
OG0025432	1	0	1	1	3
OG0025433	1	0	1	1	3
OG0025434	3	0	0	0	3
OG0025435	3	0	0	0	3
OG0025436	1	0	1	1	3
OG0025437	1	0	1	1	3
OG0025438	1	0	1	1	3
OG0025439	1	1	0	1	3
OG0025440	1	2	0	0	3
OG0025441	2	1	0	0	3
OG0025442	1	0	1	1	3
OG0025443	1	1	0	1	3
OG0025444	1	1	0	1	3
OG0025445	1	0	1	1	3
OG0025446	1	2	0	0	3
OG0025447	1	1	1	0	3
OG0025448	1	0	1	1	3
OG0025449	1	0	1	1	3
OG0025450	1	1	1	0	3
OG0025451	3	0	0	0	3
OG0025452	2	1	0	0	3
OG0025453	1	0	1	1	3
OG0025454	1	1	0	1	3
OG0025455	1	1	0	1	3
OG0025456	1	1	1	0	3
OG0025457	1	1	1	0	3
OG0025458	1	1	0	1	3
OG0025459	1	1	0	1	3
OG0025460	1	0	1	1	3
OG0025461	1	0	0	2	3
OG0025462	1	0	1	1	3
OG0025463	2	1	0	0	3
OG0025464	3	0	0	0	3
OG0025465	1	1	1	0	3
OG0025466	1	1	0	1	3
OG0025467	2	1	0	0	3
OG0025468	1	2	0	0	3
OG0025469	1	0	1	1	3
OG0025470	1	1	1	0	3
OG0025471	1	1	0	1	3
OG0025472	2	1	0	0	3
OG0025473	1	0	1	1	3
OG0025474	1	1	1	0	3
OG0025475	1	0	1	1	3
OG0025476	1	0	1	1	3
OG0025477	2	1	0	0	3
OG0025478	1	1	0	1	3
OG0025479	1	0	1	1	3
OG0025480	1	0	1	1	3
OG0025481	1	1	1	0	3
OG0025482	1	0	1	1	3
OG0025483	1	1	0	1	3
OG0025484	1	0	1	1	3
OG0025485	1	1	1	0	3
OG0025486	1	1	1	0	3
OG0025487	2	1	0	0	3
OG0025488	1	1	0	1	3
OG0025489	2	1	0	0	3
OG0025490	1	1	1	0	3
OG0025491	2	1	0	0	3
OG0025492	1	0	1	1	3
OG0025493	1	1	0	1	3
OG0025494	1	1	0	1	3
OG0025495	1	1	1	0	3
OG0025496	2	1	0	0	3
OG0025497	2	1	0	0	3
OG0025498	1	0	1	1	3
OG0025499	1	1	1	0	3
OG0025500	1	1	0	1	3
OG0025501	1	2	0	0	3
OG0025502	1	0	1	1	3
OG0025503	2	1	0	0	3
OG0025504	3	0	0	0	3
OG0025505	2	1	0	0	3
OG0025506	1	1	0	1	3
OG0025507	1	0	1	1	3
OG0025508	2	0	1	0	3
OG0025509	1	0	1	1	3
OG0025510	3	0	0	0	3
OG0025511	2	1	0	0	3
OG0025512	1	2	0	0	3
OG0025513	1	0	1	1	3
OG0025514	3	0	0	0	3
OG0025515	2	1	0	0	3
OG0025516	2	1	0	0	3
OG0025517	2	1	0	0	3
OG0025518	1	1	1	0	3
OG0025519	1	2	0	0	3
OG0025520	1	0	1	1	3
OG0025521	2	1	0	0	3
OG0025522	1	0	1	1	3
OG0025523	1	0	1	1	3
OG0025524	1	0	1	1	3
OG0025525	1	1	0	1	3
OG0025526	1	0	1	1	3
OG0025527	3	0	0	0	3
OG0025528	2	1	0	0	3
OG0025529	3	0	0	0	3
OG0025530	2	1	0	0	3
OG0025531	3	0	0	0	3
OG0025532	3	0	0	0	3
OG0025533	3	0	0	0	3
OG0025534	1	0	1	1	3
OG0025535	1	1	1	0	3
OG0025536	3	0	0	0	3
OG0025537	1	0	1	1	3
OG0025538	1	0	1	1	3
OG0025539	1	1	1	0	3
OG0025540	1	1	0	1	3
OG0025541	1	0	1	1	3
OG0025542	1	0	1	1	3
OG0025543	1	0	1	1	3
OG0025544	1	0	1	1	3
OG0025545	1	0	1	1	3
OG0025546	1	0	1	1	3
OG0025547	1	0	1	1	3
OG0025548	2	1	0	0	3
OG0025549	1	0	1	1	3
OG0025550	1	0	1	1	3
OG0025551	1	1	0	1	3
OG0025552	1	1	0	1	3
OG0025553	1	0	1	1	3
OG0025554	1	0	1	1	3
OG0025555	1	1	1	0	3
OG0025556	2	1	0	0	3
OG0025557	1	0	1	1	3
OG0025558	1	0	1	1	3
OG0025559	1	1	0	1	3
OG0025560	1	0	2	0	3
OG0025561	1	2	0	0	3
OG0025562	1	0	1	1	3
OG0025563	3	0	0	0	3
OG0025564	1	1	0	1	3
OG0025565	1	0	1	1	3
OG0025566	2	1	0	0	3
OG0025567	1	1	1	0	3
OG0025568	1	1	0	1	3
OG0025569	1	2	0	0	3
OG0025570	2	1	0	0	3
OG0025571	1	1	0	1	3
OG0025572	2	0	1	0	3
OG0025573	1	0	1	1	3
OG0025574	1	2	0	0	3
OG0025575	1	1	1	0	3
OG0025576	1	1	0	1	3
OG0025577	1	0	1	1	3
OG0025578	1	0	1	1	3
OG0025579	1	2	0	0	3
OG0025580	1	2	0	0	3
OG0025581	1	1	0	1	3
OG0025582	1	0	1	1	3
OG0025583	1	1	0	1	3
OG0025584	1	0	1	1	3
OG0025585	1	0	1	1	3
OG0025586	2	1	0	0	3
OG0025587	1	1	1	0	3
OG0025588	1	2	0	0	3
OG0025589	1	0	1	1	3
OG0025590	1	0	1	1	3
OG0025591	2	1	0	0	3
OG0025592	1	0	1	1	3
OG0025593	1	2	0	0	3
OG0025594	1	2	0	0	3
OG0025595	2	1	0	0	3
OG0025596	2	1	0	0	3
OG0025597	2	1	0	0	3
OG0025598	2	1	0	0	3
OG0025599	1	2	0	0	3
OG0025600	1	0	1	1	3
OG0025601	1	2	0	0	3
OG0025602	1	0	1	1	3
OG0025603	1	1	1	0	3
OG0025604	3	0	0	0	3
OG0025605	1	1	0	1	3
OG0025606	2	1	0	0	3
OG0025607	1	2	0	0	3
OG0025608	2	1	0	0	3
OG0025609	1	0	1	1	3
OG0025610	1	1	1	0	3
OG0025611	1	2	0	0	3
OG0025612	1	1	1	0	3
OG0025613	1	0	1	1	3
OG0025614	1	0	1	1	3
OG0025615	1	1	1	0	3
OG0025616	1	1	1	0	3
OG0025617	1	1	0	1	3
OG0025618	1	0	1	1	3
OG0025619	1	2	0	0	3
OG0025620	1	2	0	0	3
OG0025621	1	1	0	1	3
OG0025622	1	0	1	1	3
OG0025623	2	1	0	0	3
OG0025624	3	0	0	0	3
OG0025625	1	1	0	1	3
OG0025626	2	1	0	0	3
OG0025627	1	1	0	1	3
OG0025628	1	0	1	1	3
OG0025629	1	1	0	1	3
OG0025630	1	1	1	0	3
OG0025631	1	0	1	1	3
OG0025632	1	2	0	0	3
OG0025633	1	0	1	1	3
OG0025634	2	1	0	0	3
OG0025635	1	0	1	1	3
OG0025636	1	0	1	1	3
OG0025637	2	1	0	0	3
OG0025638	1	1	0	1	3
OG0025639	1	0	1	1	3
OG0025640	2	1	0	0	3
OG0025641	1	0	1	1	3
OG0025642	1	0	1	1	3
OG0025643	1	1	1	0	3
OG0025644	1	0	1	1	3
OG0025645	1	0	1	1	3
OG0025646	1	1	1	0	3
OG0025647	2	1	0	0	3
OG0025648	2	0	0	1	3
OG0025649	1	0	1	1	3
OG0025650	1	0	1	1	3
OG0025651	1	0	1	1	3
OG0025652	1	1	0	1	3
OG0025653	1	1	1	0	3
OG0025654	1	0	1	1	3
OG0025655	1	1	0	1	3
OG0025656	1	0	1	1	3
OG0025657	1	1	1	0	3
OG0025658	1	1	1	0	3
OG0025659	2	1	0	0	3
OG0025660	1	0	1	1	3
OG0025661	1	0	1	1	3
OG0025662	1	1	1	0	3
OG0025663	1	0	1	1	3
OG0025664	3	0	0	0	3
OG0025665	1	1	1	0	3
OG0025666	1	1	0	1	3
OG0025667	1	0	1	1	3
OG0025668	1	1	1	0	3
OG0025669	1	0	1	1	3
OG0025670	1	0	1	1	3
OG0025671	1	0	2	0	3
OG0025672	1	0	1	1	3
OG0025673	1	0	1	1	3
OG0025674	2	1	0	0	3
OG0025675	1	0	1	1	3
OG0025676	1	2	0	0	3
OG0025677	1	1	1	0	3
OG0025678	1	0	1	1	3
OG0025679	1	1	1	0	3
OG0025680	1	0	1	1	3
OG0025681	1	2	0	0	3
OG0025682	1	0	1	1	3
OG0025683	3	0	0	0	3
OG0025684	1	1	0	1	3
OG0025685	1	0	1	1	3
OG0025686	1	1	0	1	3
OG0025687	1	1	1	0	3
OG0025688	1	1	0	1	3
OG0025689	1	2	0	0	3
OG0025690	1	0	1	1	3
OG0025691	2	0	1	0	3
OG0025692	2	1	0	0	3
OG0025693	1	1	1	0	3
OG0025694	3	0	0	0	3
OG0025695	2	1	0	0	3
OG0025696	2	1	0	0	3
OG0025697	1	0	1	1	3
OG0025698	1	2	0	0	3
OG0025699	1	1	1	0	3
OG0025700	1	0	1	1	3
OG0025701	1	2	0	0	3
OG0025702	1	0	2	0	3
OG0025703	1	2	0	0	3
OG0025704	1	2	0	0	3
OG0025705	1	2	0	0	3
OG0025706	1	1	1	0	3
OG0025707	1	2	0	0	3
OG0025708	2	1	0	0	3
OG0025709	1	2	0	0	3
OG0025710	1	0	1	1	3
OG0025711	1	2	0	0	3
OG0025712	1	1	0	1	3
OG0025713	1	0	1	1	3
OG0025714	2	1	0	0	3
OG0025715	1	1	1	0	3
OG0025716	1	0	1	1	3
OG0025717	1	0	1	1	3
OG0025718	1	0	1	1	3
OG0025719	1	1	0	1	3
OG0025720	1	0	1	1	3
OG0025721	1	2	0	0	3
OG0025722	1	0	1	1	3
OG0025723	1	1	1	0	3
OG0025724	1	1	1	0	3
OG0025725	2	1	0	0	3
OG0025726	3	0	0	0	3
OG0025727	1	0	1	1	3
OG0025728	1	1	1	0	3
OG0025729	1	0	1	1	3
OG0025730	3	0	0	0	3
OG0025731	1	1	1	0	3
OG0025732	2	1	0	0	3
OG0025733	1	0	0	2	3
OG0025734	1	0	1	1	3
OG0025735	1	0	1	1	3
OG0025736	3	0	0	0	3
OG0025737	1	2	0	0	3
OG0025738	1	1	0	1	3
OG0025739	1	1	0	1	3
OG0025740	1	0	0	2	3
OG0025741	2	1	0	0	3
OG0025742	1	0	1	1	3
OG0025743	1	1	0	1	3
OG0025744	1	0	1	1	3
OG0025745	1	1	1	0	3
OG0025746	1	1	0	1	3
OG0025747	1	0	1	1	3
OG0025748	1	0	1	1	3
OG0025749	1	1	1	0	3
OG0025750	2	1	0	0	3
OG0025751	1	0	1	1	3
OG0025752	1	0	1	1	3
OG0025753	1	0	1	1	3
OG0025754	1	1	0	1	3
OG0025755	1	0	1	1	3
OG0025756	2	1	0	0	3
OG0025757	1	1	0	1	3
OG0025758	1	0	1	1	3
OG0025759	1	1	1	0	3
OG0025760	2	1	0	0	3
OG0025761	1	0	2	0	3
OG0025762	1	1	0	1	3
OG0025763	1	0	1	1	3
OG0025764	1	0	1	1	3
OG0025765	1	0	1	1	3
OG0025766	1	1	1	0	3
OG0025767	1	0	1	1	3
OG0025768	1	1	1	0	3
OG0025769	1	1	1	0	3
OG0025770	2	1	0	0	3
OG0025771	1	1	1	0	3
OG0025772	1	0	1	1	3
OG0025773	1	1	0	1	3
OG0025774	1	1	1	0	3
OG0025775	1	0	1	1	3
OG0025776	1	1	1	0	3
OG0025777	1	0	1	1	3
OG0025778	1	1	0	1	3
OG0025779	1	0	0	2	3
OG0025780	1	0	1	1	3
OG0025781	1	0	1	1	3
OG0025782	2	1	0	0	3
OG0025783	1	0	1	1	3
OG0025784	1	0	1	1	3
OG0025785	1	0	1	1	3
OG0025786	1	1	0	1	3
OG0025787	1	1	0	1	3
OG0025788	1	0	1	1	3
OG0025789	1	0	1	1	3
OG0025790	1	1	0	1	3
OG0025791	1	0	1	1	3
OG0025792	2	1	0	0	3
OG0025793	1	0	1	1	3
OG0025794	1	0	1	1	3
OG0025795	1	1	0	1	3
OG0025796	1	1	0	1	3
OG0025797	1	1	1	0	3
OG0025798	1	0	1	1	3
OG0025799	1	1	1	0	3
OG0025800	1	0	1	1	3
OG0025801	1	0	1	1	3
OG0025802	1	1	0	1	3
OG0025803	2	1	0	0	3
OG0025804	1	1	1	0	3
OG0025805	1	0	1	1	3
OG0025806	1	0	1	1	3
OG0025807	1	0	1	1	3
OG0025808	1	1	0	1	3
OG0025809	1	1	1	0	3
OG0025810	1	0	1	1	3
OG0025811	1	0	0	2	3
OG0025812	1	1	1	0	3
OG0025813	1	1	0	1	3
OG0025814	1	1	0	1	3
OG0025815	1	1	0	1	3
OG0025816	2	1	0	0	3
OG0025817	1	1	0	1	3
OG0025818	1	0	1	1	3
OG0025819	1	0	1	1	3
OG0025820	1	1	0	1	3
OG0025821	1	1	0	1	3
OG0025822	1	1	0	1	3
OG0025823	1	0	1	1	3
OG0025824	1	0	1	1	3
OG0025825	1	1	1	0	3
OG0025826	1	1	1	0	3
OG0025827	1	1	1	0	3
OG0025828	1	1	1	0	3
OG0025829	1	1	1	0	3
OG0025830	2	1	0	0	3
OG0025831	1	1	0	1	3
OG0025832	1	1	0	1	3
OG0025833	1	0	1	1	3
OG0025834	1	0	1	1	3
OG0025835	1	1	0	1	3
OG0025836	2	1	0	0	3
OG0025837	1	1	0	1	3
OG0025838	1	1	0	1	3
OG0025839	1	1	0	1	3
OG0025840	1	0	1	1	3
OG0025841	1	0	1	1	3
OG0025842	1	1	1	0	3
OG0025843	1	1	0	1	3
OG0025844	1	0	1	1	3
OG0025845	1	0	1	1	3
OG0025846	1	0	1	1	3
OG0025847	1	1	0	1	3
OG0025848	1	2	0	0	3
OG0025849	1	1	1	0	3
OG0025850	1	0	1	1	3
OG0025851	1	0	1	1	3
OG0025852	1	1	0	1	3
OG0025853	1	1	1	0	3
OG0025854	2	1	0	0	3
OG0025855	1	1	0	1	3
OG0025856	1	0	1	1	3
OG0025857	1	0	1	1	3
OG0025858	1	0	1	1	3
OG0025859	1	0	1	1	3
OG0025860	1	1	0	1	3
OG0025861	1	2	0	0	3
OG0025862	1	1	1	0	3
OG0025863	1	0	1	1	3
OG0025864	1	0	1	1	3
OG0025865	1	0	1	1	3
OG0025866	1	0	1	1	3
OG0025867	1	0	1	1	3
OG0025868	1	1	1	0	3
OG0025869	1	0	0	2	3
OG0025870	1	1	0	1	3
OG0025871	1	1	1	0	3
OG0025872	1	0	1	1	3
OG0025873	2	1	0	0	3
OG0025874	1	0	1	1	3
OG0025875	1	2	0	0	3
OG0025876	1	0	1	1	3
OG0025877	1	1	0	1	3
OG0025878	1	1	0	1	3
OG0025879	1	1	0	1	3
OG0025880	1	1	1	0	3
OG0025881	1	1	0	1	3
OG0025882	1	2	0	0	3
OG0025883	1	0	1	1	3
OG0025884	1	1	1	0	3
OG0025885	1	0	2	0	3
OG0025886	1	1	0	1	3
OG0025887	2	1	0	0	3
OG0025888	1	2	0	0	3
OG0025889	1	1	0	1	3
OG0025890	1	0	1	1	3
OG0025891	1	2	0	0	3
OG0025892	1	1	0	1	3
OG0025893	1	0	0	2	3
OG0025894	1	0	1	1	3
OG0025895	2	0	0	1	3
OG0025896	1	0	1	1	3
OG0025897	1	2	0	0	3
OG0025898	1	1	1	0	3
OG0025899	1	1	0	1	3
OG0025900	1	1	0	1	3
OG0025901	1	1	0	1	3
OG0025902	3	0	0	0	3
OG0025903	1	0	1	1	3
OG0025904	1	2	0	0	3
OG0025905	3	0	0	0	3
OG0025906	2	1	0	0	3
OG0025907	1	2	0	0	3
OG0025908	1	1	1	0	3
OG0025909	1	0	1	1	3
OG0025910	1	2	0	0	3
OG0025911	2	1	0	0	3
OG0025912	1	0	1	1	3
OG0025913	1	0	1	1	3
OG0025914	1	2	0	0	3
OG0025915	2	1	0	0	3
OG0025916	1	2	0	0	3
OG0025917	1	2	0	0	3
OG0025918	2	1	0	0	3
OG0025919	2	1	0	0	3
OG0025920	2	1	0	0	3
OG0025921	3	0	0	0	3
OG0025922	1	2	0	0	3
OG0025923	2	1	0	0	3
OG0025924	1	0	1	1	3
OG0025925	1	1	0	1	3
OG0025926	2	1	0	0	3
OG0025927	1	1	1	0	3
OG0025928	2	1	0	0	3
OG0025929	1	0	1	1	3
OG0025930	2	1	0	0	3
OG0025931	2	1	0	0	3
OG0025932	1	2	0	0	3
OG0025933	1	2	0	0	3
OG0025934	2	1	0	0	3
OG0025935	1	0	1	1	3
OG0025936	1	0	1	1	3
OG0025937	1	1	0	1	3
OG0025938	1	0	1	1	3
OG0025939	1	1	0	1	3
OG0025940	1	1	1	0	3
OG0025941	1	0	1	1	3
OG0025942	2	1	0	0	3
OG0025943	1	1	0	1	3
OG0025944	1	1	0	1	3
OG0025945	1	2	0	0	3
OG0025946	1	2	0	0	3
OG0025947	1	1	1	0	3
OG0025948	1	1	0	1	3
OG0025949	1	0	1	1	3
OG0025950	2	1	0	0	3
OG0025951	1	0	1	1	3
OG0025952	1	0	1	1	3
OG0025953	1	0	1	1	3
OG0025954	1	1	1	0	3
OG0025955	1	1	0	1	3
OG0025956	1	0	0	2	3
OG0025957	3	0	0	0	3
OG0025958	1	1	0	1	3
OG0025959	1	0	1	1	3
OG0025960	1	0	1	1	3
OG0025961	1	1	1	0	3
OG0025962	1	1	1	0	3
OG0025963	1	1	0	1	3
OG0025964	1	1	1	0	3
OG0025965	1	1	0	1	3
OG0025966	1	0	1	1	3
OG0025967	1	0	1	1	3
OG0025968	1	1	1	0	3
OG0025969	1	0	1	1	3
OG0025970	1	0	1	1	3
OG0025971	1	0	1	1	3
OG0025972	2	1	0	0	3
OG0025973	2	1	0	0	3
OG0025974	1	1	0	1	3
OG0025975	2	0	0	1	3
OG0025976	1	0	1	1	3
OG0025977	1	0	1	1	3
OG0025978	1	0	1	1	3
OG0025979	1	1	1	0	3
OG0025980	1	0	1	1	3
OG0025981	1	0	1	1	3
OG0025982	1	0	1	1	3
OG0025983	1	0	1	1	3
OG0025984	1	0	1	1	3
OG0025985	1	1	1	0	3
OG0025986	1	0	1	1	3
OG0025987	1	2	0	0	3
OG0025988	1	2	0	0	3
OG0025989	1	1	1	0	3
OG0025990	1	1	0	1	3
OG0025991	2	0	1	0	3
OG0025992	1	0	1	1	3
OG0025993	1	0	1	1	3
OG0025994	1	0	1	1	3
OG0025995	2	1	0	0	3
OG0025996	1	2	0	0	3
OG0025997	2	1	0	0	3
OG0025998	1	1	1	0	3
OG0025999	3	0	0	0	3
OG0026000	1	0	1	1	3
OG0026001	3	0	0	0	3
OG0026002	1	0	1	1	3
OG0026003	1	0	1	1	3
OG0026004	1	2	0	0	3
OG0026005	1	0	1	1	3
OG0026006	2	1	0	0	3
OG0026007	1	0	1	1	3
OG0026008	1	1	0	1	3
OG0026009	2	1	0	0	3
OG0026010	1	0	1	1	3
OG0026011	1	0	1	1	3
OG0026012	2	1	0	0	3
OG0026013	3	0	0	0	3
OG0026014	1	2	0	0	3
OG0026015	1	2	0	0	3
OG0026016	2	1	0	0	3
OG0026017	1	0	1	1	3
OG0026018	2	1	0	0	3
OG0026019	2	1	0	0	3
OG0026020	3	0	0	0	3
OG0026021	2	1	0	0	3
OG0026022	1	2	0	0	3
OG0026023	2	1	0	0	3
OG0026024	3	0	0	0	3
OG0026025	1	1	0	1	3
OG0026026	1	0	0	2	3
OG0026027	1	0	1	1	3
OG0026028	1	1	0	1	3
OG0026029	1	1	1	0	3
OG0026030	2	1	0	0	3
OG0026031	1	0	1	1	3
OG0026032	1	0	1	1	3
OG0026033	1	0	1	1	3
OG0026034	1	1	1	0	3
OG0026035	1	0	1	1	3
OG0026036	2	1	0	0	3
OG0026037	1	0	1	1	3
OG0026038	1	0	1	1	3
OG0026039	1	0	1	1	3
OG0026040	1	1	1	0	3
OG0026041	2	1	0	0	3
OG0026042	1	0	1	1	3
OG0026043	1	1	1	0	3
OG0026044	2	1	0	0	3
OG0026045	1	2	0	0	3
OG0026046	2	1	0	0	3
OG0026047	1	2	0	0	3
OG0026048	1	1	1	0	3
OG0026049	1	1	0	1	3
OG0026050	1	1	0	1	3
OG0026051	1	0	2	0	3
OG0026052	1	1	0	1	3
OG0026053	1	1	1	0	3
OG0026054	1	0	1	1	3
OG0026055	1	1	0	1	3
OG0026056	1	1	0	1	3
OG0026057	1	1	0	1	3
OG0026058	1	1	1	0	3
OG0026059	1	1	1	0	3
OG0026060	2	1	0	0	3
OG0026061	2	1	0	0	3
OG0026062	1	2	0	0	3
OG0026063	3	0	0	0	3
OG0026064	1	1	1	0	3
OG0026065	1	1	0	1	3
OG0026066	1	0	1	1	3
OG0026067	1	2	0	0	3
OG0026068	1	0	1	1	3
OG0026069	1	0	1	1	3
OG0026070	1	0	1	1	3
OG0026071	1	1	1	0	3
OG0026072	1	1	0	1	3
OG0026073	1	1	0	1	3
OG0026074	1	0	1	1	3
OG0026075	1	0	1	1	3
OG0026076	1	1	0	1	3
OG0026077	1	1	0	1	3
OG0026078	1	1	1	0	3
OG0026079	1	0	1	1	3
OG0026080	1	0	1	1	3
OG0026081	1	0	1	1	3
OG0026082	1	0	1	1	3
OG0026083	3	0	0	0	3
OG0026084	1	1	0	1	3
OG0026085	1	0	1	1	3
OG0026086	1	1	0	1	3
OG0026087	1	0	1	1	3
OG0026088	1	0	1	1	3
OG0026089	1	0	1	1	3
OG0026090	1	0	2	0	3
OG0026091	1	0	1	1	3
OG0026092	2	1	0	0	3
OG0026093	1	1	0	1	3
OG0026094	1	0	1	1	3
OG0026095	1	1	1	0	3
OG0026096	1	0	1	1	3
OG0026097	1	1	0	1	3
OG0026098	1	0	1	1	3
OG0026099	1	1	1	0	3
OG0026100	1	1	0	1	3
OG0026101	1	1	0	1	3
OG0026102	1	1	0	1	3
OG0026103	1	0	1	1	3
OG0026104	1	1	0	1	3
OG0026105	3	0	0	0	3
OG0026106	1	1	0	1	3
OG0026107	1	0	1	1	3
OG0026108	1	0	1	1	3
OG0026109	1	1	1	0	3
OG0026110	1	1	0	1	3
OG0026111	1	0	1	1	3
OG0026112	1	1	1	0	3
OG0026113	1	1	1	0	3
OG0026114	2	1	0	0	3
OG0026115	1	1	1	0	3
OG0026116	2	1	0	0	3
OG0026117	2	1	0	0	3
OG0026118	1	0	1	1	3
OG0026119	1	0	1	1	3
OG0026120	1	1	0	1	3
OG0026121	1	1	1	0	3
OG0026122	1	0	1	1	3
OG0026123	1	0	1	1	3
OG0026124	1	2	0	0	3
OG0026125	1	2	0	0	3
OG0026126	2	1	0	0	3
OG0026127	1	0	1	1	3
OG0026128	2	1	0	0	3
OG0026129	1	1	0	1	3
OG0026130	3	0	0	0	3
OG0026131	3	0	0	0	3
OG0026132	1	2	0	0	3
OG0026133	1	2	0	0	3
OG0026134	1	1	1	0	3
OG0026135	1	1	1	0	3
OG0026136	1	1	0	1	3
OG0026137	1	0	1	1	3
OG0026138	2	1	0	0	3
OG0026139	1	0	1	1	3
OG0026140	2	1	0	0	3
OG0026141	2	1	0	0	3
OG0026142	1	2	0	0	3
OG0026143	1	0	1	1	3
OG0026144	2	1	0	0	3
OG0026145	2	1	0	0	3
OG0026146	2	1	0	0	3
OG0026147	1	2	0	0	3
OG0026148	1	0	2	0	3
OG0026149	2	1	0	0	3
OG0026150	3	0	0	0	3
OG0026151	1	0	1	1	3
OG0026152	2	1	0	0	3
OG0026153	1	0	1	1	3
OG0026154	1	2	0	0	3
OG0026155	1	2	0	0	3
OG0026156	2	1	0	0	3
OG0026157	2	1	0	0	3
OG0026158	1	1	0	1	3
OG0026159	2	1	0	0	3
OG0026160	1	0	1	1	3
OG0026161	1	1	0	1	3
OG0026162	1	1	0	1	3
OG0026163	1	2	0	0	3
OG0026164	1	2	0	0	3
OG0026165	1	1	1	0	3
OG0026166	1	1	1	0	3
OG0026167	1	0	1	1	3
OG0026168	1	0	1	1	3
OG0026169	1	0	1	1	3
OG0026170	1	0	1	1	3
OG0026171	1	0	1	1	3
OG0026172	2	1	0	0	3
OG0026173	2	1	0	0	3
OG0026174	1	2	0	0	3
OG0026175	1	1	0	1	3
OG0026176	3	0	0	0	3
OG0026177	1	0	1	1	3
OG0026178	1	1	0	1	3
OG0026179	1	0	1	1	3
OG0026180	2	1	0	0	3
OG0026181	1	1	1	0	3
OG0026182	1	1	1	0	3
OG0026183	2	1	0	0	3
OG0026184	1	0	0	2	3
OG0026185	1	2	0	0	3
OG0026186	1	2	0	0	3
OG0026187	2	1	0	0	3
OG0026188	2	1	0	0	3
OG0026189	1	1	0	1	3
OG0026190	1	1	0	1	3
OG0026191	1	1	1	0	3
OG0026192	1	0	1	1	3
OG0026193	1	0	2	0	3
OG0026194	1	0	1	1	3
OG0026195	1	0	1	1	3
OG0026196	1	0	1	1	3
OG0026197	1	0	1	1	3
OG0026198	1	0	1	1	3
OG0026199	3	0	0	0	3
OG0026200	1	2	0	0	3
OG0026201	1	0	1	1	3
OG0026202	1	0	1	1	3
OG0026203	1	0	1	1	3
OG0026204	1	1	1	0	3
OG0026205	1	0	1	1	3
OG0026206	1	1	1	0	3
OG0026207	1	0	1	1	3
OG0026208	1	0	1	1	3
OG0026209	1	0	1	1	3
OG0026210	1	0	1	1	3
OG0026211	1	0	1	1	3
OG0026212	1	1	0	1	3
OG0026213	2	1	0	0	3
OG0026214	1	2	0	0	3
OG0026215	1	1	0	1	3
OG0026216	1	1	0	1	3
OG0026217	1	2	0	0	3
OG0026218	1	1	0	1	3
OG0026219	1	0	1	1	3
OG0026220	2	1	0	0	3
OG0026221	1	1	1	0	3
OG0026222	1	0	1	1	3
OG0026223	1	2	0	0	3
OG0026224	1	0	1	1	3
OG0026225	1	2	0	0	3
OG0026226	1	2	0	0	3
OG0026227	1	2	0	0	3
OG0026228	1	0	1	1	3
OG0026229	2	1	0	0	3
OG0026230	1	2	0	0	3
OG0026231	2	1	0	0	3
OG0026232	3	0	0	0	3
OG0026233	3	0	0	0	3
OG0026234	1	1	0	1	3
OG0026235	1	1	0	1	3
OG0026236	1	0	1	1	3
OG0026237	1	0	1	1	3
OG0026238	1	1	0	1	3
OG0026239	1	0	1	1	3
OG0026240	1	2	0	0	3
OG0026241	1	0	1	1	3
OG0026242	1	1	1	0	3
OG0026243	1	1	0	1	3
OG0026244	1	0	1	1	3
OG0026245	1	0	2	0	3
OG0026246	1	1	1	0	3
OG0026247	1	1	1	0	3
OG0026248	1	1	1	0	3
OG0026249	2	1	0	0	3
OG0026250	1	0	1	1	3
OG0026251	1	1	0	1	3
OG0026252	1	0	1	1	3
OG0026253	1	0	1	1	3
OG0026254	2	1	0	0	3
OG0026255	1	2	0	0	3
OG0026256	3	0	0	0	3
OG0026257	1	2	0	0	3
OG0026258	2	1	0	0	3
OG0026259	1	0	1	1	3
OG0026260	1	0	1	1	3
OG0026261	2	0	0	1	3
OG0026262	1	0	1	1	3
OG0026263	1	1	1	0	3
OG0026264	1	0	2	0	3
OG0026265	1	1	1	0	3
OG0026266	1	0	1	1	3
OG0026267	1	1	1	0	3
OG0026268	1	0	1	1	3
OG0026269	1	0	1	1	3
OG0026270	2	1	0	0	3
OG0026271	1	0	0	2	3
OG0026272	1	0	1	1	3
OG0026273	1	0	0	2	3
OG0026274	1	0	1	1	3
OG0026275	1	1	0	1	3
OG0026276	1	1	1	0	3
OG0026277	1	0	1	1	3
OG0026278	1	0	1	1	3
OG0026279	1	0	1	1	3
OG0026280	1	0	1	1	3
OG0026281	1	1	0	1	3
OG0026282	1	1	0	1	3
OG0026283	1	0	1	1	3
OG0026284	3	0	0	0	3
OG0026285	1	1	1	0	3
OG0026286	2	0	0	1	3
OG0026287	1	1	0	1	3
OG0026288	1	0	1	1	3
OG0026289	1	0	1	1	3
OG0026290	1	1	1	0	3
OG0026291	1	0	1	1	3
OG0026292	1	0	1	1	3
OG0026293	1	1	0	1	3
OG0026294	1	1	1	0	3
OG0026295	2	1	0	0	3
OG0026296	1	1	1	0	3
OG0026297	2	1	0	0	3
OG0026298	1	0	1	1	3
OG0026299	1	0	1	1	3
OG0026300	2	0	1	0	3
OG0026301	1	0	1	1	3
OG0026302	1	1	1	0	3
OG0026303	1	0	1	1	3
OG0026304	1	0	1	1	3
OG0026305	1	0	1	1	3
OG0026306	1	0	1	1	3
OG0026307	1	0	1	1	3
OG0026308	1	1	0	1	3
OG0026309	1	0	1	1	3
OG0026310	1	0	1	1	3
OG0026311	1	0	1	1	3
OG0026312	1	1	0	1	3
OG0026313	1	0	0	2	3
OG0026314	3	0	0	0	3
OG0026315	2	1	0	0	3
OG0026316	1	1	1	0	3
OG0026317	1	2	0	0	3
OG0026318	1	2	0	0	3
OG0026319	1	1	1	0	3
OG0026320	1	1	1	0	3
OG0026321	3	0	0	0	3
OG0026322	1	0	1	1	3
OG0026323	1	1	0	1	3
OG0026324	1	1	0	1	3
OG0026325	1	0	1	1	3
OG0026326	1	0	1	1	3
OG0026327	1	1	0	1	3
OG0026328	1	1	1	0	3
OG0026329	1	0	1	1	3
OG0026330	1	1	1	0	3
OG0026331	1	0	1	1	3
OG0026332	1	0	1	1	3
OG0026333	1	1	0	1	3
OG0026334	1	1	0	1	3
OG0026335	2	0	0	1	3
OG0026336	2	1	0	0	3
OG0026337	1	0	1	1	3
OG0026338	1	2	0	0	3
OG0026339	1	0	1	1	3
OG0026340	1	0	1	1	3
OG0026341	1	0	1	1	3
OG0026342	1	1	0	1	3
OG0026343	1	0	1	1	3
OG0026344	1	0	1	1	3
OG0026345	1	1	0	1	3
OG0026346	2	1	0	0	3
OG0026347	1	2	0	0	3
OG0026348	1	1	1	0	3
OG0026349	1	2	0	0	3
OG0026350	1	2	0	0	3
OG0026351	2	1	0	0	3
OG0026352	1	2	0	0	3
OG0026353	1	2	0	0	3
OG0026354	1	2	0	0	3
OG0026355	2	1	0	0	3
OG0026356	2	0	0	1	3
OG0026357	1	1	1	0	3
OG0026358	1	2	0	0	3
OG0026359	1	1	1	0	3
OG0026360	1	0	1	1	3
OG0026361	1	0	1	1	3
OG0026362	1	2	0	0	3
OG0026363	1	2	0	0	3
OG0026364	1	2	0	0	3
OG0026365	1	1	1	0	3
OG0026366	1	2	0	0	3
OG0026367	1	1	1	0	3
OG0026368	1	2	0	0	3
OG0026369	1	2	0	0	3
OG0026370	1	0	1	1	3
OG0026371	1	2	0	0	3
OG0026372	1	2	0	0	3
OG0026373	1	0	1	1	3
OG0026374	1	0	1	1	3
OG0026375	1	0	1	1	3
OG0026376	1	1	1	0	3
OG0026377	1	0	1	1	3
OG0026378	1	1	0	1	3
OG0026379	2	1	0	0	3
OG0026380	2	1	0	0	3
OG0026381	1	1	1	0	3
OG0026382	1	1	0	1	3
OG0026383	3	0	0	0	3
OG0026384	1	2	0	0	3
OG0026385	1	2	0	0	3
OG0026386	1	0	2	0	3
OG0026387	1	0	2	0	3
OG0026388	1	1	1	0	3
OG0026389	1	1	1	0	3
OG0026390	1	0	1	1	3
OG0026391	1	1	1	0	3
OG0026392	1	0	1	1	3
OG0026393	1	2	0	0	3
OG0026394	1	1	1	0	3
OG0026395	1	0	2	0	3
OG0026396	1	2	0	0	3
OG0026397	2	1	0	0	3
OG0026398	1	0	1	1	3
OG0026399	1	1	0	1	3
OG0026400	2	0	1	0	3
OG0026401	1	0	1	1	3
OG0026402	1	0	2	0	3
OG0026403	1	1	0	1	3
OG0026404	1	1	1	0	3
OG0026405	1	0	1	1	3
OG0026406	1	2	0	0	3
OG0026407	1	0	0	2	3
OG0026408	1	1	1	0	3
OG0026409	1	1	1	0	3
OG0026410	1	1	1	0	3
OG0026411	1	1	0	1	3
OG0026412	1	2	0	0	3
OG0026413	1	1	1	0	3
OG0026414	1	2	0	0	3
OG0026415	1	1	1	0	3
OG0026416	1	2	0	0	3
OG0026417	1	1	0	1	3
OG0026418	1	0	1	1	3
OG0026419	1	1	1	0	3
OG0026420	1	1	1	0	3
OG0026421	1	2	0	0	3
OG0026422	1	1	0	1	3
OG0026423	1	0	1	1	3
OG0026424	1	2	0	0	3
OG0026425	1	1	1	0	3
OG0026426	1	1	1	0	3
OG0026427	1	0	1	1	3
OG0026428	1	2	0	0	3
OG0026429	1	2	0	0	3
OG0026430	2	1	0	0	3
OG0026431	1	0	1	1	3
OG0026432	1	1	1	0	3
OG0026433	2	1	0	0	3
OG0026434	1	1	1	0	3
OG0026435	1	2	0	0	3
OG0026436	2	1	0	0	3
OG0026437	1	0	1	1	3
OG0026438	1	1	1	0	3
OG0026439	2	1	0	0	3
OG0026440	1	1	0	1	3
OG0026441	1	0	1	1	3
OG0026442	3	0	0	0	3
OG0026443	1	1	1	0	3
OG0026444	1	0	1	1	3
OG0026445	1	1	1	0	3
OG0026446	1	0	1	1	3
OG0026447	2	1	0	0	3
OG0026448	2	0	0	1	3
OG0026449	2	1	0	0	3
OG0026450	1	2	0	0	3
OG0026451	1	1	1	0	3
OG0026452	1	2	0	0	3
OG0026453	1	1	1	0	3
OG0026454	1	1	1	0	3
OG0026455	1	2	0	0	3
OG0026456	1	2	0	0	3
OG0026457	1	0	1	1	3
OG0026458	1	0	0	2	3
OG0026459	1	2	0	0	3
OG0026460	1	2	0	0	3
OG0026461	1	2	0	0	3
OG0026462	1	2	0	0	3
OG0026463	1	2	0	0	3
OG0026464	1	0	1	1	3
OG0026465	2	0	1	0	3
OG0026466	1	2	0	0	3
OG0026467	1	1	1	0	3
OG0026468	3	0	0	0	3
OG0026469	1	1	1	0	3
OG0026470	1	0	1	1	3
OG0026471	3	0	0	0	3
OG0026472	2	1	0	0	3
OG0026473	2	1	0	0	3
OG0026474	1	1	0	1	3
OG0026475	1	0	1	1	3
OG0026476	3	0	0	0	3
OG0026477	2	0	1	0	3
OG0026478	1	2	0	0	3
OG0026479	1	2	0	0	3
OG0026480	1	2	0	0	3
OG0026481	1	1	0	1	3
OG0026482	3	0	0	0	3
OG0026483	1	1	0	1	3
OG0026484	1	0	1	1	3
OG0026485	1	1	1	0	3
OG0026486	1	2	0	0	3
OG0026487	3	0	0	0	3
OG0026488	1	1	0	1	3
OG0026489	1	2	0	0	3
OG0026490	1	1	0	1	3
OG0026491	1	1	1	0	3
OG0026492	3	0	0	0	3
OG0026493	3	0	0	0	3
OG0026494	2	1	0	0	3
OG0026495	1	0	1	1	3
OG0026496	1	0	1	1	3
OG0026497	1	0	1	1	3
OG0026498	1	1	1	0	3
OG0026499	2	1	0	0	3
OG0026500	1	0	1	1	3
OG0026501	1	0	1	1	3
OG0026502	1	2	0	0	3
OG0026503	1	2	0	0	3
OG0026504	1	1	1	0	3
OG0026505	1	1	1	0	3
OG0026506	1	2	0	0	3
OG0026507	1	2	0	0	3
OG0026508	1	2	0	0	3
OG0026509	1	2	0	0	3
OG0026510	2	1	0	0	3
OG0026511	3	0	0	0	3
OG0026512	1	1	1	0	3
OG0026513	1	2	0	0	3
OG0026514	1	0	1	1	3
OG0026515	1	1	1	0	3
OG0026516	1	2	0	0	3
OG0026517	1	1	1	0	3
OG0026518	1	2	0	0	3
OG0026519	2	1	0	0	3
OG0026520	1	0	1	1	3
OG0026521	0	3	0	0	3
OG0026522	0	3	0	0	3
OG0026523	0	3	0	0	3
OG0026524	0	3	0	0	3
OG0026525	0	3	0	0	3
OG0026526	0	3	0	0	3
OG0026527	0	3	0	0	3
OG0026528	0	3	0	0	3
OG0026529	0	1	1	1	3
OG0026530	0	3	0	0	3
OG0026531	0	3	0	0	3
OG0026532	0	3	0	0	3
OG0026533	0	1	1	1	3
OG0026534	0	3	0	0	3
OG0026535	0	3	0	0	3
OG0026536	0	3	0	0	3
OG0026537	0	3	0	0	3
OG0026538	0	3	0	0	3
OG0026539	0	1	0	2	3
OG0026540	0	3	0	0	3
OG0026541	0	1	0	2	3
OG0026542	0	3	0	0	3
OG0026543	0	3	0	0	3
OG0026544	0	3	0	0	3
OG0026545	0	2	1	0	3
OG0026546	0	3	0	0	3
OG0026547	0	1	1	1	3
OG0026548	0	1	1	1	3
OG0026549	0	1	1	1	3
OG0026550	0	3	0	0	3
OG0026551	0	1	1	1	3
OG0026552	0	3	0	0	3
OG0026553	0	3	0	0	3
OG0026554	0	3	0	0	3
OG0026555	0	3	0	0	3
OG0026556	0	3	0	0	3
OG0026557	0	3	0	0	3
OG0026558	0	3	0	0	3
OG0026559	0	3	0	0	3
OG0026560	0	3	0	0	3
OG0026561	0	3	0	0	3
OG0026562	0	3	0	0	3
OG0026563	0	3	0	0	3
OG0026564	0	3	0	0	3
OG0026565	0	3	0	0	3
OG0026566	0	3	0	0	3
OG0026567	0	3	0	0	3
OG0026568	0	3	0	0	3
OG0026569	0	3	0	0	3
OG0026570	0	2	1	0	3
OG0026571	0	3	0	0	3
OG0026572	0	3	0	0	3
OG0026573	0	3	0	0	3
OG0026574	0	3	0	0	3
OG0026575	0	3	0	0	3
OG0026576	0	3	0	0	3
OG0026577	0	3	0	0	3
OG0026578	0	3	0	0	3
OG0026579	0	1	2	0	3
OG0026580	0	3	0	0	3
OG0026581	0	3	0	0	3
OG0026582	0	3	0	0	3
OG0026583	0	3	0	0	3
OG0026584	0	1	1	1	3
OG0026585	0	3	0	0	3
OG0026586	0	1	1	1	3
OG0026587	0	3	0	0	3
OG0026588	0	1	1	1	3
OG0026589	0	1	1	1	3
OG0026590	0	3	0	0	3
OG0026591	0	3	0	0	3
OG0026592	0	3	0	0	3
OG0026593	0	1	1	1	3
OG0026594	0	2	1	0	3
OG0026595	0	3	0	0	3
OG0026596	0	3	0	0	3
OG0026597	0	3	0	0	3
OG0026598	0	3	0	0	3
OG0026599	0	3	0	0	3
OG0026600	0	3	0	0	3
OG0026601	0	3	0	0	3
OG0026602	0	3	0	0	3
OG0026603	0	3	0	0	3
OG0026604	0	3	0	0	3
OG0026605	0	1	1	1	3
OG0026606	0	1	1	1	3
OG0026607	0	3	0	0	3
OG0026608	0	3	0	0	3
OG0026609	0	3	0	0	3
OG0026610	0	1	1	1	3
OG0026611	0	1	1	1	3
OG0026612	0	1	1	1	3
OG0026613	0	1	1	1	3
OG0026614	0	1	1	1	3
OG0026615	0	1	1	1	3
OG0026616	0	1	1	1	3
OG0026617	0	1	1	1	3
OG0026618	0	3	0	0	3
OG0026619	0	1	1	1	3
OG0026620	0	1	1	1	3
OG0026621	0	1	1	1	3
OG0026622	0	1	1	1	3
OG0026623	0	1	1	1	3
OG0026624	0	1	1	1	3
OG0026625	0	1	1	1	3
OG0026626	0	2	0	1	3
OG0026627	0	1	1	1	3
OG0026628	0	1	1	1	3
OG0026629	0	3	0	0	3
OG0026630	0	1	1	1	3
OG0026631	0	1	1	1	3
OG0026632	0	1	1	1	3
OG0026633	0	1	1	1	3
OG0026634	0	1	1	1	3
OG0026635	0	1	1	1	3
OG0026636	0	1	0	2	3
OG0026637	0	1	1	1	3
OG0026638	0	1	1	1	3
OG0026639	0	1	1	1	3
OG0026640	0	1	1	1	3
OG0026641	0	1	1	1	3
OG0026642	0	3	0	0	3
OG0026643	0	1	1	1	3
OG0026644	0	1	1	1	3
OG0026645	0	1	1	1	3
OG0026646	0	1	1	1	3
OG0026647	0	1	1	1	3
OG0026648	0	1	1	1	3
OG0026649	0	3	0	0	3
OG0026650	0	1	1	1	3
OG0026651	0	1	1	1	3
OG0026652	0	1	1	1	3
OG0026653	0	1	1	1	3
OG0026654	0	1	1	1	3
OG0026655	0	3	0	0	3
OG0026656	0	1	1	1	3
OG0026657	0	1	1	1	3
OG0026658	0	1	1	1	3
OG0026659	0	1	0	2	3
OG0026660	0	1	1	1	3
OG0026661	0	1	1	1	3
OG0026662	0	1	1	1	3
OG0026663	0	1	1	1	3
OG0026664	0	1	1	1	3
OG0026665	0	3	0	0	3
OG0026666	0	1	1	1	3
OG0026667	0	1	1	1	3
OG0026668	0	1	1	1	3
OG0026669	0	3	0	0	3
OG0026670	0	3	0	0	3
OG0026671	0	3	0	0	3
OG0026672	0	1	1	1	3
OG0026673	0	3	0	0	3
OG0026674	0	3	0	0	3
OG0026675	0	1	1	1	3
OG0026676	0	3	0	0	3
OG0026677	0	1	1	1	3
OG0026678	0	1	1	1	3
OG0026679	0	3	0	0	3
OG0026680	0	3	0	0	3
OG0026681	0	2	1	0	3
OG0026682	0	1	1	1	3
OG0026683	0	1	1	1	3
OG0026684	0	3	0	0	3
OG0026685	0	1	1	1	3
OG0026686	0	3	0	0	3
OG0026687	0	3	0	0	3
OG0026688	0	3	0	0	3
OG0026689	0	3	0	0	3
OG0026690	0	1	1	1	3
OG0026691	0	3	0	0	3
OG0026692	0	1	0	2	3
OG0026693	0	1	1	1	3
OG0026694	0	3	0	0	3
OG0026695	0	3	0	0	3
OG0026696	0	3	0	0	3
OG0026697	0	1	1	1	3
OG0026698	0	3	0	0	3
OG0026699	0	1	1	1	3
OG0026700	0	3	0	0	3
OG0026701	0	1	1	1	3
OG0026702	0	3	0	0	3
OG0026703	0	3	0	0	3
OG0026704	0	3	0	0	3
OG0026705	0	3	0	0	3
OG0026706	0	3	0	0	3
OG0026707	0	3	0	0	3
OG0026708	0	3	0	0	3
OG0026709	0	3	0	0	3
OG0026710	0	1	1	1	3
OG0026711	0	3	0	0	3
OG0026712	0	3	0	0	3
OG0026713	0	1	1	1	3
OG0026714	0	3	0	0	3
OG0026715	0	3	0	0	3
OG0026716	0	3	0	0	3
OG0026717	0	3	0	0	3
OG0026718	0	3	0	0	3
OG0026719	0	3	0	0	3
OG0026720	0	3	0	0	3
OG0026721	0	3	0	0	3
OG0026722	0	3	0	0	3
OG0026723	0	1	1	1	3
OG0026724	0	3	0	0	3
OG0026725	0	1	1	1	3
OG0026726	0	3	0	0	3
OG0026727	0	3	0	0	3
OG0026728	0	3	0	0	3
OG0026729	0	3	0	0	3
OG0026730	0	3	0	0	3
OG0026731	0	3	0	0	3
OG0026732	0	3	0	0	3
OG0026733	0	3	0	0	3
OG0026734	0	3	0	0	3
OG0026735	0	3	0	0	3
OG0026736	0	3	0	0	3
OG0026737	0	3	0	0	3
OG0026738	0	3	0	0	3
OG0026739	0	3	0	0	3
OG0026740	0	3	0	0	3
OG0026741	0	3	0	0	3
OG0026742	0	3	0	0	3
OG0026743	0	3	0	0	3
OG0026744	0	3	0	0	3
OG0026745	0	3	0	0	3
OG0026746	0	3	0	0	3
OG0026747	0	1	1	1	3
OG0026748	0	1	1	1	3
OG0026749	0	1	1	1	3
OG0026750	0	1	1	1	3
OG0026751	0	1	1	1	3
OG0026752	0	1	1	1	3
OG0026753	0	1	1	1	3
OG0026754	0	1	1	1	3
OG0026755	0	1	1	1	3
OG0026756	0	1	1	1	3
OG0026757	0	1	1	1	3
OG0026758	0	1	1	1	3
OG0026759	0	3	0	0	3
OG0026760	0	1	1	1	3
OG0026761	0	1	1	1	3
OG0026762	0	1	1	1	3
OG0026763	0	1	1	1	3
OG0026764	0	1	1	1	3
OG0026765	0	1	1	1	3
OG0026766	0	1	1	1	3
OG0026767	0	1	1	1	3
OG0026768	0	1	1	1	3
OG0026769	0	1	1	1	3
OG0026770	0	1	1	1	3
OG0026771	0	2	0	1	3
OG0026772	0	1	1	1	3
OG0026773	0	3	0	0	3
OG0026774	0	1	1	1	3
OG0026775	0	3	0	0	3
OG0026776	0	3	0	0	3
OG0026777	0	1	1	1	3
OG0026778	0	1	0	2	3
OG0026779	0	1	1	1	3
OG0026780	0	3	0	0	3
OG0026781	0	3	0	0	3
OG0026782	0	1	1	1	3
OG0026783	0	3	0	0	3
OG0026784	0	1	1	1	3
OG0026785	0	3	0	0	3
OG0026786	0	1	1	1	3
OG0026787	0	3	0	0	3
OG0026788	0	1	1	1	3
OG0026789	0	3	0	0	3
OG0026790	0	3	0	0	3
OG0026791	0	3	0	0	3
OG0026792	0	1	1	1	3
OG0026793	0	1	1	1	3
OG0026794	0	3	0	0	3
OG0026795	0	3	0	0	3
OG0026796	0	1	1	1	3
OG0026797	0	3	0	0	3
OG0026798	0	2	1	0	3
OG0026799	0	3	0	0	3
OG0026800	0	1	1	1	3
OG0026801	0	3	0	0	3
OG0026802	0	3	0	0	3
OG0026803	0	3	0	0	3
OG0026804	0	1	2	0	3
OG0026805	0	3	0	0	3
OG0026806	0	3	0	0	3
OG0026807	0	1	1	1	3
OG0026808	0	1	1	1	3
OG0026809	0	3	0	0	3
OG0026810	0	3	0	0	3
OG0026811	0	3	0	0	3
OG0026812	0	3	0	0	3
OG0026813	0	3	0	0	3
OG0026814	0	1	1	1	3
OG0026815	0	2	1	0	3
OG0026816	0	3	0	0	3
OG0026817	0	1	2	0	3
OG0026818	0	3	0	0	3
OG0026819	0	3	0	0	3
OG0026820	0	1	1	1	3
OG0026821	0	3	0	0	3
OG0026822	0	3	0	0	3
OG0026823	0	3	0	0	3
OG0026824	0	3	0	0	3
OG0026825	0	3	0	0	3
OG0026826	0	3	0	0	3
OG0026827	0	1	1	1	3
OG0026828	0	3	0	0	3
OG0026829	0	1	1	1	3
OG0026830	0	3	0	0	3
OG0026831	0	3	0	0	3
OG0026832	0	3	0	0	3
OG0026833	0	3	0	0	3
OG0026834	0	1	1	1	3
OG0026835	0	3	0	0	3
OG0026836	0	2	1	0	3
OG0026837	0	1	1	1	3
OG0026838	0	1	1	1	3
OG0026839	0	3	0	0	3
OG0026840	0	3	0	0	3
OG0026841	0	3	0	0	3
OG0026842	0	3	0	0	3
OG0026843	0	3	0	0	3
OG0026844	0	3	0	0	3
OG0026845	0	1	1	1	3
OG0026846	0	1	1	1	3
OG0026847	0	3	0	0	3
OG0026848	0	3	0	0	3
OG0026849	0	1	1	1	3
OG0026850	0	3	0	0	3
OG0026851	0	2	0	1	3
OG0026852	0	3	0	0	3
OG0026853	0	3	0	0	3
OG0026854	0	3	0	0	3
OG0026855	0	3	0	0	3
OG0026856	0	3	0	0	3
OG0026857	0	3	0	0	3
OG0026858	0	3	0	0	3
OG0026859	0	3	0	0	3
OG0026860	0	2	0	1	3
OG0026861	0	1	1	1	3
OG0026862	0	1	1	1	3
OG0026863	0	3	0	0	3
OG0026864	0	1	1	1	3
OG0026865	0	2	0	1	3
OG0026866	0	1	1	1	3
OG0026867	0	3	0	0	3
OG0026868	0	3	0	0	3
OG0026869	0	1	1	1	3
OG0026870	0	3	0	0	3
OG0026871	0	1	1	1	3
OG0026872	0	1	1	1	3
OG0026873	0	1	1	1	3
OG0026874	0	3	0	0	3
OG0026875	0	3	0	0	3
OG0026876	0	1	1	1	3
OG0026877	0	3	0	0	3
OG0026878	0	3	0	0	3
OG0026879	0	3	0	0	3
OG0026880	0	1	1	1	3
OG0026881	0	1	1	1	3
OG0026882	0	3	0	0	3
OG0026883	0	3	0	0	3
OG0026884	0	1	1	1	3
OG0026885	0	1	1	1	3
OG0026886	0	2	0	1	3
OG0026887	0	3	0	0	3
OG0026888	0	3	0	0	3
OG0026889	0	3	0	0	3
OG0026890	0	3	0	0	3
OG0026891	0	1	1	1	3
OG0026892	0	1	1	1	3
OG0026893	0	1	1	1	3
OG0026894	0	1	1	1	3
OG0026895	0	1	1	1	3
OG0026896	0	1	1	1	3
OG0026897	0	1	1	1	3
OG0026898	0	1	1	1	3
OG0026899	0	1	1	1	3
OG0026900	0	2	0	1	3
OG0026901	0	3	0	0	3
OG0026902	0	1	1	1	3
OG0026903	0	1	1	1	3
OG0026904	0	1	1	1	3
OG0026905	0	1	1	1	3
OG0026906	0	1	1	1	3
OG0026907	0	2	0	1	3
OG0026908	0	1	1	1	3
OG0026909	0	1	1	1	3
OG0026910	0	1	1	1	3
OG0026911	0	2	0	1	3
OG0026912	0	1	1	1	3
OG0026913	0	2	0	1	3
OG0026914	0	1	1	1	3
OG0026915	0	3	0	0	3
OG0026916	0	1	1	1	3
OG0026917	0	1	1	1	3
OG0026918	0	1	1	1	3
OG0026919	0	1	1	1	3
OG0026920	0	1	1	1	3
OG0026921	0	3	0	0	3
OG0026922	0	1	1	1	3
OG0026923	0	1	1	1	3
OG0026924	0	1	1	1	3
OG0026925	0	1	1	1	3
OG0026926	0	2	0	1	3
OG0026927	0	1	1	1	3
OG0026928	0	1	1	1	3
OG0026929	0	3	0	0	3
OG0026930	0	1	1	1	3
OG0026931	0	1	1	1	3
OG0026932	0	1	1	1	3
OG0026933	0	1	1	1	3
OG0026934	0	3	0	0	3
OG0026935	0	1	1	1	3
OG0026936	0	1	1	1	3
OG0026937	0	1	1	1	3
OG0026938	0	1	2	0	3
OG0026939	0	1	1	1	3
OG0026940	0	1	1	1	3
OG0026941	0	1	1	1	3
OG0026942	0	3	0	0	3
OG0026943	0	1	1	1	3
OG0026944	0	3	0	0	3
OG0026945	0	1	1	1	3
OG0026946	0	3	0	0	3
OG0026947	0	1	1	1	3
OG0026948	0	1	1	1	3
OG0026949	0	1	1	1	3
OG0026950	0	2	0	1	3
OG0026951	0	3	0	0	3
OG0026952	0	1	1	1	3
OG0026953	0	3	0	0	3
OG0026954	0	1	1	1	3
OG0026955	0	3	0	0	3
OG0026956	0	3	0	0	3
OG0026957	0	3	0	0	3
OG0026958	0	3	0	0	3
OG0026959	0	3	0	0	3
OG0026960	0	3	0	0	3
OG0026961	0	3	0	0	3
OG0026962	0	1	1	1	3
OG0026963	0	3	0	0	3
OG0026964	0	3	0	0	3
OG0026965	0	3	0	0	3
OG0026966	0	1	1	1	3
OG0026967	0	3	0	0	3
OG0026968	0	3	0	0	3
OG0026969	0	3	0	0	3
OG0026970	0	2	1	0	3
OG0026971	0	3	0	0	3
OG0026972	0	3	0	0	3
OG0026973	0	3	0	0	3
OG0026974	0	3	0	0	3
OG0026975	0	1	1	1	3
OG0026976	0	3	0	0	3
OG0026977	0	3	0	0	3
OG0026978	0	3	0	0	3
OG0026979	0	3	0	0	3
OG0026980	0	3	0	0	3
OG0026981	0	3	0	0	3
OG0026982	0	3	0	0	3
OG0026983	0	3	0	0	3
OG0026984	0	3	0	0	3
OG0026985	0	1	1	1	3
OG0026986	0	3	0	0	3
OG0026987	0	1	2	0	3
OG0026988	0	3	0	0	3
OG0026989	0	3	0	0	3
OG0026990	0	3	0	0	3
OG0026991	0	1	1	1	3
OG0026992	0	3	0	0	3
OG0026993	0	3	0	0	3
OG0026994	0	1	1	1	3
OG0026995	0	3	0	0	3
OG0026996	0	1	1	1	3
OG0026997	0	1	1	1	3
OG0026998	0	1	1	1	3
OG0026999	0	3	0	0	3
OG0027000	0	1	1	1	3
OG0027001	0	1	1	1	3
OG0027002	0	1	1	1	3
OG0027003	0	1	1	1	3
OG0027004	0	3	0	0	3
OG0027005	0	1	1	1	3
OG0027006	0	1	1	1	3
OG0027007	0	1	1	1	3
OG0027008	0	1	1	1	3
OG0027009	0	1	1	1	3
OG0027010	0	1	1	1	3
OG0027011	0	1	1	1	3
OG0027012	0	2	1	0	3
OG0027013	0	1	2	0	3
OG0027014	0	1	1	1	3
OG0027015	0	3	0	0	3
OG0027016	0	3	0	0	3
OG0027017	0	3	0	0	3
OG0027018	0	1	1	1	3
OG0027019	0	3	0	0	3
OG0027020	0	3	0	0	3
OG0027021	0	1	0	2	3
OG0027022	0	3	0	0	3
OG0027023	0	3	0	0	3
OG0027024	0	2	1	0	3
OG0027025	0	1	1	1	3
OG0027026	0	1	1	1	3
OG0027027	0	3	0	0	3
OG0027028	0	3	0	0	3
OG0027029	0	3	0	0	3
OG0027030	0	3	0	0	3
OG0027031	0	1	1	1	3
OG0027032	0	1	0	2	3
OG0027033	0	1	1	1	3
OG0027034	0	1	1	1	3
OG0027035	0	1	1	1	3
OG0027036	0	1	2	0	3
OG0027037	0	1	1	1	3
OG0027038	0	3	0	0	3
OG0027039	0	3	0	0	3
OG0027040	0	3	0	0	3
OG0027041	0	3	0	0	3
OG0027042	0	3	0	0	3
OG0027043	0	1	1	1	3
OG0027044	0	1	1	1	3
OG0027045	0	3	0	0	3
OG0027046	0	3	0	0	3
OG0027047	0	1	1	1	3
OG0027048	0	3	0	0	3
OG0027049	0	3	0	0	3
OG0027050	0	1	1	1	3
OG0027051	0	1	1	1	3
OG0027052	0	1	1	1	3
OG0027053	0	1	1	1	3
OG0027054	0	1	0	2	3
OG0027055	0	3	0	0	3
OG0027056	0	1	0	2	3
OG0027057	0	3	0	0	3
OG0027058	0	1	1	1	3
OG0027059	0	1	1	1	3
OG0027060	0	3	0	0	3
OG0027061	0	1	1	1	3
OG0027062	0	1	1	1	3
OG0027063	0	1	1	1	3
OG0027064	0	1	1	1	3
OG0027065	0	1	1	1	3
OG0027066	0	1	1	1	3
OG0027067	0	1	1	1	3
OG0027068	0	1	1	1	3
OG0027069	0	1	1	1	3
OG0027070	0	3	0	0	3
OG0027071	0	3	0	0	3
OG0027072	0	1	1	1	3
OG0027073	0	1	2	0	3
OG0027074	0	1	1	1	3
OG0027075	0	1	0	2	3
OG0027076	0	1	1	1	3
OG0027077	0	1	1	1	3
OG0027078	0	1	1	1	3
OG0027079	0	3	0	0	3
OG0027080	0	1	1	1	3
OG0027081	0	3	0	0	3
OG0027082	0	1	1	1	3
OG0027083	0	1	1	1	3
OG0027084	0	1	1	1	3
OG0027085	0	1	1	1	3
OG0027086	0	3	0	0	3
OG0027087	0	1	1	1	3
OG0027088	0	3	0	0	3
OG0027089	0	1	1	1	3
OG0027090	0	1	1	1	3
OG0027091	0	1	1	1	3
OG0027092	0	3	0	0	3
OG0027093	0	1	0	2	3
OG0027094	0	3	0	0	3
OG0027095	0	1	1	1	3
OG0027096	0	1	1	1	3
OG0027097	0	1	1	1	3
OG0027098	0	1	1	1	3
OG0027099	0	2	0	1	3
OG0027100	0	3	0	0	3
OG0027101	0	3	0	0	3
OG0027102	0	1	1	1	3
OG0027103	0	1	1	1	3
OG0027104	0	1	1	1	3
OG0027105	0	3	0	0	3
OG0027106	0	1	1	1	3
OG0027107	0	1	1	1	3
OG0027108	0	1	1	1	3
OG0027109	0	1	1	1	3
OG0027110	0	1	1	1	3
OG0027111	0	1	1	1	3
OG0027112	0	3	0	0	3
OG0027113	0	3	0	0	3
OG0027114	0	1	1	1	3
OG0027115	0	1	1	1	3
OG0027116	0	1	1	1	3
OG0027117	0	1	1	1	3
OG0027118	0	1	1	1	3
OG0027119	0	1	1	1	3
OG0027120	0	1	1	1	3
OG0027121	0	1	1	1	3
OG0027122	0	3	0	0	3
OG0027123	0	1	1	1	3
OG0027124	0	1	1	1	3
OG0027125	0	1	1	1	3
OG0027126	0	1	1	1	3
OG0027127	0	1	1	1	3
OG0027128	0	3	0	0	3
OG0027129	0	1	1	1	3
OG0027130	0	1	1	1	3
OG0027131	0	3	0	0	3
OG0027132	0	3	0	0	3
OG0027133	0	3	0	0	3
OG0027134	0	1	1	1	3
OG0027135	0	3	0	0	3
OG0027136	0	3	0	0	3
OG0027137	0	1	1	1	3
OG0027138	0	3	0	0	3
OG0027139	0	1	1	1	3
OG0027140	0	3	0	0	3
OG0027141	0	3	0	0	3
OG0027142	0	3	0	0	3
OG0027143	0	3	0	0	3
OG0027144	0	1	1	1	3
OG0027145	0	3	0	0	3
OG0027146	0	3	0	0	3
OG0027147	0	1	1	1	3
OG0027148	0	1	1	1	3
OG0027149	0	3	0	0	3
OG0027150	0	3	0	0	3
OG0027151	0	3	0	0	3
OG0027152	0	1	1	1	3
OG0027153	0	1	1	1	3
OG0027154	0	3	0	0	3
OG0027155	0	3	0	0	3
OG0027156	0	1	1	1	3
OG0027157	0	3	0	0	3
OG0027158	0	3	0	0	3
OG0027159	0	3	0	0	3
OG0027160	0	1	1	1	3
OG0027161	0	3	0	0	3
OG0027162	0	3	0	0	3
OG0027163	0	3	0	0	3
OG0027164	0	1	1	1	3
OG0027165	0	1	0	2	3
OG0027166	0	1	1	1	3
OG0027167	0	1	1	1	3
OG0027168	0	1	1	1	3
OG0027169	0	1	1	1	3
OG0027170	0	1	1	1	3
OG0027171	0	1	2	0	3
OG0027172	0	1	1	1	3
OG0027173	0	1	1	1	3
OG0027174	0	1	1	1	3
OG0027175	0	1	1	1	3
OG0027176	0	1	0	2	3
OG0027177	0	1	1	1	3
OG0027178	0	3	0	0	3
OG0027179	0	1	1	1	3
OG0027180	0	1	1	1	3
OG0027181	0	1	1	1	3
OG0027182	0	1	1	1	3
OG0027183	0	1	1	1	3
OG0027184	0	1	1	1	3
OG0027185	0	1	1	1	3
OG0027186	0	1	1	1	3
OG0027187	0	3	0	0	3
OG0027188	0	3	0	0	3
OG0027189	0	3	0	0	3
OG0027190	0	1	1	1	3
OG0027191	0	1	1	1	3
OG0027192	0	1	1	1	3
OG0027193	0	3	0	0	3
OG0027194	0	1	1	1	3
OG0027195	0	1	1	1	3
OG0027196	0	3	0	0	3
OG0027197	0	1	1	1	3
OG0027198	0	3	0	0	3
OG0027199	0	3	0	0	3
OG0027200	0	3	0	0	3
OG0027201	0	3	0	0	3
OG0027202	0	3	0	0	3
OG0027203	0	1	1	1	3
OG0027204	0	1	0	2	3
OG0027205	0	2	1	0	3
OG0027206	0	1	0	2	3
OG0027207	0	3	0	0	3
OG0027208	0	3	0	0	3
OG0027209	0	2	1	0	3
OG0027210	0	1	2	0	3
OG0027211	0	1	1	1	3
OG0027212	0	1	2	0	3
OG0027213	0	1	1	1	3
OG0027214	0	3	0	0	3
OG0027215	0	3	0	0	3
OG0027216	0	3	0	0	3
OG0027217	0	1	1	1	3
OG0027218	0	1	1	1	3
OG0027219	0	3	0	0	3
OG0027220	0	3	0	0	3
OG0027221	0	3	0	0	3
OG0027222	0	3	0	0	3
OG0027223	0	3	0	0	3
OG0027224	0	3	0	0	3
OG0027225	0	3	0	0	3
OG0027226	0	1	1	1	3
OG0027227	0	3	0	0	3
OG0027228	0	3	0	0	3
OG0027229	0	1	1	1	3
OG0027230	0	3	0	0	3
OG0027231	0	1	1	1	3
OG0027232	0	3	0	0	3
OG0027233	0	1	1	1	3
OG0027234	0	3	0	0	3
OG0027235	0	2	0	1	3
OG0027236	0	3	0	0	3
OG0027237	0	3	0	0	3
OG0027238	0	3	0	0	3
OG0027239	0	1	2	0	3
OG0027240	0	3	0	0	3
OG0027241	0	3	0	0	3
OG0027242	0	3	0	0	3
OG0027243	0	1	1	1	3
OG0027244	0	3	0	0	3
OG0027245	0	1	2	0	3
OG0027246	0	3	0	0	3
OG0027247	0	1	1	1	3
OG0027248	0	3	0	0	3
OG0027249	0	1	1	1	3
OG0027250	0	1	1	1	3
OG0027251	0	1	0	2	3
OG0027252	0	1	1	1	3
OG0027253	0	1	1	1	3
OG0027254	0	1	1	1	3
OG0027255	0	1	1	1	3
OG0027256	0	3	0	0	3
OG0027257	0	1	1	1	3
OG0027258	0	1	1	1	3
OG0027259	0	1	1	1	3
OG0027260	0	1	1	1	3
OG0027261	0	1	1	1	3
OG0027262	0	1	1	1	3
OG0027263	0	1	1	1	3
OG0027264	0	1	1	1	3
OG0027265	0	1	1	1	3
OG0027266	0	1	1	1	3
OG0027267	0	1	1	1	3
OG0027268	0	1	1	1	3
OG0027269	0	1	0	2	3
OG0027270	0	1	0	2	3
OG0027271	0	1	1	1	3
OG0027272	0	1	1	1	3
OG0027273	0	1	1	1	3
OG0027274	0	1	1	1	3
OG0027275	0	1	1	1	3
OG0027276	0	3	0	0	3
OG0027277	0	1	1	1	3
OG0027278	0	1	1	1	3
OG0027279	0	1	1	1	3
OG0027280	0	1	0	2	3
OG0027281	0	1	1	1	3
OG0027282	0	1	1	1	3
OG0027283	0	1	1	1	3
OG0027284	0	1	1	1	3
OG0027285	0	1	1	1	3
OG0027286	0	1	1	1	3
OG0027287	0	1	1	1	3
OG0027288	0	1	1	1	3
OG0027289	0	1	1	1	3
OG0027290	0	1	1	1	3
OG0027291	0	3	0	0	3
OG0027292	0	1	1	1	3
OG0027293	0	1	1	1	3
OG0027294	0	1	1	1	3
OG0027295	0	3	0	0	3
OG0027296	0	1	1	1	3
OG0027297	0	1	1	1	3
OG0027298	0	1	1	1	3
OG0027299	0	3	0	0	3
OG0027300	0	3	0	0	3
OG0027301	0	1	1	1	3
OG0027302	0	1	1	1	3
OG0027303	0	1	1	1	3
OG0027304	0	3	0	0	3
OG0027305	0	2	1	0	3
OG0027306	0	3	0	0	3
OG0027307	0	1	1	1	3
OG0027308	0	1	1	1	3
OG0027309	0	1	1	1	3
OG0027310	0	3	0	0	3
OG0027311	0	1	1	1	3
OG0027312	0	1	1	1	3
OG0027313	0	1	1	1	3
OG0027314	0	1	1	1	3
OG0027315	0	1	1	1	3
OG0027316	0	1	1	1	3
OG0027317	0	1	1	1	3
OG0027318	0	1	1	1	3
OG0027319	0	1	1	1	3
OG0027320	0	1	1	1	3
OG0027321	0	1	1	1	3
OG0027322	0	1	1	1	3
OG0027323	0	1	0	2	3
OG0027324	0	1	1	1	3
OG0027325	0	1	1	1	3
OG0027326	0	1	1	1	3
OG0027327	0	1	1	1	3
OG0027328	0	3	0	0	3
OG0027329	0	1	1	1	3
OG0027330	0	1	1	1	3
OG0027331	0	1	1	1	3
OG0027332	0	1	1	1	3
OG0027333	0	1	1	1	3
OG0027334	0	3	0	0	3
OG0027335	0	1	1	1	3
OG0027336	0	1	1	1	3
OG0027337	0	1	1	1	3
OG0027338	0	1	1	1	3
OG0027339	0	1	1	1	3
OG0027340	0	2	1	0	3
OG0027341	0	1	1	1	3
OG0027342	0	1	1	1	3
OG0027343	0	3	0	0	3
OG0027344	0	1	1	1	3
OG0027345	0	1	1	1	3
OG0027346	0	1	1	1	3
OG0027347	0	1	1	1	3
OG0027348	0	1	1	1	3
OG0027349	0	3	0	0	3
OG0027350	0	1	1	1	3
OG0027351	0	1	1	1	3
OG0027352	0	1	1	1	3
OG0027353	0	1	1	1	3
OG0027354	0	1	1	1	3
OG0027355	0	2	0	1	3
OG0027356	0	1	1	1	3
OG0027357	0	1	1	1	3
OG0027358	0	1	1	1	3
OG0027359	0	1	1	1	3
OG0027360	0	3	0	0	3
OG0027361	0	1	1	1	3
OG0027362	0	3	0	0	3
OG0027363	0	1	1	1	3
OG0027364	0	3	0	0	3
OG0027365	0	1	1	1	3
OG0027366	0	3	0	0	3
OG0027367	0	3	0	0	3
OG0027368	0	1	0	2	3
OG0027369	0	3	0	0	3
OG0027370	0	3	0	0	3
OG0027371	0	3	0	0	3
OG0027372	0	1	1	1	3
OG0027373	0	1	2	0	3
OG0027374	0	3	0	0	3
OG0027375	0	2	0	1	3
OG0027376	0	1	0	2	3
OG0027377	0	1	2	0	3
OG0027378	0	3	0	0	3
OG0027379	0	3	0	0	3
OG0027380	0	3	0	0	3
OG0027381	0	1	1	1	3
OG0027382	0	3	0	0	3
OG0027383	0	1	1	1	3
OG0027384	0	1	1	1	3
OG0027385	0	1	1	1	3
OG0027386	0	1	1	1	3
OG0027387	0	1	1	1	3
OG0027388	0	1	1	1	3
OG0027389	0	1	1	1	3
OG0027390	0	1	1	1	3
OG0027391	0	1	1	1	3
OG0027392	0	1	1	1	3
OG0027393	0	1	1	1	3
OG0027394	0	1	0	2	3
OG0027395	0	1	1	1	3
OG0027396	0	1	1	1	3
OG0027397	0	2	0	1	3
OG0027398	0	1	1	1	3
OG0027399	0	1	1	1	3
OG0027400	0	1	1	1	3
OG0027401	0	1	1	1	3
OG0027402	0	1	1	1	3
OG0027403	0	1	1	1	3
OG0027404	0	1	1	1	3
OG0027405	0	1	1	1	3
OG0027406	0	1	1	1	3
OG0027407	0	1	1	1	3
OG0027408	0	1	1	1	3
OG0027409	0	1	1	1	3
OG0027410	0	1	1	1	3
OG0027411	0	1	1	1	3
OG0027412	0	2	1	0	3
OG0027413	0	1	1	1	3
OG0027414	0	1	1	1	3
OG0027415	0	1	1	1	3
OG0027416	0	1	1	1	3
OG0027417	0	3	0	0	3
OG0027418	0	1	2	0	3
OG0027419	0	3	0	0	3
OG0027420	0	1	1	1	3
OG0027421	0	2	1	0	3
OG0027422	0	1	1	1	3
OG0027423	0	3	0	0	3
OG0027424	0	3	0	0	3
OG0027425	0	3	0	0	3
OG0027426	0	3	0	0	3
OG0027427	0	1	1	1	3
OG0027428	0	1	1	1	3
OG0027429	0	3	0	0	3
OG0027430	0	1	1	1	3
OG0027431	0	3	0	0	3
OG0027432	0	1	1	1	3
OG0027433	0	1	1	1	3
OG0027434	0	1	1	1	3
OG0027435	0	1	1	1	3
OG0027436	0	1	1	1	3
OG0027437	0	1	1	1	3
OG0027438	0	1	1	1	3
OG0027439	0	1	1	1	3
OG0027440	0	1	1	1	3
OG0027441	0	1	1	1	3
OG0027442	0	1	1	1	3
OG0027443	0	1	1	1	3
OG0027444	0	1	1	1	3
OG0027445	0	1	1	1	3
OG0027446	0	1	1	1	3
OG0027447	0	1	1	1	3
OG0027448	0	1	1	1	3
OG0027449	0	1	0	2	3
OG0027450	0	1	1	1	3
OG0027451	0	1	1	1	3
OG0027452	0	1	1	1	3
OG0027453	0	1	2	0	3
OG0027454	0	1	1	1	3
OG0027455	0	1	1	1	3
OG0027456	0	3	0	0	3
OG0027457	0	1	1	1	3
OG0027458	0	1	1	1	3
OG0027459	0	1	1	1	3
OG0027460	0	3	0	0	3
OG0027461	0	1	1	1	3
OG0027462	0	1	1	1	3
OG0027463	0	1	1	1	3
OG0027464	0	3	0	0	3
OG0027465	0	3	0	0	3
OG0027466	0	1	1	1	3
OG0027467	0	2	0	1	3
OG0027468	0	1	1	1	3
OG0027469	0	3	0	0	3
OG0027470	0	1	1	1	3
OG0027471	0	1	1	1	3
OG0027472	0	3	0	0	3
OG0027473	0	3	0	0	3
OG0027474	0	1	1	1	3
OG0027475	0	1	1	1	3
OG0027476	0	1	1	1	3
OG0027477	0	1	1	1	3
OG0027478	0	1	1	1	3
OG0027479	0	1	1	1	3
OG0027480	0	1	1	1	3
OG0027481	0	1	1	1	3
OG0027482	0	1	1	1	3
OG0027483	0	1	0	2	3
OG0027484	0	1	1	1	3
OG0027485	0	1	1	1	3
OG0027486	0	1	1	1	3
OG0027487	0	1	1	1	3
OG0027488	0	1	1	1	3
OG0027489	0	1	1	1	3
OG0027490	0	3	0	0	3
OG0027491	0	1	0	2	3
OG0027492	0	1	1	1	3
OG0027493	0	1	1	1	3
OG0027494	0	1	1	1	3
OG0027495	0	1	0	2	3
OG0027496	0	1	1	1	3
OG0027497	0	1	1	1	3
OG0027498	0	3	0	0	3
OG0027499	0	3	0	0	3
OG0027500	0	1	1	1	3
OG0027501	0	1	1	1	3
OG0027502	0	3	0	0	3
OG0027503	0	3	0	0	3
OG0027504	0	3	0	0	3
OG0027505	0	1	1	1	3
OG0027506	0	3	0	0	3
OG0027507	0	1	1	1	3
OG0027508	0	1	1	1	3
OG0027509	0	1	1	1	3
OG0027510	0	1	1	1	3
OG0027511	0	1	1	1	3
OG0027512	0	3	0	0	3
OG0027513	0	1	1	1	3
OG0027514	0	1	1	1	3
OG0027515	0	1	1	1	3
OG0027516	0	1	1	1	3
OG0027517	0	1	1	1	3
OG0027518	0	3	0	0	3
OG0027519	0	1	1	1	3
OG0027520	0	1	1	1	3
OG0027521	0	1	1	1	3
OG0027522	0	1	1	1	3
OG0027523	0	1	1	1	3
OG0027524	0	1	1	1	3
OG0027525	0	1	1	1	3
OG0027526	0	1	2	0	3
OG0027527	0	1	1	1	3
OG0027528	0	1	1	1	3
OG0027529	0	1	2	0	3
OG0027530	0	1	1	1	3
OG0027531	0	1	1	1	3
OG0027532	0	3	0	0	3
OG0027533	0	1	1	1	3
OG0027534	0	1	1	1	3
OG0027535	0	1	1	1	3
OG0027536	0	1	1	1	3
OG0027537	0	1	1	1	3
OG0027538	0	1	1	1	3
OG0027539	0	1	1	1	3
OG0027540	0	1	1	1	3
OG0027541	0	1	1	1	3
OG0027542	0	1	1	1	3
OG0027543	0	1	2	0	3
OG0027544	0	1	2	0	3
OG0027545	0	1	1	1	3
OG0027546	0	1	1	1	3
OG0027547	0	1	1	1	3
OG0027548	0	1	1	1	3
OG0027549	0	1	1	1	3
OG0027550	0	1	1	1	3
OG0027551	0	1	1	1	3
OG0027552	0	1	1	1	3
OG0027553	0	1	1	1	3
OG0027554	0	1	1	1	3
OG0027555	0	1	1	1	3
OG0027556	0	1	1	1	3
OG0027557	0	1	1	1	3
OG0027558	0	1	1	1	3
OG0027559	0	1	1	1	3
OG0027560	0	1	1	1	3
OG0027561	0	1	1	1	3
OG0027562	0	1	1	1	3
OG0027563	0	3	0	0	3
OG0027564	0	3	0	0	3
OG0027565	0	1	1	1	3
OG0027566	0	1	0	2	3
OG0027567	0	1	1	1	3
OG0027568	0	1	0	2	3
OG0027569	0	1	1	1	3
OG0027570	0	1	1	1	3
OG0027571	0	1	1	1	3
OG0027572	0	1	1	1	3
OG0027573	0	1	0	2	3
OG0027574	0	1	1	1	3
OG0027575	0	1	0	2	3
OG0027576	0	1	1	1	3
OG0027577	0	1	1	1	3
OG0027578	0	1	1	1	3
OG0027579	0	2	1	0	3
OG0027580	0	2	0	1	3
OG0027581	0	1	1	1	3
OG0027582	0	1	1	1	3
OG0027583	0	1	1	1	3
OG0027584	0	0	3	0	3
OG0027585	0	0	3	0	3
OG0027586	0	0	3	0	3
OG0027587	0	0	2	1	3
OG0027588	0	0	2	1	3
OG0027589	0	0	1	2	3
OG0027590	0	0	3	0	3
OG0027591	0	0	2	1	3
OG0027592	0	0	1	2	3
OG0027593	0	0	3	0	3
OG0027594	0	0	2	1	3
OG0027595	0	0	2	1	3
OG0027596	0	0	2	1	3
OG0027597	0	0	1	2	3
OG0027598	0	0	3	0	3
OG0027599	0	0	3	0	3
OG0027600	0	0	3	0	3
OG0027601	0	0	3	0	3
OG0027602	0	0	2	1	3
OG0027603	0	0	2	1	3
OG0027604	0	0	2	1	3
OG0027605	0	0	3	0	3
OG0027606	0	0	2	1	3
OG0027607	0	0	3	0	3
OG0027608	0	0	2	1	3
OG0027609	0	0	3	0	3
OG0027610	0	0	3	0	3
OG0027611	0	0	2	1	3
OG0027612	0	0	3	0	3
OG0027613	0	0	2	1	3
OG0027614	0	0	2	1	3
OG0027615	0	0	3	0	3
OG0027616	0	0	2	1	3
OG0027617	0	0	3	0	3
OG0027618	0	0	3	0	3
OG0027619	0	0	3	0	3
OG0027620	0	0	2	1	3
OG0027621	0	0	2	1	3
OG0027622	0	0	3	0	3
OG0027623	0	0	3	0	3
OG0027624	0	0	2	1	3
OG0027625	0	0	3	0	3
OG0027626	0	0	2	1	3
OG0027627	0	0	1	2	3
OG0027628	0	0	1	2	3
OG0027629	0	0	1	2	3
OG0027630	0	0	3	0	3
OG0027631	0	0	2	1	3
OG0027632	0	0	3	0	3
OG0027633	0	0	3	0	3
OG0027634	0	0	2	1	3
OG0027635	0	0	2	1	3
OG0027636	0	0	2	1	3
OG0027637	0	0	3	0	3
OG0027638	0	0	2	1	3
OG0027639	0	0	2	1	3
OG0027640	0	0	3	0	3
OG0027641	0	0	2	1	3
OG0027642	0	0	1	2	3
OG0027643	0	0	1	2	3
OG0027644	0	0	1	2	3
OG0027645	0	0	1	2	3
OG0027646	0	0	1	2	3
OG0027647	0	0	2	1	3
OG0027648	0	0	2	1	3
OG0027649	0	0	3	0	3
OG0027650	0	0	1	2	3
OG0027651	0	0	2	1	3
OG0027652	0	0	1	2	3
OG0027653	0	0	1	2	3
OG0027654	0	0	1	2	3
OG0027655	0	0	3	0	3
OG0027656	0	0	2	1	3
OG0027657	0	0	3	0	3
OG0027658	0	0	2	1	3
OG0027659	0	0	2	1	3
OG0027660	0	0	1	2	3
OG0027661	0	0	1	2	3
OG0027662	0	0	2	1	3
OG0027663	0	0	2	1	3
OG0027664	0	0	1	2	3
OG0027665	0	0	3	0	3
OG0027666	0	0	1	2	3
OG0027667	0	0	2	1	3
OG0027668	0	0	2	1	3
OG0027669	0	0	3	0	3
OG0027670	0	0	1	2	3
OG0027671	0	0	3	0	3
OG0027672	0	0	3	0	3
OG0027673	0	0	1	2	3
OG0027674	0	0	3	0	3
OG0027675	0	0	1	2	3
OG0027676	0	0	1	2	3
OG0027677	0	0	2	1	3
OG0027678	0	0	1	2	3
OG0027679	0	0	3	0	3
OG0027680	0	0	3	0	3
OG0027681	0	0	2	1	3
OG0027682	0	0	1	2	3
OG0027683	0	0	1	2	3
OG0027684	0	0	3	0	3
OG0027685	0	0	1	2	3
OG0027686	0	0	1	2	3
OG0027687	0	0	3	0	3
OG0027688	0	0	3	0	3
OG0027689	0	0	2	1	3
OG0027690	0	0	2	1	3
OG0027691	0	0	2	1	3
OG0027692	0	0	2	1	3
OG0027693	0	0	1	2	3
OG0027694	0	0	1	2	3
OG0027695	0	0	2	1	3
OG0027696	0	0	1	2	3
OG0027697	0	0	3	0	3
OG0027698	0	0	1	2	3
OG0027699	0	0	2	1	3
OG0027700	0	0	1	2	3
OG0027701	0	0	2	1	3
OG0027702	0	0	1	2	3
OG0027703	0	0	2	1	3
OG0027704	0	0	2	1	3
OG0027705	0	0	1	2	3
OG0027706	0	0	2	1	3
OG0027707	0	0	2	1	3
OG0027708	0	0	3	0	3
OG0027709	0	0	3	0	3
OG0027710	0	0	2	1	3
OG0027711	0	0	1	2	3
OG0027712	0	0	1	2	3
OG0027713	0	0	2	1	3
OG0027714	0	0	2	1	3
OG0027715	0	0	1	2	3
OG0027716	0	0	1	2	3
OG0027717	0	0	2	1	3
OG0027718	0	0	3	0	3
OG0027719	0	0	2	1	3
OG0027720	0	0	1	2	3
OG0027721	0	0	1	2	3
OG0027722	0	0	2	1	3
OG0027723	0	0	3	0	3
OG0027724	0	0	3	0	3
OG0027725	0	0	3	0	3
OG0027726	0	0	1	2	3
OG0027727	0	0	1	2	3
OG0027728	0	0	1	2	3
OG0027729	0	0	2	1	3
OG0027730	0	0	1	2	3
OG0027731	0	0	1	2	3
OG0027732	0	0	1	2	3
OG0027733	0	0	3	0	3
OG0027734	0	0	1	2	3
OG0027735	0	0	1	2	3
OG0027736	0	0	2	1	3
OG0027737	0	0	3	0	3
OG0027738	0	0	3	0	3
OG0027739	0	0	1	2	3
OG0027740	0	0	1	2	3
OG0027741	0	0	3	0	3
OG0027742	0	0	3	0	3
OG0027743	0	0	1	2	3
OG0027744	0	0	1	2	3
OG0027745	0	0	3	0	3
OG0027746	0	0	3	0	3
OG0027747	0	0	3	0	3
OG0027748	0	0	2	1	3
OG0027749	0	0	2	1	3
OG0027750	0	0	1	2	3
OG0027751	0	0	2	1	3
OG0027752	0	0	1	2	3
OG0027753	0	0	1	2	3
OG0027754	0	0	1	2	3
OG0027755	0	0	1	2	3
OG0027756	0	0	2	1	3
OG0027757	0	0	1	2	3
OG0027758	0	0	1	2	3
OG0027759	0	0	3	0	3
OG0027760	0	0	2	1	3
OG0027761	0	0	1	2	3
OG0027762	0	0	2	1	3
OG0027763	0	0	2	1	3
OG0027764	0	0	2	1	3
OG0027765	0	0	2	1	3
OG0027766	0	0	2	1	3
OG0027767	0	0	2	1	3
OG0027768	0	0	2	1	3
OG0027769	0	0	2	1	3
OG0027770	0	0	2	1	3
OG0027771	0	0	1	2	3
OG0027772	0	0	1	2	3
OG0027773	0	0	2	1	3
OG0027774	0	0	1	2	3
OG0027775	0	0	3	0	3
OG0027776	0	0	1	2	3
OG0027777	0	0	1	2	3
OG0027778	0	0	2	1	3
OG0027779	0	0	1	2	3
OG0027780	0	0	2	1	3
OG0027781	0	0	2	1	3
OG0027782	0	0	3	0	3
OG0027783	0	0	2	1	3
OG0027784	0	0	3	0	3
OG0027785	0	0	2	1	3
OG0027786	0	0	2	1	3
OG0027787	0	0	2	1	3
OG0027788	0	0	1	2	3
OG0027789	0	0	2	1	3
OG0027790	0	0	2	1	3
OG0027791	0	0	2	1	3
OG0027792	0	0	2	1	3
OG0027793	0	0	1	2	3
OG0027794	0	0	1	2	3
OG0027795	0	0	2	1	3
OG0027796	0	0	1	2	3
OG0027797	0	0	2	1	3
OG0027798	0	0	2	1	3
OG0027799	0	0	1	2	3
OG0027800	0	0	2	1	3
OG0027801	0	0	2	1	3
OG0027802	0	0	1	2	3
OG0027803	0	0	1	2	3
OG0027804	0	0	1	2	3
OG0027805	0	0	1	2	3
OG0027806	0	0	3	0	3
OG0027807	0	0	2	1	3
OG0027808	0	0	2	1	3
OG0027809	0	0	1	2	3
OG0027810	0	0	2	1	3
OG0027811	0	0	3	0	3
OG0027812	0	0	3	0	3
OG0027813	0	0	1	2	3
OG0027814	0	0	1	2	3
OG0027815	0	0	2	1	3
OG0027816	0	0	3	0	3
OG0027817	0	0	2	1	3
OG0027818	0	0	1	2	3
OG0027819	0	0	2	1	3
OG0027820	0	0	2	1	3
OG0027821	0	0	3	0	3
OG0027822	0	0	2	1	3
OG0027823	0	0	1	2	3
OG0027824	0	0	1	2	3
OG0027825	0	0	1	2	3
OG0027826	0	0	1	2	3
OG0027827	0	0	3	0	3
OG0027828	0	0	3	0	3
OG0027829	0	0	3	0	3
OG0027830	0	0	1	2	3
OG0027831	0	0	2	1	3
OG0027832	0	0	2	1	3
OG0027833	0	0	1	2	3
OG0027834	0	0	2	1	3
OG0027835	0	0	3	0	3
OG0027836	0	0	2	1	3
OG0027837	0	0	1	2	3
OG0027838	0	0	2	1	3
OG0027839	0	0	1	2	3
OG0027840	0	0	1	2	3
OG0027841	0	0	2	1	3
OG0027842	0	0	1	2	3
OG0027843	0	0	1	2	3
OG0027844	0	0	1	2	3
OG0027845	0	0	2	1	3
OG0027846	0	0	3	0	3
OG0027847	0	0	2	1	3
OG0027848	0	0	2	1	3
OG0027849	0	0	2	1	3
OG0027850	0	0	1	2	3
OG0027851	0	0	1	2	3
OG0027852	0	0	2	1	3
OG0027853	0	0	1	2	3
OG0027854	0	0	2	1	3
OG0027855	0	0	3	0	3
OG0027856	0	0	1	2	3
OG0027857	0	0	3	0	3
OG0027858	0	0	1	2	3
OG0027859	0	0	1	2	3
OG0027860	0	0	2	1	3
OG0027861	0	0	3	0	3
OG0027862	0	0	1	2	3
OG0027863	0	0	1	2	3
OG0027864	0	0	1	2	3
OG0027865	0	0	3	0	3
OG0027866	0	0	1	2	3
OG0027867	0	0	1	2	3
OG0027868	0	0	1	2	3
OG0027869	0	0	3	0	3
OG0027870	0	0	2	1	3
OG0027871	0	0	1	2	3
OG0027872	0	0	1	2	3
OG0027873	0	0	2	1	3
OG0027874	0	0	1	2	3
OG0027875	0	0	1	2	3
OG0027876	0	0	2	1	3
OG0027877	0	0	1	2	3
OG0027878	0	0	2	1	3
OG0027879	0	0	2	1	3
OG0027880	0	0	2	1	3
OG0027881	0	0	2	1	3
OG0027882	0	0	3	0	3
OG0027883	0	0	2	1	3
OG0027884	0	0	2	1	3
OG0027885	0	0	3	0	3
OG0027886	0	0	2	1	3
OG0027887	0	0	3	0	3
OG0027888	0	0	1	2	3
OG0027889	0	0	1	2	3
OG0027890	0	0	1	2	3
OG0027891	0	0	3	0	3
OG0027892	0	0	2	1	3
OG0027893	0	0	1	2	3
OG0027894	0	0	3	0	3
OG0027895	0	0	3	0	3
OG0027896	0	0	3	0	3
OG0027897	0	0	3	0	3
OG0027898	0	0	2	1	3
OG0027899	0	0	2	1	3
OG0027900	0	0	1	2	3
OG0027901	0	0	3	0	3
OG0027902	0	0	1	2	3
OG0027903	0	0	1	2	3
OG0027904	0	0	1	2	3
OG0027905	0	0	2	1	3
OG0027906	0	0	2	1	3
OG0027907	0	0	1	2	3
OG0027908	0	0	1	2	3
OG0027909	0	0	1	2	3
OG0027910	0	0	2	1	3
OG0027911	0	0	2	1	3
OG0027912	0	0	3	0	3
OG0027913	0	0	3	0	3
OG0027914	0	0	1	2	3
OG0027915	0	0	1	2	3
OG0027916	0	0	2	1	3
OG0027917	0	0	3	0	3
OG0027918	0	0	2	1	3
OG0027919	0	0	1	2	3
OG0027920	0	0	3	0	3
OG0027921	0	0	1	2	3
OG0027922	0	0	2	1	3
OG0027923	0	0	1	2	3
OG0027924	0	0	2	1	3
OG0027925	0	0	1	2	3
OG0027926	0	0	1	2	3
OG0027927	0	0	2	1	3
OG0027928	0	0	1	2	3
OG0027929	0	0	2	1	3
OG0027930	0	0	1	2	3
OG0027931	0	0	2	1	3
OG0027932	0	0	2	1	3
OG0027933	0	0	3	0	3
OG0027934	0	0	3	0	3
OG0027935	0	0	3	0	3
OG0027936	0	0	2	1	3
OG0027937	0	0	2	1	3
OG0027938	0	0	1	2	3
OG0027939	0	0	2	1	3
OG0027940	0	0	1	2	3
OG0027941	0	0	2	1	3
OG0027942	0	0	2	1	3
OG0027943	0	0	1	2	3
OG0027944	0	0	1	2	3
OG0027945	0	0	3	0	3
OG0027946	0	0	2	1	3
OG0027947	0	0	1	2	3
OG0027948	0	0	1	2	3
OG0027949	0	0	3	0	3
OG0027950	0	0	2	1	3
OG0027951	0	0	1	2	3
OG0027952	0	0	1	2	3
OG0027953	0	0	1	2	3
OG0027954	0	0	1	2	3
OG0027955	0	0	1	2	3
OG0027956	0	0	2	1	3
OG0027957	0	0	1	2	3
OG0027958	0	0	3	0	3
OG0027959	0	0	2	1	3
OG0027960	0	0	2	1	3
OG0027961	0	0	2	1	3
OG0027962	0	0	2	1	3
OG0027963	0	0	2	1	3
OG0027964	0	0	2	1	3
OG0027965	0	0	1	2	3
OG0027966	0	0	2	1	3
OG0027967	0	0	2	1	3
OG0027968	0	0	2	1	3
OG0027969	0	0	2	1	3
OG0027970	0	0	1	2	3
OG0027971	0	0	3	0	3
OG0027972	0	0	2	1	3
OG0027973	0	0	2	1	3
OG0027974	0	0	3	0	3
OG0027975	0	0	3	0	3
OG0027976	0	0	2	1	3
OG0027977	0	0	2	1	3
OG0027978	0	0	3	0	3
OG0027979	0	0	1	2	3
OG0027980	0	0	2	1	3
OG0027981	0	0	2	1	3
OG0027982	0	0	1	2	3
OG0027983	0	0	1	2	3
OG0027984	0	0	3	0	3
OG0027985	0	0	1	2	3
OG0027986	0	0	1	2	3
OG0027987	0	0	2	1	3
OG0027988	0	0	2	1	3
OG0027989	0	0	1	2	3
OG0027990	0	0	1	2	3
OG0027991	0	0	2	1	3
OG0027992	0	0	2	1	3
OG0027993	0	0	1	2	3
OG0027994	0	0	2	1	3
OG0027995	0	0	1	2	3
OG0027996	0	0	2	1	3
OG0027997	0	0	2	1	3
OG0027998	0	0	2	1	3
OG0027999	0	0	2	1	3
OG0028000	0	0	1	2	3
OG0028001	0	0	2	1	3
OG0028002	0	0	3	0	3
OG0028003	0	0	1	2	3
OG0028004	0	0	2	1	3
OG0028005	0	0	1	2	3
OG0028006	0	0	2	1	3
OG0028007	0	0	2	1	3
OG0028008	0	0	2	1	3
OG0028009	0	0	2	1	3
OG0028010	0	0	2	1	3
OG0028011	0	0	2	1	3
OG0028012	0	0	2	1	3
OG0028013	0	0	2	1	3
OG0028014	0	0	3	0	3
OG0028015	0	0	1	2	3
OG0028016	0	0	1	2	3
OG0028017	0	0	1	2	3
OG0028018	0	0	2	1	3
OG0028019	0	0	2	1	3
OG0028020	0	0	2	1	3
OG0028021	0	0	2	1	3
OG0028022	0	0	1	2	3
OG0028023	0	0	2	1	3
OG0028024	0	0	1	2	3
OG0028025	0	0	2	1	3
OG0028026	0	0	3	0	3
OG0028027	0	0	2	1	3
OG0028028	0	0	1	2	3
OG0028029	0	0	1	2	3
OG0028030	0	0	2	1	3
OG0028031	0	0	3	0	3
OG0028032	0	0	1	2	3
OG0028033	0	0	2	1	3
OG0028034	0	0	1	2	3
OG0028035	0	0	1	2	3
OG0028036	0	0	2	1	3
OG0028037	0	0	1	2	3
OG0028038	0	0	1	2	3
OG0028039	0	0	1	2	3
OG0028040	0	0	2	1	3
OG0028041	0	0	1	2	3
OG0028042	0	0	2	1	3
OG0028043	0	0	2	1	3
OG0028044	0	0	1	2	3
OG0028045	0	0	1	2	3
OG0028046	0	0	1	2	3
OG0028047	0	0	2	1	3
OG0028048	0	0	1	2	3
OG0028049	0	0	3	0	3
OG0028050	0	0	1	2	3
OG0028051	0	0	1	2	3
OG0028052	0	0	3	0	3
OG0028053	0	0	3	0	3
OG0028054	0	0	1	2	3
OG0028055	0	0	3	0	3
OG0028056	0	0	2	1	3
OG0028057	0	0	1	2	3
OG0028058	0	0	1	2	3
OG0028059	0	0	2	1	3
OG0028060	0	0	1	2	3
OG0028061	0	0	3	0	3
OG0028062	0	0	2	1	3
OG0028063	0	0	1	2	3
OG0028064	0	0	1	2	3
OG0028065	0	0	2	1	3
OG0028066	0	0	2	1	3
OG0028067	0	0	2	1	3
OG0028068	0	0	1	2	3
OG0028069	0	0	3	0	3
OG0028070	0	0	2	1	3
OG0028071	0	0	1	2	3
OG0028072	0	0	3	0	3
OG0028073	0	0	2	1	3
OG0028074	0	0	2	1	3
OG0028075	0	0	3	0	3
OG0028076	0	0	3	0	3
OG0028077	0	0	3	0	3
OG0028078	0	0	1	2	3
OG0028079	0	0	1	2	3
OG0028080	0	0	2	1	3
OG0028081	0	0	1	2	3
OG0028082	0	0	2	1	3
OG0028083	0	0	1	2	3
OG0028084	0	0	1	2	3
OG0028085	0	0	1	2	3
OG0028086	0	0	2	1	3
OG0028087	0	0	1	2	3
OG0028088	0	0	3	0	3
OG0028089	0	0	1	2	3
OG0028090	0	0	1	2	3
OG0028091	0	0	1	2	3
OG0028092	0	0	2	1	3
OG0028093	0	0	1	2	3
OG0028094	0	0	2	1	3
OG0028095	0	0	1	2	3
OG0028096	0	0	2	1	3
OG0028097	0	0	1	2	3
OG0028098	0	0	2	1	3
OG0028099	0	0	1	2	3
OG0028100	0	0	1	2	3
OG0028101	0	0	2	1	3
OG0028102	0	0	1	2	3
OG0028103	0	0	1	2	3
OG0028104	0	0	2	1	3
OG0028105	0	0	1	2	3
OG0028106	0	0	3	0	3
OG0028107	0	0	2	1	3
OG0028108	0	0	3	0	3
OG0028109	0	0	2	1	3
OG0028110	0	0	2	1	3
OG0028111	0	0	2	1	3
OG0028112	0	0	1	2	3
OG0028113	0	0	2	1	3
OG0028114	0	0	1	2	3
OG0028115	0	0	1	2	3
OG0028116	0	0	1	2	3
OG0028117	0	0	1	2	3
OG0028118	0	0	1	2	3
OG0028119	0	0	2	1	3
OG0028120	0	0	1	2	3
OG0028121	0	0	2	1	3
OG0028122	0	0	1	2	3
OG0028123	0	0	2	1	3
OG0028124	0	0	2	1	3
OG0028125	0	0	1	2	3
OG0028126	0	0	1	2	3
OG0028127	0	0	2	1	3
OG0028128	0	0	1	2	3
OG0028129	0	0	2	1	3
OG0028130	0	0	2	1	3
OG0028131	0	0	1	2	3
OG0028132	0	0	3	0	3
OG0028133	0	0	2	1	3
OG0028134	0	0	1	2	3
OG0028135	0	0	2	1	3
OG0028136	0	0	3	0	3
OG0028137	0	0	2	1	3
OG0028138	0	0	2	1	3
OG0028139	0	0	1	2	3
OG0028140	0	0	3	0	3
OG0028141	0	0	1	2	3
OG0028142	0	0	2	1	3
OG0028143	0	0	1	2	3
OG0028144	0	0	1	2	3
OG0028145	0	0	1	2	3
OG0028146	0	0	2	1	3
OG0028147	0	0	2	1	3
OG0028148	0	0	3	0	3
OG0028149	0	0	2	1	3
OG0028150	0	0	1	2	3
OG0028151	0	0	1	2	3
OG0028152	0	0	2	1	3
OG0028153	0	0	1	2	3
OG0028154	0	0	1	2	3
OG0028155	0	0	2	1	3
OG0028156	0	0	1	2	3
OG0028157	0	0	3	0	3
OG0028158	0	0	1	2	3
OG0028159	0	0	3	0	3
OG0028160	0	0	2	1	3
OG0028161	0	0	1	2	3
OG0028162	0	0	1	2	3
OG0028163	0	0	2	1	3
OG0028164	0	0	3	0	3
OG0028165	0	0	1	2	3
OG0028166	0	0	1	2	3
OG0028167	0	0	1	2	3
OG0028168	0	0	2	1	3
OG0028169	0	0	1	2	3
OG0028170	0	0	1	2	3
OG0028171	0	0	2	1	3
OG0028172	0	0	2	1	3
OG0028173	0	0	2	1	3
OG0028174	0	0	1	2	3
OG0028175	0	0	1	2	3
OG0028176	0	0	2	1	3
OG0028177	0	0	2	1	3
OG0028178	0	0	1	2	3
OG0028179	0	0	2	1	3
OG0028180	0	0	2	1	3
OG0028181	0	0	3	0	3
OG0028182	0	0	1	2	3
OG0028183	0	0	3	0	3
OG0028184	0	0	1	2	3
OG0028185	0	0	1	2	3
OG0028186	0	0	1	2	3
OG0028187	0	0	1	2	3
OG0028188	0	0	1	2	3
OG0028189	0	0	3	0	3
OG0028190	0	0	2	1	3
OG0028191	0	0	0	3	3
OG0028192	0	0	0	3	3
OG0028193	0	0	0	3	3
OG0028194	0	0	0	3	3
OG0028195	0	0	0	3	3
OG0028196	0	0	0	3	3
OG0028197	0	0	0	3	3
OG0028198	0	0	0	3	3
OG0028199	0	0	0	3	3
OG0028200	0	0	0	3	3
OG0028201	0	0	0	3	3
OG0028202	0	0	0	3	3
OG0028203	0	0	0	3	3
OG0028204	0	0	0	3	3
OG0028205	0	0	0	3	3
OG0028206	0	0	0	3	3
OG0028207	0	0	0	3	3
OG0028208	0	0	0	3	3
OG0028209	0	0	0	3	3
OG0028210	0	0	0	3	3
OG0028211	0	0	0	3	3
OG0028212	0	0	0	3	3
OG0028213	0	0	0	3	3
OG0028214	0	0	0	3	3
OG0028215	0	0	0	3	3
OG0028216	0	0	0	3	3
OG0028217	0	0	0	3	3
OG0028218	0	0	0	3	3
OG0028219	0	0	0	3	3
OG0028220	0	0	0	3	3
OG0028221	0	0	0	3	3
OG0028222	0	0	0	3	3
OG0028223	0	0	0	3	3
OG0028224	0	0	0	3	3
OG0028225	0	0	0	3	3
OG0028226	0	0	0	3	3
OG0028227	0	0	0	3	3
OG0028228	0	0	0	3	3
OG0028229	0	0	0	3	3
OG0028230	0	0	0	3	3
OG0028231	0	0	0	3	3
OG0028232	0	0	0	3	3
OG0028233	0	0	0	3	3
OG0028234	0	0	0	3	3
OG0028235	0	0	0	3	3
OG0028236	0	0	0	3	3
OG0028237	0	0	0	3	3
OG0028238	0	0	0	3	3
OG0028239	0	0	0	3	3
OG0028240	0	0	0	3	3
OG0028241	0	0	0	3	3
OG0028242	0	0	0	3	3
OG0028243	0	0	0	3	3
OG0028244	0	0	0	3	3
OG0028245	0	0	0	3	3
OG0028246	0	0	0	3	3
OG0028247	0	0	0	3	3
OG0028248	0	0	0	3	3
OG0028249	0	0	0	3	3
OG0028250	0	0	0	3	3
OG0028251	0	0	0	3	3
OG0028252	0	0	0	3	3
OG0028253	0	0	0	3	3
OG0028254	0	0	0	3	3
OG0028255	0	0	0	3	3
OG0028256	0	0	0	3	3
OG0028257	0	0	0	3	3
OG0028258	0	0	0	3	3
OG0028259	0	0	0	3	3
OG0028260	0	0	0	3	3
OG0028261	0	0	0	3	3
OG0028262	0	0	0	3	3
OG0028263	0	0	0	3	3
OG0028264	0	0	0	3	3
OG0028265	0	0	0	3	3
OG0028266	0	0	0	3	3
OG0028267	0	0	0	3	3
OG0028268	0	0	0	3	3
OG0028269	0	0	0	3	3
OG0028270	0	0	0	3	3
OG0028271	0	0	0	3	3
OG0028272	0	0	0	3	3
OG0028273	0	0	0	3	3
OG0028274	0	0	0	3	3
OG0028275	0	0	0	3	3
OG0028276	0	0	0	3	3
OG0028277	0	0	0	3	3
OG0028278	0	0	0	3	3
OG0028279	0	0	0	3	3
OG0028280	0	0	0	3	3
OG0028281	0	0	0	3	3
OG0028282	0	0	0	3	3
OG0028283	0	0	0	3	3
OG0028284	0	0	0	3	3
OG0028285	0	0	0	3	3
OG0028286	0	0	0	3	3
OG0028287	0	0	0	3	3
OG0028288	0	0	0	3	3
OG0028289	0	0	0	3	3
OG0028290	0	0	0	3	3
OG0028291	0	0	0	3	3
OG0028292	0	0	0	3	3
OG0028293	0	0	0	3	3
OG0028294	0	0	0	3	3
OG0028295	0	0	0	3	3
OG0028296	0	0	0	3	3
OG0028297	0	0	0	3	3
OG0028298	0	0	0	3	3
OG0028299	0	0	0	3	3
OG0028300	0	0	0	3	3
OG0028301	0	0	0	3	3
OG0028302	0	0	0	3	3
OG0028303	0	0	0	3	3
OG0028304	0	0	0	3	3
OG0028305	0	0	0	3	3
OG0028306	0	0	0	3	3
OG0028307	0	0	0	3	3
OG0028308	0	0	0	3	3
OG0028309	0	0	0	3	3
OG0028310	0	0	0	3	3
OG0028311	0	0	0	3	3
OG0028312	0	0	0	3	3
OG0028313	0	0	0	3	3
OG0028314	0	0	0	3	3
OG0028315	0	0	0	3	3
OG0028316	0	0	0	3	3
OG0028317	0	0	0	3	3
OG0028318	0	0	0	3	3
OG0028319	0	0	0	3	3
OG0028320	0	0	0	3	3
OG0028321	0	0	0	3	3
OG0028322	0	0	0	3	3
OG0028323	0	0	0	3	3
OG0028324	0	0	0	3	3
OG0028325	0	0	0	3	3
OG0028326	0	0	0	3	3
OG0028327	0	0	0	3	3
OG0028328	0	0	0	3	3
OG0028329	0	0	0	3	3
OG0028330	0	0	0	3	3
OG0028331	0	0	0	3	3
OG0028332	0	0	0	3	3
OG0028333	0	0	0	3	3
OG0028334	0	0	0	3	3
OG0028335	0	0	0	3	3
OG0028336	0	0	0	3	3
OG0028337	0	0	0	3	3
OG0028338	0	0	0	3	3
OG0028339	0	0	0	3	3
OG0028340	0	0	0	3	3
OG0028341	0	0	0	3	3
OG0028342	0	0	0	3	3
OG0028343	0	0	0	3	3
OG0028344	0	0	0	3	3
OG0028345	0	0	0	3	3
OG0028346	0	0	0	3	3
OG0028347	0	0	0	3	3
OG0028348	0	0	0	3	3
OG0028349	0	0	0	3	3
OG0028350	0	0	0	3	3
OG0028351	0	0	0	3	3
OG0028352	0	0	0	3	3
OG0028353	0	0	0	3	3
OG0028354	0	0	0	3	3
OG0028355	0	0	0	3	3
OG0028356	0	0	0	3	3
OG0028357	0	0	0	3	3
OG0028358	0	0	0	3	3
OG0028359	0	0	0	3	3
OG0028360	0	0	0	3	3
OG0028361	0	0	0	3	3
OG0028362	0	0	0	3	3
OG0028363	0	0	0	3	3
OG0028364	0	0	0	3	3
OG0028365	0	0	0	3	3
OG0028366	0	0	0	3	3
OG0028367	0	0	0	3	3
OG0028368	0	0	0	3	3
OG0028369	0	0	0	3	3
OG0028370	0	0	0	3	3
OG0028371	0	0	0	3	3
OG0028372	0	0	0	3	3
OG0028373	0	0	0	3	3
OG0028374	0	0	0	3	3
OG0028375	0	0	0	3	3
OG0028376	0	0	0	3	3
OG0028377	0	0	0	3	3
OG0028378	0	0	0	3	3
OG0028379	0	0	0	3	3
OG0028380	0	0	0	3	3
OG0028381	0	0	0	3	3
OG0028382	0	0	0	3	3
OG0028383	0	0	0	3	3
OG0028384	0	0	0	3	3
OG0028385	0	0	0	3	3
OG0028386	0	0	0	3	3
OG0028387	0	0	0	3	3
OG0028388	0	0	0	3	3
OG0028389	0	0	0	3	3
OG0028390	0	0	0	3	3
OG0028391	0	0	0	3	3
OG0028392	0	0	0	3	3
OG0028393	0	0	0	3	3
OG0028394	0	0	0	3	3
OG0028395	0	0	0	3	3
OG0028396	0	0	0	3	3
OG0028397	2	0	0	0	2
OG0028398	2	0	0	0	2
OG0028399	1	1	0	0	2
OG0028400	2	0	0	0	2
OG0028401	1	1	0	0	2
OG0028402	1	1	0	0	2
OG0028403	1	0	1	0	2
OG0028404	1	1	0	0	2
OG0028405	1	1	0	0	2
OG0028406	2	0	0	0	2
OG0028407	1	1	0	0	2
OG0028408	1	1	0	0	2
OG0028409	2	0	0	0	2
OG0028410	2	0	0	0	2
OG0028411	2	0	0	0	2
OG0028412	1	1	0	0	2
OG0028413	2	0	0	0	2
OG0028414	2	0	0	0	2
OG0028415	1	1	0	0	2
OG0028416	2	0	0	0	2
OG0028417	1	1	0	0	2
OG0028418	1	1	0	0	2
OG0028419	1	1	0	0	2
OG0028420	2	0	0	0	2
OG0028421	1	1	0	0	2
OG0028422	2	0	0	0	2
OG0028423	1	1	0	0	2
OG0028424	2	0	0	0	2
OG0028425	1	1	0	0	2
OG0028426	2	0	0	0	2
OG0028427	2	0	0	0	2
OG0028428	2	0	0	0	2
OG0028429	1	1	0	0	2
OG0028430	1	1	0	0	2
OG0028431	1	1	0	0	2
OG0028432	2	0	0	0	2
OG0028433	2	0	0	0	2
OG0028434	2	0	0	0	2
OG0028435	1	1	0	0	2
OG0028436	1	1	0	0	2
OG0028437	1	1	0	0	2
OG0028438	1	1	0	0	2
OG0028439	1	1	0	0	2
OG0028440	2	0	0	0	2
OG0028441	1	1	0	0	2
OG0028442	1	1	0	0	2
OG0028443	1	1	0	0	2
OG0028444	1	1	0	0	2
OG0028445	1	1	0	0	2
OG0028446	1	1	0	0	2
OG0028447	1	1	0	0	2
OG0028448	1	1	0	0	2
OG0028449	1	1	0	0	2
OG0028450	1	1	0	0	2
OG0028451	1	1	0	0	2
OG0028452	1	1	0	0	2
OG0028453	1	1	0	0	2
OG0028454	2	0	0	0	2
OG0028455	1	1	0	0	2
OG0028456	1	1	0	0	2
OG0028457	1	1	0	0	2
OG0028458	1	1	0	0	2
OG0028459	1	1	0	0	2
OG0028460	2	0	0	0	2
OG0028461	2	0	0	0	2
OG0028462	1	1	0	0	2
OG0028463	1	1	0	0	2
OG0028464	1	1	0	0	2
OG0028465	2	0	0	0	2
OG0028466	2	0	0	0	2
OG0028467	1	1	0	0	2
OG0028468	1	1	0	0	2
OG0028469	2	0	0	0	2
OG0028470	1	1	0	0	2
OG0028471	1	1	0	0	2
OG0028472	1	1	0	0	2
OG0028473	1	1	0	0	2
OG0028474	1	1	0	0	2
OG0028475	1	1	0	0	2
OG0028476	1	1	0	0	2
OG0028477	2	0	0	0	2
OG0028478	1	1	0	0	2
OG0028479	1	0	0	1	2
OG0028480	2	0	0	0	2
OG0028481	1	1	0	0	2
OG0028482	1	1	0	0	2
OG0028483	2	0	0	0	2
OG0028484	2	0	0	0	2
OG0028485	2	0	0	0	2
OG0028486	1	1	0	0	2
OG0028487	2	0	0	0	2
OG0028488	1	1	0	0	2
OG0028489	1	1	0	0	2
OG0028490	1	1	0	0	2
OG0028491	1	1	0	0	2
OG0028492	1	1	0	0	2
OG0028493	2	0	0	0	2
OG0028494	2	0	0	0	2
OG0028495	1	0	0	1	2
OG0028496	1	1	0	0	2
OG0028497	1	1	0	0	2
OG0028498	2	0	0	0	2
OG0028499	2	0	0	0	2
OG0028500	1	1	0	0	2
OG0028501	1	1	0	0	2
OG0028502	1	0	0	1	2
OG0028503	1	1	0	0	2
OG0028504	1	1	0	0	2
OG0028505	1	1	0	0	2
OG0028506	1	0	0	1	2
OG0028507	1	1	0	0	2
OG0028508	1	0	0	1	2
OG0028509	1	1	0	0	2
OG0028510	1	1	0	0	2
OG0028511	1	1	0	0	2
OG0028512	1	0	1	0	2
OG0028513	1	1	0	0	2
OG0028514	1	1	0	0	2
OG0028515	1	1	0	0	2
OG0028516	1	1	0	0	2
OG0028517	1	1	0	0	2
OG0028518	1	1	0	0	2
OG0028519	1	1	0	0	2
OG0028520	2	0	0	0	2
OG0028521	1	1	0	0	2
OG0028522	2	0	0	0	2
OG0028523	1	1	0	0	2
OG0028524	1	0	1	0	2
OG0028525	1	1	0	0	2
OG0028526	1	1	0	0	2
OG0028527	1	1	0	0	2
OG0028528	1	1	0	0	2
OG0028529	1	1	0	0	2
OG0028530	1	1	0	0	2
OG0028531	2	0	0	0	2
OG0028532	2	0	0	0	2
OG0028533	1	1	0	0	2
OG0028534	1	1	0	0	2
OG0028535	1	0	0	1	2
OG0028536	1	0	1	0	2
OG0028537	1	1	0	0	2
OG0028538	1	1	0	0	2
OG0028539	1	1	0	0	2
OG0028540	1	0	1	0	2
OG0028541	1	0	0	1	2
OG0028542	1	1	0	0	2
OG0028543	2	0	0	0	2
OG0028544	2	0	0	0	2
OG0028545	1	1	0	0	2
OG0028546	2	0	0	0	2
OG0028547	1	1	0	0	2
OG0028548	1	1	0	0	2
OG0028549	1	1	0	0	2
OG0028550	1	1	0	0	2
OG0028551	1	1	0	0	2
OG0028552	1	1	0	0	2
OG0028553	1	1	0	0	2
OG0028554	1	1	0	0	2
OG0028555	1	1	0	0	2
OG0028556	1	1	0	0	2
OG0028557	1	1	0	0	2
OG0028558	1	1	0	0	2
OG0028559	1	0	1	0	2
OG0028560	1	1	0	0	2
OG0028561	1	1	0	0	2
OG0028562	1	1	0	0	2
OG0028563	1	1	0	0	2
OG0028564	1	1	0	0	2
OG0028565	1	1	0	0	2
OG0028566	1	1	0	0	2
OG0028567	1	1	0	0	2
OG0028568	1	1	0	0	2
OG0028569	1	0	0	1	2
OG0028570	2	0	0	0	2
OG0028571	1	1	0	0	2
OG0028572	1	0	0	1	2
OG0028573	1	1	0	0	2
OG0028574	1	1	0	0	2
OG0028575	1	1	0	0	2
OG0028576	1	0	0	1	2
OG0028577	1	1	0	0	2
OG0028578	1	1	0	0	2
OG0028579	1	1	0	0	2
OG0028580	1	1	0	0	2
OG0028581	2	0	0	0	2
OG0028582	1	1	0	0	2
OG0028583	2	0	0	0	2
OG0028584	1	0	0	1	2
OG0028585	1	1	0	0	2
OG0028586	1	1	0	0	2
OG0028587	2	0	0	0	2
OG0028588	2	0	0	0	2
OG0028589	2	0	0	0	2
OG0028590	1	1	0	0	2
OG0028591	1	1	0	0	2
OG0028592	2	0	0	0	2
OG0028593	2	0	0	0	2
OG0028594	2	0	0	0	2
OG0028595	1	1	0	0	2
OG0028596	2	0	0	0	2
OG0028597	1	1	0	0	2
OG0028598	1	1	0	0	2
OG0028599	1	1	0	0	2
OG0028600	1	1	0	0	2
OG0028601	2	0	0	0	2
OG0028602	1	1	0	0	2
OG0028603	1	1	0	0	2
OG0028604	1	1	0	0	2
OG0028605	1	1	0	0	2
OG0028606	1	1	0	0	2
OG0028607	1	1	0	0	2
OG0028608	1	1	0	0	2
OG0028609	2	0	0	0	2
OG0028610	2	0	0	0	2
OG0028611	1	1	0	0	2
OG0028612	1	0	1	0	2
OG0028613	2	0	0	0	2
OG0028614	2	0	0	0	2
OG0028615	1	1	0	0	2
OG0028616	1	1	0	0	2
OG0028617	1	1	0	0	2
OG0028618	1	0	0	1	2
OG0028619	1	1	0	0	2
OG0028620	1	1	0	0	2
OG0028621	1	1	0	0	2
OG0028622	2	0	0	0	2
OG0028623	2	0	0	0	2
OG0028624	1	1	0	0	2
OG0028625	2	0	0	0	2
OG0028626	1	1	0	0	2
OG0028627	1	1	0	0	2
OG0028628	1	1	0	0	2
OG0028629	1	1	0	0	2
OG0028630	2	0	0	0	2
OG0028631	1	1	0	0	2
OG0028632	1	1	0	0	2
OG0028633	1	1	0	0	2
OG0028634	1	1	0	0	2
OG0028635	1	1	0	0	2
OG0028636	2	0	0	0	2
OG0028637	2	0	0	0	2
OG0028638	1	1	0	0	2
OG0028639	1	1	0	0	2
OG0028640	1	1	0	0	2
OG0028641	1	1	0	0	2
OG0028642	1	1	0	0	2
OG0028643	2	0	0	0	2
OG0028644	1	1	0	0	2
OG0028645	1	1	0	0	2
OG0028646	2	0	0	0	2
OG0028647	2	0	0	0	2
OG0028648	2	0	0	0	2
OG0028649	2	0	0	0	2
OG0028650	1	1	0	0	2
OG0028651	2	0	0	0	2
OG0028652	2	0	0	0	2
OG0028653	1	1	0	0	2
OG0028654	2	0	0	0	2
OG0028655	1	1	0	0	2
OG0028656	1	1	0	0	2
OG0028657	2	0	0	0	2
OG0028658	1	1	0	0	2
OG0028659	1	1	0	0	2
OG0028660	1	1	0	0	2
OG0028661	1	1	0	0	2
OG0028662	1	0	1	0	2
OG0028663	1	1	0	0	2
OG0028664	1	1	0	0	2
OG0028665	1	1	0	0	2
OG0028666	2	0	0	0	2
OG0028667	2	0	0	0	2
OG0028668	1	1	0	0	2
OG0028669	2	0	0	0	2
OG0028670	1	1	0	0	2
OG0028671	2	0	0	0	2
OG0028672	1	1	0	0	2
OG0028673	2	0	0	0	2
OG0028674	1	1	0	0	2
OG0028675	1	1	0	0	2
OG0028676	1	1	0	0	2
OG0028677	2	0	0	0	2
OG0028678	1	1	0	0	2
OG0028679	2	0	0	0	2
OG0028680	1	1	0	0	2
OG0028681	1	1	0	0	2
OG0028682	1	0	0	1	2
OG0028683	1	1	0	0	2
OG0028684	1	0	0	1	2
OG0028685	1	0	0	1	2
OG0028686	2	0	0	0	2
OG0028687	2	0	0	0	2
OG0028688	1	1	0	0	2
OG0028689	1	1	0	0	2
OG0028690	2	0	0	0	2
OG0028691	1	1	0	0	2
OG0028692	2	0	0	0	2
OG0028693	1	1	0	0	2
OG0028694	2	0	0	0	2
OG0028695	1	1	0	0	2
OG0028696	1	1	0	0	2
OG0028697	2	0	0	0	2
OG0028698	1	1	0	0	2
OG0028699	2	0	0	0	2
OG0028700	1	1	0	0	2
OG0028701	1	0	1	0	2
OG0028702	1	1	0	0	2
OG0028703	1	1	0	0	2
OG0028704	1	1	0	0	2
OG0028705	1	1	0	0	2
OG0028706	1	1	0	0	2
OG0028707	1	1	0	0	2
OG0028708	1	0	1	0	2
OG0028709	1	1	0	0	2
OG0028710	2	0	0	0	2
OG0028711	2	0	0	0	2
OG0028712	1	1	0	0	2
OG0028713	1	1	0	0	2
OG0028714	2	0	0	0	2
OG0028715	1	0	0	1	2
OG0028716	1	1	0	0	2
OG0028717	2	0	0	0	2
OG0028718	1	1	0	0	2
OG0028719	1	1	0	0	2
OG0028720	1	1	0	0	2
OG0028721	2	0	0	0	2
OG0028722	1	1	0	0	2
OG0028723	1	1	0	0	2
OG0028724	1	1	0	0	2
OG0028725	1	1	0	0	2
OG0028726	1	1	0	0	2
OG0028727	1	1	0	0	2
OG0028728	1	1	0	0	2
OG0028729	1	0	0	1	2
OG0028730	1	1	0	0	2
OG0028731	1	1	0	0	2
OG0028732	1	1	0	0	2
OG0028733	1	1	0	0	2
OG0028734	1	1	0	0	2
OG0028735	1	1	0	0	2
OG0028736	1	1	0	0	2
OG0028737	2	0	0	0	2
OG0028738	2	0	0	0	2
OG0028739	1	1	0	0	2
OG0028740	1	1	0	0	2
OG0028741	1	1	0	0	2
OG0028742	1	1	0	0	2
OG0028743	1	1	0	0	2
OG0028744	1	1	0	0	2
OG0028745	1	1	0	0	2
OG0028746	1	0	0	1	2
OG0028747	1	0	0	1	2
OG0028748	1	1	0	0	2
OG0028749	1	0	0	1	2
OG0028750	2	0	0	0	2
OG0028751	1	1	0	0	2
OG0028752	1	1	0	0	2
OG0028753	1	1	0	0	2
OG0028754	1	1	0	0	2
OG0028755	1	1	0	0	2
OG0028756	1	1	0	0	2
OG0028757	1	0	0	1	2
OG0028758	1	1	0	0	2
OG0028759	1	0	1	0	2
OG0028760	2	0	0	0	2
OG0028761	1	1	0	0	2
OG0028762	1	1	0	0	2
OG0028763	1	1	0	0	2
OG0028764	1	1	0	0	2
OG0028765	2	0	0	0	2
OG0028766	1	1	0	0	2
OG0028767	2	0	0	0	2
OG0028768	2	0	0	0	2
OG0028769	2	0	0	0	2
OG0028770	1	1	0	0	2
OG0028771	1	1	0	0	2
OG0028772	2	0	0	0	2
OG0028773	1	1	0	0	2
OG0028774	2	0	0	0	2
OG0028775	1	0	0	1	2
OG0028776	1	1	0	0	2
OG0028777	1	1	0	0	2
OG0028778	1	1	0	0	2
OG0028779	2	0	0	0	2
OG0028780	2	0	0	0	2
OG0028781	1	1	0	0	2
OG0028782	2	0	0	0	2
OG0028783	1	1	0	0	2
OG0028784	1	1	0	0	2
OG0028785	1	1	0	0	2
OG0028786	2	0	0	0	2
OG0028787	1	1	0	0	2
OG0028788	2	0	0	0	2
OG0028789	2	0	0	0	2
OG0028790	1	1	0	0	2
OG0028791	2	0	0	0	2
OG0028792	1	1	0	0	2
OG0028793	2	0	0	0	2
OG0028794	1	1	0	0	2
OG0028795	2	0	0	0	2
OG0028796	1	1	0	0	2
OG0028797	1	1	0	0	2
OG0028798	2	0	0	0	2
OG0028799	1	1	0	0	2
OG0028800	1	1	0	0	2
OG0028801	1	1	0	0	2
OG0028802	1	1	0	0	2
OG0028803	1	1	0	0	2
OG0028804	2	0	0	0	2
OG0028805	1	1	0	0	2
OG0028806	2	0	0	0	2
OG0028807	1	1	0	0	2
OG0028808	1	1	0	0	2
OG0028809	1	1	0	0	2
OG0028810	1	1	0	0	2
OG0028811	2	0	0	0	2
OG0028812	1	1	0	0	2
OG0028813	1	1	0	0	2
OG0028814	1	1	0	0	2
OG0028815	1	1	0	0	2
OG0028816	1	1	0	0	2
OG0028817	1	1	0	0	2
OG0028818	1	1	0	0	2
OG0028819	1	0	0	1	2
OG0028820	1	1	0	0	2
OG0028821	1	1	0	0	2
OG0028822	1	1	0	0	2
OG0028823	1	1	0	0	2
OG0028824	1	1	0	0	2
OG0028825	2	0	0	0	2
OG0028826	1	0	0	1	2
OG0028827	1	1	0	0	2
OG0028828	1	1	0	0	2
OG0028829	1	1	0	0	2
OG0028830	1	1	0	0	2
OG0028831	1	1	0	0	2
OG0028832	2	0	0	0	2
OG0028833	1	1	0	0	2
OG0028834	2	0	0	0	2
OG0028835	2	0	0	0	2
OG0028836	1	0	0	1	2
OG0028837	1	1	0	0	2
OG0028838	2	0	0	0	2
OG0028839	1	1	0	0	2
OG0028840	1	0	0	1	2
OG0028841	1	1	0	0	2
OG0028842	2	0	0	0	2
OG0028843	1	1	0	0	2
OG0028844	1	1	0	0	2
OG0028845	1	1	0	0	2
OG0028846	1	0	0	1	2
OG0028847	1	1	0	0	2
OG0028848	1	1	0	0	2
OG0028849	1	0	0	1	2
OG0028850	1	1	0	0	2
OG0028851	1	1	0	0	2
OG0028852	2	0	0	0	2
OG0028853	1	1	0	0	2
OG0028854	1	1	0	0	2
OG0028855	1	1	0	0	2
OG0028856	1	1	0	0	2
OG0028857	1	1	0	0	2
OG0028858	1	1	0	0	2
OG0028859	1	1	0	0	2
OG0028860	1	0	0	1	2
OG0028861	1	1	0	0	2
OG0028862	1	1	0	0	2
OG0028863	1	1	0	0	2
OG0028864	2	0	0	0	2
OG0028865	2	0	0	0	2
OG0028866	1	1	0	0	2
OG0028867	1	0	0	1	2
OG0028868	1	1	0	0	2
OG0028869	2	0	0	0	2
OG0028870	1	1	0	0	2
OG0028871	1	1	0	0	2
OG0028872	2	0	0	0	2
OG0028873	2	0	0	0	2
OG0028874	1	1	0	0	2
OG0028875	1	1	0	0	2
OG0028876	1	1	0	0	2
OG0028877	2	0	0	0	2
OG0028878	2	0	0	0	2
OG0028879	1	1	0	0	2
OG0028880	1	1	0	0	2
OG0028881	1	1	0	0	2
OG0028882	1	1	0	0	2
OG0028883	1	0	0	1	2
OG0028884	1	1	0	0	2
OG0028885	2	0	0	0	2
OG0028886	1	1	0	0	2
OG0028887	1	0	1	0	2
OG0028888	2	0	0	0	2
OG0028889	1	1	0	0	2
OG0028890	1	1	0	0	2
OG0028891	1	1	0	0	2
OG0028892	1	1	0	0	2
OG0028893	1	1	0	0	2
OG0028894	1	1	0	0	2
OG0028895	1	1	0	0	2
OG0028896	1	1	0	0	2
OG0028897	1	1	0	0	2
OG0028898	2	0	0	0	2
OG0028899	1	1	0	0	2
OG0028900	1	1	0	0	2
OG0028901	2	0	0	0	2
OG0028902	1	1	0	0	2
OG0028903	2	0	0	0	2
OG0028904	2	0	0	0	2
OG0028905	1	1	0	0	2
OG0028906	1	0	0	1	2
OG0028907	2	0	0	0	2
OG0028908	1	1	0	0	2
OG0028909	2	0	0	0	2
OG0028910	1	1	0	0	2
OG0028911	2	0	0	0	2
OG0028912	1	1	0	0	2
OG0028913	1	0	0	1	2
OG0028914	2	0	0	0	2
OG0028915	1	1	0	0	2
OG0028916	1	1	0	0	2
OG0028917	1	1	0	0	2
OG0028918	2	0	0	0	2
OG0028919	1	1	0	0	2
OG0028920	1	1	0	0	2
OG0028921	1	1	0	0	2
OG0028922	1	1	0	0	2
OG0028923	1	1	0	0	2
OG0028924	1	1	0	0	2
OG0028925	1	1	0	0	2
OG0028926	1	0	0	1	2
OG0028927	1	1	0	0	2
OG0028928	1	1	0	0	2
OG0028929	1	1	0	0	2
OG0028930	2	0	0	0	2
OG0028931	2	0	0	0	2
OG0028932	1	0	0	1	2
OG0028933	1	0	1	0	2
OG0028934	1	1	0	0	2
OG0028935	1	1	0	0	2
OG0028936	1	1	0	0	2
OG0028937	2	0	0	0	2
OG0028938	2	0	0	0	2
OG0028939	1	0	0	1	2
OG0028940	2	0	0	0	2
OG0028941	1	1	0	0	2
OG0028942	1	1	0	0	2
OG0028943	1	1	0	0	2
OG0028944	1	1	0	0	2
OG0028945	1	1	0	0	2
OG0028946	2	0	0	0	2
OG0028947	1	1	0	0	2
OG0028948	2	0	0	0	2
OG0028949	1	1	0	0	2
OG0028950	1	1	0	0	2
OG0028951	1	1	0	0	2
OG0028952	1	1	0	0	2
OG0028953	1	0	0	1	2
OG0028954	2	0	0	0	2
OG0028955	2	0	0	0	2
OG0028956	2	0	0	0	2
OG0028957	1	1	0	0	2
OG0028958	1	1	0	0	2
OG0028959	1	1	0	0	2
OG0028960	1	1	0	0	2
OG0028961	1	1	0	0	2
OG0028962	1	0	1	0	2
OG0028963	1	1	0	0	2
OG0028964	1	1	0	0	2
OG0028965	1	1	0	0	2
OG0028966	1	1	0	0	2
OG0028967	2	0	0	0	2
OG0028968	1	1	0	0	2
OG0028969	2	0	0	0	2
OG0028970	1	1	0	0	2
OG0028971	1	1	0	0	2
OG0028972	1	1	0	0	2
OG0028973	1	1	0	0	2
OG0028974	1	1	0	0	2
OG0028975	1	1	0	0	2
OG0028976	2	0	0	0	2
OG0028977	1	1	0	0	2
OG0028978	1	1	0	0	2
OG0028979	2	0	0	0	2
OG0028980	1	1	0	0	2
OG0028981	1	1	0	0	2
OG0028982	1	1	0	0	2
OG0028983	2	0	0	0	2
OG0028984	1	1	0	0	2
OG0028985	1	1	0	0	2
OG0028986	2	0	0	0	2
OG0028987	1	1	0	0	2
OG0028988	1	1	0	0	2
OG0028989	1	1	0	0	2
OG0028990	1	1	0	0	2
OG0028991	1	1	0	0	2
OG0028992	2	0	0	0	2
OG0028993	1	1	0	0	2
OG0028994	1	1	0	0	2
OG0028995	2	0	0	0	2
OG0028996	2	0	0	0	2
OG0028997	2	0	0	0	2
OG0028998	1	1	0	0	2
OG0028999	1	0	1	0	2
OG0029000	1	1	0	0	2
OG0029001	1	1	0	0	2
OG0029002	1	1	0	0	2
OG0029003	1	1	0	0	2
OG0029004	1	1	0	0	2
OG0029005	1	1	0	0	2
OG0029006	2	0	0	0	2
OG0029007	1	1	0	0	2
OG0029008	1	1	0	0	2
OG0029009	1	0	0	1	2
OG0029010	1	0	0	1	2
OG0029011	2	0	0	0	2
OG0029012	1	1	0	0	2
OG0029013	2	0	0	0	2
OG0029014	1	1	0	0	2
OG0029015	1	1	0	0	2
OG0029016	1	1	0	0	2
OG0029017	2	0	0	0	2
OG0029018	1	1	0	0	2
OG0029019	1	0	0	1	2
OG0029020	1	1	0	0	2
OG0029021	1	1	0	0	2
OG0029022	1	1	0	0	2
OG0029023	1	1	0	0	2
OG0029024	2	0	0	0	2
OG0029025	1	1	0	0	2
OG0029026	1	1	0	0	2
OG0029027	1	1	0	0	2
OG0029028	1	1	0	0	2
OG0029029	1	1	0	0	2
OG0029030	1	1	0	0	2
OG0029031	2	0	0	0	2
OG0029032	1	1	0	0	2
OG0029033	1	1	0	0	2
OG0029034	1	1	0	0	2
OG0029035	1	1	0	0	2
OG0029036	1	1	0	0	2
OG0029037	1	0	0	1	2
OG0029038	1	1	0	0	2
OG0029039	1	1	0	0	2
OG0029040	1	0	0	1	2
OG0029041	1	1	0	0	2
OG0029042	1	0	0	1	2
OG0029043	1	1	0	0	2
OG0029044	2	0	0	0	2
OG0029045	1	1	0	0	2
OG0029046	2	0	0	0	2
OG0029047	1	1	0	0	2
OG0029048	1	1	0	0	2
OG0029049	1	1	0	0	2
OG0029050	1	1	0	0	2
OG0029051	1	0	1	0	2
OG0029052	1	1	0	0	2
OG0029053	2	0	0	0	2
OG0029054	1	1	0	0	2
OG0029055	1	1	0	0	2
OG0029056	1	1	0	0	2
OG0029057	2	0	0	0	2
OG0029058	1	1	0	0	2
OG0029059	2	0	0	0	2
OG0029060	1	1	0	0	2
OG0029061	2	0	0	0	2
OG0029062	2	0	0	0	2
OG0029063	1	0	0	1	2
OG0029064	1	1	0	0	2
OG0029065	2	0	0	0	2
OG0029066	2	0	0	0	2
OG0029067	1	0	1	0	2
OG0029068	1	1	0	0	2
OG0029069	1	1	0	0	2
OG0029070	1	1	0	0	2
OG0029071	1	1	0	0	2
OG0029072	1	1	0	0	2
OG0029073	1	1	0	0	2
OG0029074	1	1	0	0	2
OG0029075	1	1	0	0	2
OG0029076	1	1	0	0	2
OG0029077	1	0	1	0	2
OG0029078	1	1	0	0	2
OG0029079	1	0	0	1	2
OG0029080	1	1	0	0	2
OG0029081	1	1	0	0	2
OG0029082	1	1	0	0	2
OG0029083	1	1	0	0	2
OG0029084	1	1	0	0	2
OG0029085	1	0	0	1	2
OG0029086	1	1	0	0	2
OG0029087	1	1	0	0	2
OG0029088	1	1	0	0	2
OG0029089	1	1	0	0	2
OG0029090	1	1	0	0	2
OG0029091	1	1	0	0	2
OG0029092	1	1	0	0	2
OG0029093	1	1	0	0	2
OG0029094	1	1	0	0	2
OG0029095	1	0	1	0	2
OG0029096	2	0	0	0	2
OG0029097	1	0	0	1	2
OG0029098	1	1	0	0	2
OG0029099	1	1	0	0	2
OG0029100	2	0	0	0	2
OG0029101	1	1	0	0	2
OG0029102	1	0	0	1	2
OG0029103	1	0	0	1	2
OG0029104	1	0	0	1	2
OG0029105	1	1	0	0	2
OG0029106	1	1	0	0	2
OG0029107	1	1	0	0	2
OG0029108	1	1	0	0	2
OG0029109	1	0	1	0	2
OG0029110	1	1	0	0	2
OG0029111	2	0	0	0	2
OG0029112	1	1	0	0	2
OG0029113	1	0	1	0	2
OG0029114	2	0	0	0	2
OG0029115	1	1	0	0	2
OG0029116	1	0	1	0	2
OG0029117	1	1	0	0	2
OG0029118	2	0	0	0	2
OG0029119	2	0	0	0	2
OG0029120	1	1	0	0	2
OG0029121	1	1	0	0	2
OG0029122	1	1	0	0	2
OG0029123	1	1	0	0	2
OG0029124	1	1	0	0	2
OG0029125	1	1	0	0	2
OG0029126	1	0	1	0	2
OG0029127	1	1	0	0	2
OG0029128	1	1	0	0	2
OG0029129	1	1	0	0	2
OG0029130	1	1	0	0	2
OG0029131	1	1	0	0	2
OG0029132	1	1	0	0	2
OG0029133	1	1	0	0	2
OG0029134	1	1	0	0	2
OG0029135	1	0	0	1	2
OG0029136	1	1	0	0	2
OG0029137	1	1	0	0	2
OG0029138	2	0	0	0	2
OG0029139	2	0	0	0	2
OG0029140	1	1	0	0	2
OG0029141	1	1	0	0	2
OG0029142	1	0	0	1	2
OG0029143	1	1	0	0	2
OG0029144	1	1	0	0	2
OG0029145	2	0	0	0	2
OG0029146	2	0	0	0	2
OG0029147	2	0	0	0	2
OG0029148	1	0	1	0	2
OG0029149	1	1	0	0	2
OG0029150	2	0	0	0	2
OG0029151	1	1	0	0	2
OG0029152	2	0	0	0	2
OG0029153	1	1	0	0	2
OG0029154	1	1	0	0	2
OG0029155	1	1	0	0	2
OG0029156	1	1	0	0	2
OG0029157	1	1	0	0	2
OG0029158	1	1	0	0	2
OG0029159	2	0	0	0	2
OG0029160	1	1	0	0	2
OG0029161	1	1	0	0	2
OG0029162	1	1	0	0	2
OG0029163	2	0	0	0	2
OG0029164	1	1	0	0	2
OG0029165	1	1	0	0	2
OG0029166	1	1	0	0	2
OG0029167	1	1	0	0	2
OG0029168	2	0	0	0	2
OG0029169	1	1	0	0	2
OG0029170	1	1	0	0	2
OG0029171	1	1	0	0	2
OG0029172	1	1	0	0	2
OG0029173	1	1	0	0	2
OG0029174	2	0	0	0	2
OG0029175	2	0	0	0	2
OG0029176	1	1	0	0	2
OG0029177	1	1	0	0	2
OG0029178	2	0	0	0	2
OG0029179	2	0	0	0	2
OG0029180	1	1	0	0	2
OG0029181	1	1	0	0	2
OG0029182	1	1	0	0	2
OG0029183	1	1	0	0	2
OG0029184	2	0	0	0	2
OG0029185	1	1	0	0	2
OG0029186	1	1	0	0	2
OG0029187	1	1	0	0	2
OG0029188	1	1	0	0	2
OG0029189	1	1	0	0	2
OG0029190	1	1	0	0	2
OG0029191	1	1	0	0	2
OG0029192	1	1	0	0	2
OG0029193	2	0	0	0	2
OG0029194	2	0	0	0	2
OG0029195	1	0	0	1	2
OG0029196	1	1	0	0	2
OG0029197	2	0	0	0	2
OG0029198	1	1	0	0	2
OG0029199	1	1	0	0	2
OG0029200	1	1	0	0	2
OG0029201	1	1	0	0	2
OG0029202	1	1	0	0	2
OG0029203	1	1	0	0	2
OG0029204	1	1	0	0	2
OG0029205	1	1	0	0	2
OG0029206	1	1	0	0	2
OG0029207	2	0	0	0	2
OG0029208	1	1	0	0	2
OG0029209	1	1	0	0	2
OG0029210	1	1	0	0	2
OG0029211	1	1	0	0	2
OG0029212	2	0	0	0	2
OG0029213	1	1	0	0	2
OG0029214	1	1	0	0	2
OG0029215	1	1	0	0	2
OG0029216	1	1	0	0	2
OG0029217	2	0	0	0	2
OG0029218	1	1	0	0	2
OG0029219	1	0	1	0	2
OG0029220	1	1	0	0	2
OG0029221	1	1	0	0	2
OG0029222	2	0	0	0	2
OG0029223	1	0	1	0	2
OG0029224	1	1	0	0	2
OG0029225	2	0	0	0	2
OG0029226	1	1	0	0	2
OG0029227	1	1	0	0	2
OG0029228	1	0	1	0	2
OG0029229	1	1	0	0	2
OG0029230	1	1	0	0	2
OG0029231	1	1	0	0	2
OG0029232	1	1	0	0	2
OG0029233	1	1	0	0	2
OG0029234	1	0	1	0	2
OG0029235	1	1	0	0	2
OG0029236	1	1	0	0	2
OG0029237	1	0	1	0	2
OG0029238	1	1	0	0	2
OG0029239	1	0	1	0	2
OG0029240	1	1	0	0	2
OG0029241	1	1	0	0	2
OG0029242	1	1	0	0	2
OG0029243	1	1	0	0	2
OG0029244	1	1	0	0	2
OG0029245	1	0	0	1	2
OG0029246	1	0	0	1	2
OG0029247	2	0	0	0	2
OG0029248	2	0	0	0	2
OG0029249	2	0	0	0	2
OG0029250	1	1	0	0	2
OG0029251	2	0	0	0	2
OG0029252	2	0	0	0	2
OG0029253	2	0	0	0	2
OG0029254	1	1	0	0	2
OG0029255	1	1	0	0	2
OG0029256	1	1	0	0	2
OG0029257	1	1	0	0	2
OG0029258	1	1	0	0	2
OG0029259	2	0	0	0	2
OG0029260	1	1	0	0	2
OG0029261	1	1	0	0	2
OG0029262	1	1	0	0	2
OG0029263	2	0	0	0	2
OG0029264	2	0	0	0	2
OG0029265	1	1	0	0	2
OG0029266	1	1	0	0	2
OG0029267	2	0	0	0	2
OG0029268	1	1	0	0	2
OG0029269	1	1	0	0	2
OG0029270	1	1	0	0	2
OG0029271	2	0	0	0	2
OG0029272	1	1	0	0	2
OG0029273	2	0	0	0	2
OG0029274	1	1	0	0	2
OG0029275	1	1	0	0	2
OG0029276	1	1	0	0	2
OG0029277	1	0	1	0	2
OG0029278	1	1	0	0	2
OG0029279	1	1	0	0	2
OG0029280	2	0	0	0	2
OG0029281	2	0	0	0	2
OG0029282	1	1	0	0	2
OG0029283	2	0	0	0	2
OG0029284	2	0	0	0	2
OG0029285	1	1	0	0	2
OG0029286	1	1	0	0	2
OG0029287	2	0	0	0	2
OG0029288	1	1	0	0	2
OG0029289	1	1	0	0	2
OG0029290	2	0	0	0	2
OG0029291	1	1	0	0	2
OG0029292	2	0	0	0	2
OG0029293	2	0	0	0	2
OG0029294	1	1	0	0	2
OG0029295	1	1	0	0	2
OG0029296	1	1	0	0	2
OG0029297	1	0	1	0	2
OG0029298	1	1	0	0	2
OG0029299	2	0	0	0	2
OG0029300	1	0	1	0	2
OG0029301	1	1	0	0	2
OG0029302	2	0	0	0	2
OG0029303	1	1	0	0	2
OG0029304	1	1	0	0	2
OG0029305	1	1	0	0	2
OG0029306	1	1	0	0	2
OG0029307	1	1	0	0	2
OG0029308	2	0	0	0	2
OG0029309	2	0	0	0	2
OG0029310	1	1	0	0	2
OG0029311	1	1	0	0	2
OG0029312	1	0	1	0	2
OG0029313	1	1	0	0	2
OG0029314	1	1	0	0	2
OG0029315	1	1	0	0	2
OG0029316	1	0	0	1	2
OG0029317	1	1	0	0	2
OG0029318	1	1	0	0	2
OG0029319	1	1	0	0	2
OG0029320	1	1	0	0	2
OG0029321	1	1	0	0	2
OG0029322	1	1	0	0	2
OG0029323	1	1	0	0	2
OG0029324	2	0	0	0	2
OG0029325	1	1	0	0	2
OG0029326	1	1	0	0	2
OG0029327	1	1	0	0	2
OG0029328	1	1	0	0	2
OG0029329	1	1	0	0	2
OG0029330	1	0	1	0	2
OG0029331	1	1	0	0	2
OG0029332	1	1	0	0	2
OG0029333	1	1	0	0	2
OG0029334	2	0	0	0	2
OG0029335	1	1	0	0	2
OG0029336	1	1	0	0	2
OG0029337	1	1	0	0	2
OG0029338	1	0	1	0	2
OG0029339	2	0	0	0	2
OG0029340	1	1	0	0	2
OG0029341	2	0	0	0	2
OG0029342	1	1	0	0	2
OG0029343	1	0	1	0	2
OG0029344	1	1	0	0	2
OG0029345	2	0	0	0	2
OG0029346	2	0	0	0	2
OG0029347	1	1	0	0	2
OG0029348	1	0	1	0	2
OG0029349	1	0	1	0	2
OG0029350	1	1	0	0	2
OG0029351	1	1	0	0	2
OG0029352	1	1	0	0	2
OG0029353	1	1	0	0	2
OG0029354	1	1	0	0	2
OG0029355	1	0	0	1	2
OG0029356	1	1	0	0	2
OG0029357	2	0	0	0	2
OG0029358	1	1	0	0	2
OG0029359	1	1	0	0	2
OG0029360	1	1	0	0	2
OG0029361	1	1	0	0	2
OG0029362	1	0	1	0	2
OG0029363	1	0	0	1	2
OG0029364	1	1	0	0	2
OG0029365	2	0	0	0	2
OG0029366	2	0	0	0	2
OG0029367	1	1	0	0	2
OG0029368	1	1	0	0	2
OG0029369	1	0	0	1	2
OG0029370	1	0	0	1	2
OG0029371	2	0	0	0	2
OG0029372	2	0	0	0	2
OG0029373	1	0	0	1	2
OG0029374	1	1	0	0	2
OG0029375	1	1	0	0	2
OG0029376	1	1	0	0	2
OG0029377	1	1	0	0	2
OG0029378	1	1	0	0	2
OG0029379	1	1	0	0	2
OG0029380	1	1	0	0	2
OG0029381	1	1	0	0	2
OG0029382	1	1	0	0	2
OG0029383	1	1	0	0	2
OG0029384	2	0	0	0	2
OG0029385	1	0	0	1	2
OG0029386	1	1	0	0	2
OG0029387	1	1	0	0	2
OG0029388	1	1	0	0	2
OG0029389	1	1	0	0	2
OG0029390	2	0	0	0	2
OG0029391	2	0	0	0	2
OG0029392	1	1	0	0	2
OG0029393	2	0	0	0	2
OG0029394	2	0	0	0	2
OG0029395	1	1	0	0	2
OG0029396	1	0	0	1	2
OG0029397	1	0	0	1	2
OG0029398	1	1	0	0	2
OG0029399	1	1	0	0	2
OG0029400	1	1	0	0	2
OG0029401	1	1	0	0	2
OG0029402	1	1	0	0	2
OG0029403	1	1	0	0	2
OG0029404	1	1	0	0	2
OG0029405	1	1	0	0	2
OG0029406	2	0	0	0	2
OG0029407	2	0	0	0	2
OG0029408	1	1	0	0	2
OG0029409	1	1	0	0	2
OG0029410	1	0	1	0	2
OG0029411	1	1	0	0	2
OG0029412	1	0	1	0	2
OG0029413	1	1	0	0	2
OG0029414	1	1	0	0	2
OG0029415	1	1	0	0	2
OG0029416	1	1	0	0	2
OG0029417	1	1	0	0	2
OG0029418	1	1	0	0	2
OG0029419	2	0	0	0	2
OG0029420	1	1	0	0	2
OG0029421	1	0	0	1	2
OG0029422	1	0	1	0	2
OG0029423	1	1	0	0	2
OG0029424	1	1	0	0	2
OG0029425	1	1	0	0	2
OG0029426	1	0	1	0	2
OG0029427	1	1	0	0	2
OG0029428	1	1	0	0	2
OG0029429	1	1	0	0	2
OG0029430	2	0	0	0	2
OG0029431	2	0	0	0	2
OG0029432	1	1	0	0	2
OG0029433	1	1	0	0	2
OG0029434	2	0	0	0	2
OG0029435	1	1	0	0	2
OG0029436	1	0	0	1	2
OG0029437	1	1	0	0	2
OG0029438	1	1	0	0	2
OG0029439	1	1	0	0	2
OG0029440	1	1	0	0	2
OG0029441	1	1	0	0	2
OG0029442	2	0	0	0	2
OG0029443	1	1	0	0	2
OG0029444	1	1	0	0	2
OG0029445	1	1	0	0	2
OG0029446	2	0	0	0	2
OG0029447	2	0	0	0	2
OG0029448	1	1	0	0	2
OG0029449	1	1	0	0	2
OG0029450	1	0	0	1	2
OG0029451	1	0	0	1	2
OG0029452	1	0	0	1	2
OG0029453	1	1	0	0	2
OG0029454	1	1	0	0	2
OG0029455	1	1	0	0	2
OG0029456	2	0	0	0	2
OG0029457	1	1	0	0	2
OG0029458	1	1	0	0	2
OG0029459	1	1	0	0	2
OG0029460	1	0	1	0	2
OG0029461	2	0	0	0	2
OG0029462	1	1	0	0	2
OG0029463	1	1	0	0	2
OG0029464	2	0	0	0	2
OG0029465	1	1	0	0	2
OG0029466	2	0	0	0	2
OG0029467	1	1	0	0	2
OG0029468	2	0	0	0	2
OG0029469	1	1	0	0	2
OG0029470	1	1	0	0	2
OG0029471	1	1	0	0	2
OG0029472	1	1	0	0	2
OG0029473	1	0	0	1	2
OG0029474	1	1	0	0	2
OG0029475	1	1	0	0	2
OG0029476	1	1	0	0	2
OG0029477	1	1	0	0	2
OG0029478	1	1	0	0	2
OG0029479	2	0	0	0	2
OG0029480	1	1	0	0	2
OG0029481	1	1	0	0	2
OG0029482	2	0	0	0	2
OG0029483	1	1	0	0	2
OG0029484	2	0	0	0	2
OG0029485	1	1	0	0	2
OG0029486	2	0	0	0	2
OG0029487	1	1	0	0	2
OG0029488	1	1	0	0	2
OG0029489	1	1	0	0	2
OG0029490	1	1	0	0	2
OG0029491	2	0	0	0	2
OG0029492	2	0	0	0	2
OG0029493	2	0	0	0	2
OG0029494	1	1	0	0	2
OG0029495	2	0	0	0	2
OG0029496	1	1	0	0	2
OG0029497	1	1	0	0	2
OG0029498	1	1	0	0	2
OG0029499	2	0	0	0	2
OG0029500	1	1	0	0	2
OG0029501	1	1	0	0	2
OG0029502	1	1	0	0	2
OG0029503	1	1	0	0	2
OG0029504	1	1	0	0	2
OG0029505	1	1	0	0	2
OG0029506	2	0	0	0	2
OG0029507	1	1	0	0	2
OG0029508	1	1	0	0	2
OG0029509	1	1	0	0	2
OG0029510	2	0	0	0	2
OG0029511	1	1	0	0	2
OG0029512	1	1	0	0	2
OG0029513	1	1	0	0	2
OG0029514	1	1	0	0	2
OG0029515	1	1	0	0	2
OG0029516	2	0	0	0	2
OG0029517	2	0	0	0	2
OG0029518	1	1	0	0	2
OG0029519	2	0	0	0	2
OG0029520	1	1	0	0	2
OG0029521	1	0	0	1	2
OG0029522	2	0	0	0	2
OG0029523	1	1	0	0	2
OG0029524	1	1	0	0	2
OG0029525	1	0	0	1	2
OG0029526	2	0	0	0	2
OG0029527	1	1	0	0	2
OG0029528	1	1	0	0	2
OG0029529	1	0	1	0	2
OG0029530	1	0	0	1	2
OG0029531	1	1	0	0	2
OG0029532	1	1	0	0	2
OG0029533	2	0	0	0	2
OG0029534	2	0	0	0	2
OG0029535	1	1	0	0	2
OG0029536	1	0	1	0	2
OG0029537	1	1	0	0	2
OG0029538	1	1	0	0	2
OG0029539	1	0	0	1	2
OG0029540	1	0	0	1	2
OG0029541	1	1	0	0	2
OG0029542	1	1	0	0	2
OG0029543	2	0	0	0	2
OG0029544	1	1	0	0	2
OG0029545	2	0	0	0	2
OG0029546	1	1	0	0	2
OG0029547	1	1	0	0	2
OG0029548	1	1	0	0	2
OG0029549	1	1	0	0	2
OG0029550	1	1	0	0	2
OG0029551	1	1	0	0	2
OG0029552	1	1	0	0	2
OG0029553	1	1	0	0	2
OG0029554	2	0	0	0	2
OG0029555	1	0	1	0	2
OG0029556	2	0	0	0	2
OG0029557	1	1	0	0	2
OG0029558	1	1	0	0	2
OG0029559	1	1	0	0	2
OG0029560	1	1	0	0	2
OG0029561	2	0	0	0	2
OG0029562	1	1	0	0	2
OG0029563	1	1	0	0	2
OG0029564	1	1	0	0	2
OG0029565	2	0	0	0	2
OG0029566	1	1	0	0	2
OG0029567	2	0	0	0	2
OG0029568	1	0	0	1	2
OG0029569	1	1	0	0	2
OG0029570	1	0	0	1	2
OG0029571	1	1	0	0	2
OG0029572	2	0	0	0	2
OG0029573	1	1	0	0	2
OG0029574	1	1	0	0	2
OG0029575	1	1	0	0	2
OG0029576	2	0	0	0	2
OG0029577	1	0	0	1	2
OG0029578	2	0	0	0	2
OG0029579	1	1	0	0	2
OG0029580	1	1	0	0	2
OG0029581	1	0	1	0	2
OG0029582	2	0	0	0	2
OG0029583	2	0	0	0	2
OG0029584	1	1	0	0	2
OG0029585	1	1	0	0	2
OG0029586	1	0	1	0	2
OG0029587	2	0	0	0	2
OG0029588	2	0	0	0	2
OG0029589	1	1	0	0	2
OG0029590	2	0	0	0	2
OG0029591	1	1	0	0	2
OG0029592	2	0	0	0	2
OG0029593	2	0	0	0	2
OG0029594	1	1	0	0	2
OG0029595	1	1	0	0	2
OG0029596	1	0	1	0	2
OG0029597	1	1	0	0	2
OG0029598	1	1	0	0	2
OG0029599	1	1	0	0	2
OG0029600	1	1	0	0	2
OG0029601	1	1	0	0	2
OG0029602	1	1	0	0	2
OG0029603	1	1	0	0	2
OG0029604	1	0	1	0	2
OG0029605	1	0	1	0	2
OG0029606	1	1	0	0	2
OG0029607	1	1	0	0	2
OG0029608	2	0	0	0	2
OG0029609	1	1	0	0	2
OG0029610	1	1	0	0	2
OG0029611	1	1	0	0	2
OG0029612	2	0	0	0	2
OG0029613	1	0	1	0	2
OG0029614	1	1	0	0	2
OG0029615	1	1	0	0	2
OG0029616	1	1	0	0	2
OG0029617	1	1	0	0	2
OG0029618	1	1	0	0	2
OG0029619	1	1	0	0	2
OG0029620	1	1	0	0	2
OG0029621	1	1	0	0	2
OG0029622	2	0	0	0	2
OG0029623	1	0	0	1	2
OG0029624	1	1	0	0	2
OG0029625	1	1	0	0	2
OG0029626	1	1	0	0	2
OG0029627	1	1	0	0	2
OG0029628	1	0	1	0	2
OG0029629	1	1	0	0	2
OG0029630	1	1	0	0	2
OG0029631	1	1	0	0	2
OG0029632	1	0	1	0	2
OG0029633	2	0	0	0	2
OG0029634	1	0	0	1	2
OG0029635	1	1	0	0	2
OG0029636	1	1	0	0	2
OG0029637	1	1	0	0	2
OG0029638	1	1	0	0	2
OG0029639	1	1	0	0	2
OG0029640	1	0	0	1	2
OG0029641	1	1	0	0	2
OG0029642	1	1	0	0	2
OG0029643	1	1	0	0	2
OG0029644	1	1	0	0	2
OG0029645	1	0	0	1	2
OG0029646	2	0	0	0	2
OG0029647	2	0	0	0	2
OG0029648	1	1	0	0	2
OG0029649	1	1	0	0	2
OG0029650	1	1	0	0	2
OG0029651	1	1	0	0	2
OG0029652	2	0	0	0	2
OG0029653	1	1	0	0	2
OG0029654	1	1	0	0	2
OG0029655	1	1	0	0	2
OG0029656	1	1	0	0	2
OG0029657	1	1	0	0	2
OG0029658	1	1	0	0	2
OG0029659	1	1	0	0	2
OG0029660	1	1	0	0	2
OG0029661	1	1	0	0	2
OG0029662	1	1	0	0	2
OG0029663	1	1	0	0	2
OG0029664	1	1	0	0	2
OG0029665	1	1	0	0	2
OG0029666	1	1	0	0	2
OG0029667	2	0	0	0	2
OG0029668	1	1	0	0	2
OG0029669	1	1	0	0	2
OG0029670	1	1	0	0	2
OG0029671	1	1	0	0	2
OG0029672	1	1	0	0	2
OG0029673	1	1	0	0	2
OG0029674	1	1	0	0	2
OG0029675	2	0	0	0	2
OG0029676	1	1	0	0	2
OG0029677	2	0	0	0	2
OG0029678	2	0	0	0	2
OG0029679	1	0	0	1	2
OG0029680	2	0	0	0	2
OG0029681	1	0	1	0	2
OG0029682	2	0	0	0	2
OG0029683	2	0	0	0	2
OG0029684	1	1	0	0	2
OG0029685	2	0	0	0	2
OG0029686	1	1	0	0	2
OG0029687	2	0	0	0	2
OG0029688	1	1	0	0	2
OG0029689	1	1	0	0	2
OG0029690	1	1	0	0	2
OG0029691	1	1	0	0	2
OG0029692	2	0	0	0	2
OG0029693	1	1	0	0	2
OG0029694	1	1	0	0	2
OG0029695	1	1	0	0	2
OG0029696	1	1	0	0	2
OG0029697	1	1	0	0	2
OG0029698	1	1	0	0	2
OG0029699	1	1	0	0	2
OG0029700	1	1	0	0	2
OG0029701	1	1	0	0	2
OG0029702	2	0	0	0	2
OG0029703	1	1	0	0	2
OG0029704	1	1	0	0	2
OG0029705	1	1	0	0	2
OG0029706	1	0	0	1	2
OG0029707	2	0	0	0	2
OG0029708	1	1	0	0	2
OG0029709	1	1	0	0	2
OG0029710	1	1	0	0	2
OG0029711	1	1	0	0	2
OG0029712	1	1	0	0	2
OG0029713	1	1	0	0	2
OG0029714	1	1	0	0	2
OG0029715	1	1	0	0	2
OG0029716	1	1	0	0	2
OG0029717	1	1	0	0	2
OG0029718	1	1	0	0	2
OG0029719	1	1	0	0	2
OG0029720	1	1	0	0	2
OG0029721	1	1	0	0	2
OG0029722	1	1	0	0	2
OG0029723	1	1	0	0	2
OG0029724	1	1	0	0	2
OG0029725	1	1	0	0	2
OG0029726	1	1	0	0	2
OG0029727	1	1	0	0	2
OG0029728	1	1	0	0	2
OG0029729	1	0	1	0	2
OG0029730	1	1	0	0	2
OG0029731	1	1	0	0	2
OG0029732	1	1	0	0	2
OG0029733	1	1	0	0	2
OG0029734	2	0	0	0	2
OG0029735	1	1	0	0	2
OG0029736	1	1	0	0	2
OG0029737	1	1	0	0	2
OG0029738	1	1	0	0	2
OG0029739	1	0	1	0	2
OG0029740	1	1	0	0	2
OG0029741	2	0	0	0	2
OG0029742	1	1	0	0	2
OG0029743	1	0	0	1	2
OG0029744	1	1	0	0	2
OG0029745	1	1	0	0	2
OG0029746	1	1	0	0	2
OG0029747	1	1	0	0	2
OG0029748	1	0	0	1	2
OG0029749	2	0	0	0	2
OG0029750	1	1	0	0	2
OG0029751	1	0	0	1	2
OG0029752	1	0	1	0	2
OG0029753	1	0	1	0	2
OG0029754	1	0	0	1	2
OG0029755	2	0	0	0	2
OG0029756	1	1	0	0	2
OG0029757	1	1	0	0	2
OG0029758	1	0	0	1	2
OG0029759	2	0	0	0	2
OG0029760	1	1	0	0	2
OG0029761	1	1	0	0	2
OG0029762	1	1	0	0	2
OG0029763	1	0	0	1	2
OG0029764	2	0	0	0	2
OG0029765	1	1	0	0	2
OG0029766	2	0	0	0	2
OG0029767	1	1	0	0	2
OG0029768	1	1	0	0	2
OG0029769	1	1	0	0	2
OG0029770	1	1	0	0	2
OG0029771	1	1	0	0	2
OG0029772	1	0	1	0	2
OG0029773	1	1	0	0	2
OG0029774	1	1	0	0	2
OG0029775	1	1	0	0	2
OG0029776	1	1	0	0	2
OG0029777	1	1	0	0	2
OG0029778	2	0	0	0	2
OG0029779	1	1	0	0	2
OG0029780	1	1	0	0	2
OG0029781	2	0	0	0	2
OG0029782	1	1	0	0	2
OG0029783	1	1	0	0	2
OG0029784	1	1	0	0	2
OG0029785	1	1	0	0	2
OG0029786	1	1	0	0	2
OG0029787	1	1	0	0	2
OG0029788	2	0	0	0	2
OG0029789	1	1	0	0	2
OG0029790	1	1	0	0	2
OG0029791	1	1	0	0	2
OG0029792	1	1	0	0	2
OG0029793	1	1	0	0	2
OG0029794	2	0	0	0	2
OG0029795	1	1	0	0	2
OG0029796	1	1	0	0	2
OG0029797	1	0	0	1	2
OG0029798	2	0	0	0	2
OG0029799	2	0	0	0	2
OG0029800	1	1	0	0	2
OG0029801	1	1	0	0	2
OG0029802	1	1	0	0	2
OG0029803	1	1	0	0	2
OG0029804	1	1	0	0	2
OG0029805	1	1	0	0	2
OG0029806	1	1	0	0	2
OG0029807	1	1	0	0	2
OG0029808	1	1	0	0	2
OG0029809	1	0	0	1	2
OG0029810	2	0	0	0	2
OG0029811	1	1	0	0	2
OG0029812	1	1	0	0	2
OG0029813	1	1	0	0	2
OG0029814	1	1	0	0	2
OG0029815	1	1	0	0	2
OG0029816	1	1	0	0	2
OG0029817	1	1	0	0	2
OG0029818	1	1	0	0	2
OG0029819	1	1	0	0	2
OG0029820	1	0	0	1	2
OG0029821	2	0	0	0	2
OG0029822	1	1	0	0	2
OG0029823	1	1	0	0	2
OG0029824	1	0	1	0	2
OG0029825	1	1	0	0	2
OG0029826	1	1	0	0	2
OG0029827	1	1	0	0	2
OG0029828	1	1	0	0	2
OG0029829	2	0	0	0	2
OG0029830	2	0	0	0	2
OG0029831	1	1	0	0	2
OG0029832	1	1	0	0	2
OG0029833	2	0	0	0	2
OG0029834	1	1	0	0	2
OG0029835	1	1	0	0	2
OG0029836	1	1	0	0	2
OG0029837	1	1	0	0	2
OG0029838	1	1	0	0	2
OG0029839	1	1	0	0	2
OG0029840	1	1	0	0	2
OG0029841	1	1	0	0	2
OG0029842	1	1	0	0	2
OG0029843	1	1	0	0	2
OG0029844	2	0	0	0	2
OG0029845	2	0	0	0	2
OG0029846	1	1	0	0	2
OG0029847	1	1	0	0	2
OG0029848	1	1	0	0	2
OG0029849	2	0	0	0	2
OG0029850	1	1	0	0	2
OG0029851	1	0	0	1	2
OG0029852	2	0	0	0	2
OG0029853	1	1	0	0	2
OG0029854	1	1	0	0	2
OG0029855	1	1	0	0	2
OG0029856	1	1	0	0	2
OG0029857	2	0	0	0	2
OG0029858	1	1	0	0	2
OG0029859	2	0	0	0	2
OG0029860	1	1	0	0	2
OG0029861	1	1	0	0	2
OG0029862	1	1	0	0	2
OG0029863	1	1	0	0	2
OG0029864	1	1	0	0	2
OG0029865	1	1	0	0	2
OG0029866	1	1	0	0	2
OG0029867	1	1	0	0	2
OG0029868	2	0	0	0	2
OG0029869	1	1	0	0	2
OG0029870	1	1	0	0	2
OG0029871	1	1	0	0	2
OG0029872	2	0	0	0	2
OG0029873	1	1	0	0	2
OG0029874	1	1	0	0	2
OG0029875	1	1	0	0	2
OG0029876	1	1	0	0	2
OG0029877	1	1	0	0	2
OG0029878	1	1	0	0	2
OG0029879	1	1	0	0	2
OG0029880	1	1	0	0	2
OG0029881	2	0	0	0	2
OG0029882	1	1	0	0	2
OG0029883	2	0	0	0	2
OG0029884	1	1	0	0	2
OG0029885	1	0	1	0	2
OG0029886	1	1	0	0	2
OG0029887	2	0	0	0	2
OG0029888	1	1	0	0	2
OG0029889	1	1	0	0	2
OG0029890	1	1	0	0	2
OG0029891	2	0	0	0	2
OG0029892	1	0	1	0	2
OG0029893	1	1	0	0	2
OG0029894	1	1	0	0	2
OG0029895	1	1	0	0	2
OG0029896	1	0	0	1	2
OG0029897	1	1	0	0	2
OG0029898	2	0	0	0	2
OG0029899	1	1	0	0	2
OG0029900	1	1	0	0	2
OG0029901	1	0	1	0	2
OG0029902	1	1	0	0	2
OG0029903	1	0	1	0	2
OG0029904	1	1	0	0	2
OG0029905	1	1	0	0	2
OG0029906	1	1	0	0	2
OG0029907	1	1	0	0	2
OG0029908	1	1	0	0	2
OG0029909	1	1	0	0	2
OG0029910	2	0	0	0	2
OG0029911	1	0	0	1	2
OG0029912	1	1	0	0	2
OG0029913	1	1	0	0	2
OG0029914	2	0	0	0	2
OG0029915	1	1	0	0	2
OG0029916	1	1	0	0	2
OG0029917	1	1	0	0	2
OG0029918	1	1	0	0	2
OG0029919	1	1	0	0	2
OG0029920	1	1	0	0	2
OG0029921	1	1	0	0	2
OG0029922	1	1	0	0	2
OG0029923	1	1	0	0	2
OG0029924	1	1	0	0	2
OG0029925	1	1	0	0	2
OG0029926	2	0	0	0	2
OG0029927	2	0	0	0	2
OG0029928	1	1	0	0	2
OG0029929	1	1	0	0	2
OG0029930	1	1	0	0	2
OG0029931	1	1	0	0	2
OG0029932	1	1	0	0	2
OG0029933	1	1	0	0	2
OG0029934	1	1	0	0	2
OG0029935	2	0	0	0	2
OG0029936	1	1	0	0	2
OG0029937	2	0	0	0	2
OG0029938	1	1	0	0	2
OG0029939	1	1	0	0	2
OG0029940	2	0	0	0	2
OG0029941	1	1	0	0	2
OG0029942	1	1	0	0	2
OG0029943	1	1	0	0	2
OG0029944	1	1	0	0	2
OG0029945	1	1	0	0	2
OG0029946	1	1	0	0	2
OG0029947	1	1	0	0	2
OG0029948	1	1	0	0	2
OG0029949	1	1	0	0	2
OG0029950	1	1	0	0	2
OG0029951	2	0	0	0	2
OG0029952	1	1	0	0	2
OG0029953	1	1	0	0	2
OG0029954	1	1	0	0	2
OG0029955	1	1	0	0	2
OG0029956	1	0	1	0	2
OG0029957	1	0	1	0	2
OG0029958	1	1	0	0	2
OG0029959	1	1	0	0	2
OG0029960	2	0	0	0	2
OG0029961	1	0	1	0	2
OG0029962	1	0	0	1	2
OG0029963	1	1	0	0	2
OG0029964	1	1	0	0	2
OG0029965	2	0	0	0	2
OG0029966	2	0	0	0	2
OG0029967	1	0	1	0	2
OG0029968	1	0	1	0	2
OG0029969	1	1	0	0	2
OG0029970	2	0	0	0	2
OG0029971	1	1	0	0	2
OG0029972	1	1	0	0	2
OG0029973	1	1	0	0	2
OG0029974	2	0	0	0	2
OG0029975	1	1	0	0	2
OG0029976	1	1	0	0	2
OG0029977	1	1	0	0	2
OG0029978	1	1	0	0	2
OG0029979	1	0	0	1	2
OG0029980	1	1	0	0	2
OG0029981	1	1	0	0	2
OG0029982	1	1	0	0	2
OG0029983	1	1	0	0	2
OG0029984	1	1	0	0	2
OG0029985	1	1	0	0	2
OG0029986	1	1	0	0	2
OG0029987	1	1	0	0	2
OG0029988	1	1	0	0	2
OG0029989	1	0	0	1	2
OG0029990	2	0	0	0	2
OG0029991	1	1	0	0	2
OG0029992	1	1	0	0	2
OG0029993	2	0	0	0	2
OG0029994	1	1	0	0	2
OG0029995	1	0	1	0	2
OG0029996	1	0	1	0	2
OG0029997	1	1	0	0	2
OG0029998	1	0	0	1	2
OG0029999	1	1	0	0	2
OG0030000	1	1	0	0	2
OG0030001	1	0	1	0	2
OG0030002	1	1	0	0	2
OG0030003	1	0	1	0	2
OG0030004	1	1	0	0	2
OG0030005	1	0	0	1	2
OG0030006	1	0	1	0	2
OG0030007	1	1	0	0	2
OG0030008	1	1	0	0	2
OG0030009	1	1	0	0	2
OG0030010	1	1	0	0	2
OG0030011	1	1	0	0	2
OG0030012	1	0	0	1	2
OG0030013	1	1	0	0	2
OG0030014	1	1	0	0	2
OG0030015	1	1	0	0	2
OG0030016	1	0	1	0	2
OG0030017	1	1	0	0	2
OG0030018	1	1	0	0	2
OG0030019	1	1	0	0	2
OG0030020	1	0	0	1	2
OG0030021	1	0	1	0	2
OG0030022	1	1	0	0	2
OG0030023	1	1	0	0	2
OG0030024	1	1	0	0	2
OG0030025	1	0	0	1	2
OG0030026	1	1	0	0	2
OG0030027	1	1	0	0	2
OG0030028	1	1	0	0	2
OG0030029	1	1	0	0	2
OG0030030	1	1	0	0	2
OG0030031	1	1	0	0	2
OG0030032	1	1	0	0	2
OG0030033	1	1	0	0	2
OG0030034	2	0	0	0	2
OG0030035	2	0	0	0	2
OG0030036	1	1	0	0	2
OG0030037	2	0	0	0	2
OG0030038	1	1	0	0	2
OG0030039	1	1	0	0	2
OG0030040	1	1	0	0	2
OG0030041	1	1	0	0	2
OG0030042	1	1	0	0	2
OG0030043	1	1	0	0	2
OG0030044	2	0	0	0	2
OG0030045	1	1	0	0	2
OG0030046	2	0	0	0	2
OG0030047	1	1	0	0	2
OG0030048	1	1	0	0	2
OG0030049	2	0	0	0	2
OG0030050	2	0	0	0	2
OG0030051	2	0	0	0	2
OG0030052	1	1	0	0	2
OG0030053	1	1	0	0	2
OG0030054	1	1	0	0	2
OG0030055	1	1	0	0	2
OG0030056	1	1	0	0	2
OG0030057	1	1	0	0	2
OG0030058	1	0	1	0	2
OG0030059	1	1	0	0	2
OG0030060	1	1	0	0	2
OG0030061	1	1	0	0	2
OG0030062	2	0	0	0	2
OG0030063	1	1	0	0	2
OG0030064	1	1	0	0	2
OG0030065	1	1	0	0	2
OG0030066	1	0	0	1	2
OG0030067	1	1	0	0	2
OG0030068	1	1	0	0	2
OG0030069	1	1	0	0	2
OG0030070	1	1	0	0	2
OG0030071	1	1	0	0	2
OG0030072	1	1	0	0	2
OG0030073	1	1	0	0	2
OG0030074	1	1	0	0	2
OG0030075	1	1	0	0	2
OG0030076	1	1	0	0	2
OG0030077	1	1	0	0	2
OG0030078	1	1	0	0	2
OG0030079	1	1	0	0	2
OG0030080	1	1	0	0	2
OG0030081	1	1	0	0	2
OG0030082	1	1	0	0	2
OG0030083	1	1	0	0	2
OG0030084	1	0	1	0	2
OG0030085	2	0	0	0	2
OG0030086	1	1	0	0	2
OG0030087	1	1	0	0	2
OG0030088	1	1	0	0	2
OG0030089	2	0	0	0	2
OG0030090	1	1	0	0	2
OG0030091	1	1	0	0	2
OG0030092	1	1	0	0	2
OG0030093	1	1	0	0	2
OG0030094	1	1	0	0	2
OG0030095	1	1	0	0	2
OG0030096	1	1	0	0	2
OG0030097	1	1	0	0	2
OG0030098	1	1	0	0	2
OG0030099	1	1	0	0	2
OG0030100	1	1	0	0	2
OG0030101	1	1	0	0	2
OG0030102	1	1	0	0	2
OG0030103	1	1	0	0	2
OG0030104	2	0	0	0	2
OG0030105	1	1	0	0	2
OG0030106	1	1	0	0	2
OG0030107	1	1	0	0	2
OG0030108	1	1	0	0	2
OG0030109	2	0	0	0	2
OG0030110	1	1	0	0	2
OG0030111	2	0	0	0	2
OG0030112	1	1	0	0	2
OG0030113	1	1	0	0	2
OG0030114	1	1	0	0	2
OG0030115	1	0	1	0	2
OG0030116	1	1	0	0	2
OG0030117	1	1	0	0	2
OG0030118	1	1	0	0	2
OG0030119	1	1	0	0	2
OG0030120	1	1	0	0	2
OG0030121	1	1	0	0	2
OG0030122	1	1	0	0	2
OG0030123	1	1	0	0	2
OG0030124	2	0	0	0	2
OG0030125	1	1	0	0	2
OG0030126	1	1	0	0	2
OG0030127	1	1	0	0	2
OG0030128	1	1	0	0	2
OG0030129	1	1	0	0	2
OG0030130	1	0	0	1	2
OG0030131	1	0	1	0	2
OG0030132	1	1	0	0	2
OG0030133	1	1	0	0	2
OG0030134	1	0	1	0	2
OG0030135	1	1	0	0	2
OG0030136	1	1	0	0	2
OG0030137	1	1	0	0	2
OG0030138	1	1	0	0	2
OG0030139	1	1	0	0	2
OG0030140	1	1	0	0	2
OG0030141	1	1	0	0	2
OG0030142	2	0	0	0	2
OG0030143	1	1	0	0	2
OG0030144	2	0	0	0	2
OG0030145	1	1	0	0	2
OG0030146	1	1	0	0	2
OG0030147	1	1	0	0	2
OG0030148	1	0	1	0	2
OG0030149	1	0	1	0	2
OG0030150	1	1	0	0	2
OG0030151	1	1	0	0	2
OG0030152	2	0	0	0	2
OG0030153	1	1	0	0	2
OG0030154	1	1	0	0	2
OG0030155	1	1	0	0	2
OG0030156	1	1	0	0	2
OG0030157	1	1	0	0	2
OG0030158	1	1	0	0	2
OG0030159	2	0	0	0	2
OG0030160	1	1	0	0	2
OG0030161	1	1	0	0	2
OG0030162	2	0	0	0	2
OG0030163	1	1	0	0	2
OG0030164	1	1	0	0	2
OG0030165	1	1	0	0	2
OG0030166	1	1	0	0	2
OG0030167	1	1	0	0	2
OG0030168	1	1	0	0	2
OG0030169	1	1	0	0	2
OG0030170	1	1	0	0	2
OG0030171	2	0	0	0	2
OG0030172	2	0	0	0	2
OG0030173	1	0	0	1	2
OG0030174	1	1	0	0	2
OG0030175	1	0	0	1	2
OG0030176	2	0	0	0	2
OG0030177	1	1	0	0	2
OG0030178	2	0	0	0	2
OG0030179	1	1	0	0	2
OG0030180	1	1	0	0	2
OG0030181	1	1	0	0	2
OG0030182	2	0	0	0	2
OG0030183	1	1	0	0	2
OG0030184	2	0	0	0	2
OG0030185	2	0	0	0	2
OG0030186	1	0	0	1	2
OG0030187	2	0	0	0	2
OG0030188	1	0	1	0	2
OG0030189	1	1	0	0	2
OG0030190	1	1	0	0	2
OG0030191	1	1	0	0	2
OG0030192	1	1	0	0	2
OG0030193	1	1	0	0	2
OG0030194	1	0	1	0	2
OG0030195	1	1	0	0	2
OG0030196	1	1	0	0	2
OG0030197	1	1	0	0	2
OG0030198	2	0	0	0	2
OG0030199	1	0	0	1	2
OG0030200	2	0	0	0	2
OG0030201	1	1	0	0	2
OG0030202	1	1	0	0	2
OG0030203	1	0	1	0	2
OG0030204	1	1	0	0	2
OG0030205	1	1	0	0	2
OG0030206	1	1	0	0	2
OG0030207	1	1	0	0	2
OG0030208	1	1	0	0	2
OG0030209	1	1	0	0	2
OG0030210	1	1	0	0	2
OG0030211	1	1	0	0	2
OG0030212	1	1	0	0	2
OG0030213	1	1	0	0	2
OG0030214	1	0	0	1	2
OG0030215	2	0	0	0	2
OG0030216	2	0	0	0	2
OG0030217	1	1	0	0	2
OG0030218	1	1	0	0	2
OG0030219	1	1	0	0	2
OG0030220	1	1	0	0	2
OG0030221	1	1	0	0	2
OG0030222	1	1	0	0	2
OG0030223	1	0	1	0	2
OG0030224	1	0	1	0	2
OG0030225	1	1	0	0	2
OG0030226	1	1	0	0	2
OG0030227	1	1	0	0	2
OG0030228	1	0	0	1	2
OG0030229	1	1	0	0	2
OG0030230	2	0	0	0	2
OG0030231	1	0	1	0	2
OG0030232	1	1	0	0	2
OG0030233	2	0	0	0	2
OG0030234	1	0	1	0	2
OG0030235	1	0	1	0	2
OG0030236	1	0	0	1	2
OG0030237	1	1	0	0	2
OG0030238	1	1	0	0	2
OG0030239	1	1	0	0	2
OG0030240	1	1	0	0	2
OG0030241	1	1	0	0	2
OG0030242	2	0	0	0	2
OG0030243	2	0	0	0	2
OG0030244	2	0	0	0	2
OG0030245	2	0	0	0	2
OG0030246	1	1	0	0	2
OG0030247	1	1	0	0	2
OG0030248	2	0	0	0	2
OG0030249	1	1	0	0	2
OG0030250	1	1	0	0	2
OG0030251	1	1	0	0	2
OG0030252	1	1	0	0	2
OG0030253	1	1	0	0	2
OG0030254	1	1	0	0	2
OG0030255	1	1	0	0	2
OG0030256	1	0	0	1	2
OG0030257	1	1	0	0	2
OG0030258	1	0	0	1	2
OG0030259	1	1	0	0	2
OG0030260	1	1	0	0	2
OG0030261	1	1	0	0	2
OG0030262	1	1	0	0	2
OG0030263	1	1	0	0	2
OG0030264	1	1	0	0	2
OG0030265	1	0	0	1	2
OG0030266	1	1	0	0	2
OG0030267	1	0	1	0	2
OG0030268	1	1	0	0	2
OG0030269	2	0	0	0	2
OG0030270	1	1	0	0	2
OG0030271	1	1	0	0	2
OG0030272	1	1	0	0	2
OG0030273	1	1	0	0	2
OG0030274	1	1	0	0	2
OG0030275	2	0	0	0	2
OG0030276	1	1	0	0	2
OG0030277	1	1	0	0	2
OG0030278	2	0	0	0	2
OG0030279	2	0	0	0	2
OG0030280	2	0	0	0	2
OG0030281	1	1	0	0	2
OG0030282	1	1	0	0	2
OG0030283	2	0	0	0	2
OG0030284	1	1	0	0	2
OG0030285	1	1	0	0	2
OG0030286	1	1	0	0	2
OG0030287	1	1	0	0	2
OG0030288	1	1	0	0	2
OG0030289	1	1	0	0	2
OG0030290	1	0	1	0	2
OG0030291	1	1	0	0	2
OG0030292	1	1	0	0	2
OG0030293	1	1	0	0	2
OG0030294	2	0	0	0	2
OG0030295	1	0	1	0	2
OG0030296	1	1	0	0	2
OG0030297	2	0	0	0	2
OG0030298	1	1	0	0	2
OG0030299	2	0	0	0	2
OG0030300	1	1	0	0	2
OG0030301	1	1	0	0	2
OG0030302	1	1	0	0	2
OG0030303	1	1	0	0	2
OG0030304	1	1	0	0	2
OG0030305	2	0	0	0	2
OG0030306	1	1	0	0	2
OG0030307	1	1	0	0	2
OG0030308	1	1	0	0	2
OG0030309	1	1	0	0	2
OG0030310	1	0	0	1	2
OG0030311	1	1	0	0	2
OG0030312	1	0	1	0	2
OG0030313	1	1	0	0	2
OG0030314	1	1	0	0	2
OG0030315	2	0	0	0	2
OG0030316	1	1	0	0	2
OG0030317	1	1	0	0	2
OG0030318	1	1	0	0	2
OG0030319	1	1	0	0	2
OG0030320	1	1	0	0	2
OG0030321	1	1	0	0	2
OG0030322	1	0	1	0	2
OG0030323	1	1	0	0	2
OG0030324	1	1	0	0	2
OG0030325	1	1	0	0	2
OG0030326	1	1	0	0	2
OG0030327	1	1	0	0	2
OG0030328	1	1	0	0	2
OG0030329	2	0	0	0	2
OG0030330	2	0	0	0	2
OG0030331	1	0	1	0	2
OG0030332	2	0	0	0	2
OG0030333	1	1	0	0	2
OG0030334	1	0	0	1	2
OG0030335	1	1	0	0	2
OG0030336	1	1	0	0	2
OG0030337	1	1	0	0	2
OG0030338	1	1	0	0	2
OG0030339	1	1	0	0	2
OG0030340	1	1	0	0	2
OG0030341	1	1	0	0	2
OG0030342	1	0	0	1	2
OG0030343	1	1	0	0	2
OG0030344	1	1	0	0	2
OG0030345	1	0	0	1	2
OG0030346	1	0	1	0	2
OG0030347	2	0	0	0	2
OG0030348	1	1	0	0	2
OG0030349	1	1	0	0	2
OG0030350	1	1	0	0	2
OG0030351	2	0	0	0	2
OG0030352	1	1	0	0	2
OG0030353	1	1	0	0	2
OG0030354	1	1	0	0	2
OG0030355	1	1	0	0	2
OG0030356	1	1	0	0	2
OG0030357	1	0	1	0	2
OG0030358	1	1	0	0	2
OG0030359	1	1	0	0	2
OG0030360	1	1	0	0	2
OG0030361	2	0	0	0	2
OG0030362	1	0	0	1	2
OG0030363	1	1	0	0	2
OG0030364	1	1	0	0	2
OG0030365	1	1	0	0	2
OG0030366	1	0	0	1	2
OG0030367	2	0	0	0	2
OG0030368	1	1	0	0	2
OG0030369	1	1	0	0	2
OG0030370	1	1	0	0	2
OG0030371	1	1	0	0	2
OG0030372	2	0	0	0	2
OG0030373	1	1	0	0	2
OG0030374	1	1	0	0	2
OG0030375	1	1	0	0	2
OG0030376	1	1	0	0	2
OG0030377	1	1	0	0	2
OG0030378	1	1	0	0	2
OG0030379	1	1	0	0	2
OG0030380	2	0	0	0	2
OG0030381	1	1	0	0	2
OG0030382	1	1	0	0	2
OG0030383	2	0	0	0	2
OG0030384	1	1	0	0	2
OG0030385	1	1	0	0	2
OG0030386	1	1	0	0	2
OG0030387	1	1	0	0	2
OG0030388	1	1	0	0	2
OG0030389	1	1	0	0	2
OG0030390	1	1	0	0	2
OG0030391	1	1	0	0	2
OG0030392	1	1	0	0	2
OG0030393	1	1	0	0	2
OG0030394	1	1	0	0	2
OG0030395	1	1	0	0	2
OG0030396	2	0	0	0	2
OG0030397	1	1	0	0	2
OG0030398	2	0	0	0	2
OG0030399	1	0	1	0	2
OG0030400	1	1	0	0	2
OG0030401	1	1	0	0	2
OG0030402	1	1	0	0	2
OG0030403	1	0	1	0	2
OG0030404	1	1	0	0	2
OG0030405	1	1	0	0	2
OG0030406	1	1	0	0	2
OG0030407	1	1	0	0	2
OG0030408	1	1	0	0	2
OG0030409	1	1	0	0	2
OG0030410	1	1	0	0	2
OG0030411	1	1	0	0	2
OG0030412	1	1	0	0	2
OG0030413	1	1	0	0	2
OG0030414	1	1	0	0	2
OG0030415	1	1	0	0	2
OG0030416	1	1	0	0	2
OG0030417	1	1	0	0	2
OG0030418	1	1	0	0	2
OG0030419	2	0	0	0	2
OG0030420	1	1	0	0	2
OG0030421	1	1	0	0	2
OG0030422	1	1	0	0	2
OG0030423	1	1	0	0	2
OG0030424	1	1	0	0	2
OG0030425	2	0	0	0	2
OG0030426	1	1	0	0	2
OG0030427	1	1	0	0	2
OG0030428	1	1	0	0	2
OG0030429	2	0	0	0	2
OG0030430	1	1	0	0	2
OG0030431	2	0	0	0	2
OG0030432	2	0	0	0	2
OG0030433	2	0	0	0	2
OG0030434	2	0	0	0	2
OG0030435	2	0	0	0	2
OG0030436	2	0	0	0	2
OG0030437	1	0	1	0	2
OG0030438	1	1	0	0	2
OG0030439	2	0	0	0	2
OG0030440	2	0	0	0	2
OG0030441	2	0	0	0	2
OG0030442	2	0	0	0	2
OG0030443	2	0	0	0	2
OG0030444	2	0	0	0	2
OG0030445	1	1	0	0	2
OG0030446	1	1	0	0	2
OG0030447	1	0	1	0	2
OG0030448	1	1	0	0	2
OG0030449	1	1	0	0	2
OG0030450	1	1	0	0	2
OG0030451	1	1	0	0	2
OG0030452	2	0	0	0	2
OG0030453	1	1	0	0	2
OG0030454	1	1	0	0	2
OG0030455	1	1	0	0	2
OG0030456	1	0	1	0	2
OG0030457	2	0	0	0	2
OG0030458	1	1	0	0	2
OG0030459	1	0	0	1	2
OG0030460	2	0	0	0	2
OG0030461	1	1	0	0	2
OG0030462	1	1	0	0	2
OG0030463	1	1	0	0	2
OG0030464	1	1	0	0	2
OG0030465	1	1	0	0	2
OG0030466	1	1	0	0	2
OG0030467	1	1	0	0	2
OG0030468	1	1	0	0	2
OG0030469	2	0	0	0	2
OG0030470	1	1	0	0	2
OG0030471	2	0	0	0	2
OG0030472	1	1	0	0	2
OG0030473	1	1	0	0	2
OG0030474	2	0	0	0	2
OG0030475	1	1	0	0	2
OG0030476	1	0	1	0	2
OG0030477	1	1	0	0	2
OG0030478	1	1	0	0	2
OG0030479	1	1	0	0	2
OG0030480	1	1	0	0	2
OG0030481	1	1	0	0	2
OG0030482	1	1	0	0	2
OG0030483	2	0	0	0	2
OG0030484	1	1	0	0	2
OG0030485	2	0	0	0	2
OG0030486	2	0	0	0	2
OG0030487	1	1	0	0	2
OG0030488	1	1	0	0	2
OG0030489	2	0	0	0	2
OG0030490	1	1	0	0	2
OG0030491	2	0	0	0	2
OG0030492	1	1	0	0	2
OG0030493	2	0	0	0	2
OG0030494	1	1	0	0	2
OG0030495	1	1	0	0	2
OG0030496	1	1	0	0	2
OG0030497	1	1	0	0	2
OG0030498	1	1	0	0	2
OG0030499	1	1	0	0	2
OG0030500	1	1	0	0	2
OG0030501	2	0	0	0	2
OG0030502	2	0	0	0	2
OG0030503	0	2	0	0	2
OG0030504	0	2	0	0	2
OG0030505	0	2	0	0	2
OG0030506	0	2	0	0	2
OG0030507	0	2	0	0	2
OG0030508	0	2	0	0	2
OG0030509	0	2	0	0	2
OG0030510	0	2	0	0	2
OG0030511	0	2	0	0	2
OG0030512	0	2	0	0	2
OG0030513	0	2	0	0	2
OG0030514	0	2	0	0	2
OG0030515	0	2	0	0	2
OG0030516	0	2	0	0	2
OG0030517	0	2	0	0	2
OG0030518	0	2	0	0	2
OG0030519	0	2	0	0	2
OG0030520	0	2	0	0	2
OG0030521	0	2	0	0	2
OG0030522	0	1	1	0	2
OG0030523	0	2	0	0	2
OG0030524	0	2	0	0	2
OG0030525	0	2	0	0	2
OG0030526	0	2	0	0	2
OG0030527	0	2	0	0	2
OG0030528	0	2	0	0	2
OG0030529	0	2	0	0	2
OG0030530	0	2	0	0	2
OG0030531	0	2	0	0	2
OG0030532	0	2	0	0	2
OG0030533	0	1	1	0	2
OG0030534	0	2	0	0	2
OG0030535	0	2	0	0	2
OG0030536	0	2	0	0	2
OG0030537	0	2	0	0	2
OG0030538	0	1	0	1	2
OG0030539	0	2	0	0	2
OG0030540	0	2	0	0	2
OG0030541	0	2	0	0	2
OG0030542	0	2	0	0	2
OG0030543	0	2	0	0	2
OG0030544	0	1	1	0	2
OG0030545	0	2	0	0	2
OG0030546	0	2	0	0	2
OG0030547	0	1	0	1	2
OG0030548	0	2	0	0	2
OG0030549	0	2	0	0	2
OG0030550	0	1	0	1	2
OG0030551	0	2	0	0	2
OG0030552	0	2	0	0	2
OG0030553	0	2	0	0	2
OG0030554	0	2	0	0	2
OG0030555	0	2	0	0	2
OG0030556	0	2	0	0	2
OG0030557	0	2	0	0	2
OG0030558	0	1	1	0	2
OG0030559	0	2	0	0	2
OG0030560	0	2	0	0	2
OG0030561	0	2	0	0	2
OG0030562	0	2	0	0	2
OG0030563	0	2	0	0	2
OG0030564	0	2	0	0	2
OG0030565	0	2	0	0	2
OG0030566	0	2	0	0	2
OG0030567	0	2	0	0	2
OG0030568	0	2	0	0	2
OG0030569	0	2	0	0	2
OG0030570	0	2	0	0	2
OG0030571	0	2	0	0	2
OG0030572	0	2	0	0	2
OG0030573	0	2	0	0	2
OG0030574	0	2	0	0	2
OG0030575	0	2	0	0	2
OG0030576	0	2	0	0	2
OG0030577	0	2	0	0	2
OG0030578	0	2	0	0	2
OG0030579	0	2	0	0	2
OG0030580	0	2	0	0	2
OG0030581	0	2	0	0	2
OG0030582	0	2	0	0	2
OG0030583	0	2	0	0	2
OG0030584	0	2	0	0	2
OG0030585	0	2	0	0	2
OG0030586	0	1	0	1	2
OG0030587	0	1	0	1	2
OG0030588	0	2	0	0	2
OG0030589	0	2	0	0	2
OG0030590	0	2	0	0	2
OG0030591	0	2	0	0	2
OG0030592	0	2	0	0	2
OG0030593	0	2	0	0	2
OG0030594	0	2	0	0	2
OG0030595	0	2	0	0	2
OG0030596	0	2	0	0	2
OG0030597	0	1	1	0	2
OG0030598	0	2	0	0	2
OG0030599	0	2	0	0	2
OG0030600	0	2	0	0	2
OG0030601	0	2	0	0	2
OG0030602	0	2	0	0	2
OG0030603	0	2	0	0	2
OG0030604	0	2	0	0	2
OG0030605	0	2	0	0	2
OG0030606	0	2	0	0	2
OG0030607	0	2	0	0	2
OG0030608	0	2	0	0	2
OG0030609	0	2	0	0	2
OG0030610	0	2	0	0	2
OG0030611	0	2	0	0	2
OG0030612	0	2	0	0	2
OG0030613	0	2	0	0	2
OG0030614	0	1	1	0	2
OG0030615	0	2	0	0	2
OG0030616	0	2	0	0	2
OG0030617	0	2	0	0	2
OG0030618	0	2	0	0	2
OG0030619	0	2	0	0	2
OG0030620	0	2	0	0	2
OG0030621	0	1	1	0	2
OG0030622	0	2	0	0	2
OG0030623	0	1	1	0	2
OG0030624	0	2	0	0	2
OG0030625	0	2	0	0	2
OG0030626	0	2	0	0	2
OG0030627	0	2	0	0	2
OG0030628	0	2	0	0	2
OG0030629	0	1	0	1	2
OG0030630	0	2	0	0	2
OG0030631	0	1	0	1	2
OG0030632	0	2	0	0	2
OG0030633	0	1	1	0	2
OG0030634	0	2	0	0	2
OG0030635	0	1	1	0	2
OG0030636	0	1	1	0	2
OG0030637	0	2	0	0	2
OG0030638	0	2	0	0	2
OG0030639	0	2	0	0	2
OG0030640	0	2	0	0	2
OG0030641	0	2	0	0	2
OG0030642	0	2	0	0	2
OG0030643	0	2	0	0	2
OG0030644	0	2	0	0	2
OG0030645	0	1	0	1	2
OG0030646	0	2	0	0	2
OG0030647	0	2	0	0	2
OG0030648	0	1	0	1	2
OG0030649	0	2	0	0	2
OG0030650	0	2	0	0	2
OG0030651	0	2	0	0	2
OG0030652	0	1	1	0	2
OG0030653	0	2	0	0	2
OG0030654	0	2	0	0	2
OG0030655	0	2	0	0	2
OG0030656	0	2	0	0	2
OG0030657	0	2	0	0	2
OG0030658	0	1	0	1	2
OG0030659	0	2	0	0	2
OG0030660	0	2	0	0	2
OG0030661	0	2	0	0	2
OG0030662	0	1	1	0	2
OG0030663	0	2	0	0	2
OG0030664	0	2	0	0	2
OG0030665	0	2	0	0	2
OG0030666	0	2	0	0	2
OG0030667	0	2	0	0	2
OG0030668	0	2	0	0	2
OG0030669	0	2	0	0	2
OG0030670	0	2	0	0	2
OG0030671	0	2	0	0	2
OG0030672	0	2	0	0	2
OG0030673	0	2	0	0	2
OG0030674	0	2	0	0	2
OG0030675	0	2	0	0	2
OG0030676	0	2	0	0	2
OG0030677	0	2	0	0	2
OG0030678	0	2	0	0	2
OG0030679	0	2	0	0	2
OG0030680	0	2	0	0	2
OG0030681	0	2	0	0	2
OG0030682	0	2	0	0	2
OG0030683	0	2	0	0	2
OG0030684	0	1	1	0	2
OG0030685	0	2	0	0	2
OG0030686	0	2	0	0	2
OG0030687	0	2	0	0	2
OG0030688	0	2	0	0	2
OG0030689	0	2	0	0	2
OG0030690	0	2	0	0	2
OG0030691	0	2	0	0	2
OG0030692	0	2	0	0	2
OG0030693	0	2	0	0	2
OG0030694	0	2	0	0	2
OG0030695	0	2	0	0	2
OG0030696	0	2	0	0	2
OG0030697	0	2	0	0	2
OG0030698	0	2	0	0	2
OG0030699	0	2	0	0	2
OG0030700	0	2	0	0	2
OG0030701	0	2	0	0	2
OG0030702	0	2	0	0	2
OG0030703	0	1	0	1	2
OG0030704	0	1	1	0	2
OG0030705	0	2	0	0	2
OG0030706	0	2	0	0	2
OG0030707	0	2	0	0	2
OG0030708	0	2	0	0	2
OG0030709	0	2	0	0	2
OG0030710	0	2	0	0	2
OG0030711	0	2	0	0	2
OG0030712	0	2	0	0	2
OG0030713	0	2	0	0	2
OG0030714	0	2	0	0	2
OG0030715	0	2	0	0	2
OG0030716	0	1	0	1	2
OG0030717	0	2	0	0	2
OG0030718	0	2	0	0	2
OG0030719	0	2	0	0	2
OG0030720	0	2	0	0	2
OG0030721	0	2	0	0	2
OG0030722	0	2	0	0	2
OG0030723	0	2	0	0	2
OG0030724	0	2	0	0	2
OG0030725	0	2	0	0	2
OG0030726	0	2	0	0	2
OG0030727	0	2	0	0	2
OG0030728	0	2	0	0	2
OG0030729	0	2	0	0	2
OG0030730	0	2	0	0	2
OG0030731	0	2	0	0	2
OG0030732	0	2	0	0	2
OG0030733	0	2	0	0	2
OG0030734	0	2	0	0	2
OG0030735	0	2	0	0	2
OG0030736	0	1	0	1	2
OG0030737	0	2	0	0	2
OG0030738	0	2	0	0	2
OG0030739	0	2	0	0	2
OG0030740	0	2	0	0	2
OG0030741	0	2	0	0	2
OG0030742	0	2	0	0	2
OG0030743	0	2	0	0	2
OG0030744	0	2	0	0	2
OG0030745	0	2	0	0	2
OG0030746	0	2	0	0	2
OG0030747	0	2	0	0	2
OG0030748	0	2	0	0	2
OG0030749	0	2	0	0	2
OG0030750	0	2	0	0	2
OG0030751	0	2	0	0	2
OG0030752	0	2	0	0	2
OG0030753	0	2	0	0	2
OG0030754	0	1	0	1	2
OG0030755	0	2	0	0	2
OG0030756	0	1	1	0	2
OG0030757	0	2	0	0	2
OG0030758	0	2	0	0	2
OG0030759	0	2	0	0	2
OG0030760	0	1	0	1	2
OG0030761	0	2	0	0	2
OG0030762	0	1	1	0	2
OG0030763	0	1	0	1	2
OG0030764	0	1	1	0	2
OG0030765	0	2	0	0	2
OG0030766	0	1	1	0	2
OG0030767	0	1	0	1	2
OG0030768	0	1	1	0	2
OG0030769	0	2	0	0	2
OG0030770	0	1	0	1	2
OG0030771	0	1	0	1	2
OG0030772	0	1	0	1	2
OG0030773	0	2	0	0	2
OG0030774	0	2	0	0	2
OG0030775	0	1	0	1	2
OG0030776	0	1	0	1	2
OG0030777	0	2	0	0	2
OG0030778	0	1	0	1	2
OG0030779	0	2	0	0	2
OG0030780	0	1	1	0	2
OG0030781	0	2	0	0	2
OG0030782	0	2	0	0	2
OG0030783	0	2	0	0	2
OG0030784	0	2	0	0	2
OG0030785	0	2	0	0	2
OG0030786	0	1	1	0	2
OG0030787	0	2	0	0	2
OG0030788	0	2	0	0	2
OG0030789	0	2	0	0	2
OG0030790	0	2	0	0	2
OG0030791	0	2	0	0	2
OG0030792	0	1	0	1	2
OG0030793	0	2	0	0	2
OG0030794	0	2	0	0	2
OG0030795	0	2	0	0	2
OG0030796	0	2	0	0	2
OG0030797	0	2	0	0	2
OG0030798	0	2	0	0	2
OG0030799	0	2	0	0	2
OG0030800	0	1	1	0	2
OG0030801	0	2	0	0	2
OG0030802	0	2	0	0	2
OG0030803	0	1	1	0	2
OG0030804	0	1	0	1	2
OG0030805	0	2	0	0	2
OG0030806	0	2	0	0	2
OG0030807	0	2	0	0	2
OG0030808	0	1	0	1	2
OG0030809	0	2	0	0	2
OG0030810	0	2	0	0	2
OG0030811	0	2	0	0	2
OG0030812	0	2	0	0	2
OG0030813	0	2	0	0	2
OG0030814	0	2	0	0	2
OG0030815	0	2	0	0	2
OG0030816	0	2	0	0	2
OG0030817	0	2	0	0	2
OG0030818	0	2	0	0	2
OG0030819	0	2	0	0	2
OG0030820	0	2	0	0	2
OG0030821	0	2	0	0	2
OG0030822	0	2	0	0	2
OG0030823	0	2	0	0	2
OG0030824	0	2	0	0	2
OG0030825	0	2	0	0	2
OG0030826	0	2	0	0	2
OG0030827	0	2	0	0	2
OG0030828	0	2	0	0	2
OG0030829	0	2	0	0	2
OG0030830	0	2	0	0	2
OG0030831	0	1	1	0	2
OG0030832	0	2	0	0	2
OG0030833	0	2	0	0	2
OG0030834	0	2	0	0	2
OG0030835	0	2	0	0	2
OG0030836	0	1	1	0	2
OG0030837	0	2	0	0	2
OG0030838	0	2	0	0	2
OG0030839	0	2	0	0	2
OG0030840	0	2	0	0	2
OG0030841	0	2	0	0	2
OG0030842	0	1	1	0	2
OG0030843	0	2	0	0	2
OG0030844	0	2	0	0	2
OG0030845	0	2	0	0	2
OG0030846	0	2	0	0	2
OG0030847	0	2	0	0	2
OG0030848	0	2	0	0	2
OG0030849	0	2	0	0	2
OG0030850	0	2	0	0	2
OG0030851	0	2	0	0	2
OG0030852	0	2	0	0	2
OG0030853	0	2	0	0	2
OG0030854	0	2	0	0	2
OG0030855	0	2	0	0	2
OG0030856	0	2	0	0	2
OG0030857	0	1	0	1	2
OG0030858	0	2	0	0	2
OG0030859	0	2	0	0	2
OG0030860	0	2	0	0	2
OG0030861	0	2	0	0	2
OG0030862	0	2	0	0	2
OG0030863	0	2	0	0	2
OG0030864	0	2	0	0	2
OG0030865	0	2	0	0	2
OG0030866	0	2	0	0	2
OG0030867	0	2	0	0	2
OG0030868	0	2	0	0	2
OG0030869	0	2	0	0	2
OG0030870	0	2	0	0	2
OG0030871	0	2	0	0	2
OG0030872	0	2	0	0	2
OG0030873	0	2	0	0	2
OG0030874	0	2	0	0	2
OG0030875	0	2	0	0	2
OG0030876	0	2	0	0	2
OG0030877	0	2	0	0	2
OG0030878	0	2	0	0	2
OG0030879	0	2	0	0	2
OG0030880	0	2	0	0	2
OG0030881	0	2	0	0	2
OG0030882	0	2	0	0	2
OG0030883	0	2	0	0	2
OG0030884	0	2	0	0	2
OG0030885	0	2	0	0	2
OG0030886	0	1	1	0	2
OG0030887	0	2	0	0	2
OG0030888	0	2	0	0	2
OG0030889	0	2	0	0	2
OG0030890	0	2	0	0	2
OG0030891	0	2	0	0	2
OG0030892	0	2	0	0	2
OG0030893	0	1	1	0	2
OG0030894	0	2	0	0	2
OG0030895	0	2	0	0	2
OG0030896	0	2	0	0	2
OG0030897	0	2	0	0	2
OG0030898	0	2	0	0	2
OG0030899	0	1	0	1	2
OG0030900	0	2	0	0	2
OG0030901	0	2	0	0	2
OG0030902	0	2	0	0	2
OG0030903	0	2	0	0	2
OG0030904	0	2	0	0	2
OG0030905	0	2	0	0	2
OG0030906	0	1	1	0	2
OG0030907	0	2	0	0	2
OG0030908	0	2	0	0	2
OG0030909	0	2	0	0	2
OG0030910	0	2	0	0	2
OG0030911	0	2	0	0	2
OG0030912	0	2	0	0	2
OG0030913	0	2	0	0	2
OG0030914	0	2	0	0	2
OG0030915	0	2	0	0	2
OG0030916	0	2	0	0	2
OG0030917	0	2	0	0	2
OG0030918	0	2	0	0	2
OG0030919	0	2	0	0	2
OG0030920	0	2	0	0	2
OG0030921	0	2	0	0	2
OG0030922	0	2	0	0	2
OG0030923	0	2	0	0	2
OG0030924	0	2	0	0	2
OG0030925	0	2	0	0	2
OG0030926	0	2	0	0	2
OG0030927	0	2	0	0	2
OG0030928	0	1	1	0	2
OG0030929	0	2	0	0	2
OG0030930	0	2	0	0	2
OG0030931	0	2	0	0	2
OG0030932	0	2	0	0	2
OG0030933	0	2	0	0	2
OG0030934	0	2	0	0	2
OG0030935	0	2	0	0	2
OG0030936	0	2	0	0	2
OG0030937	0	2	0	0	2
OG0030938	0	2	0	0	2
OG0030939	0	2	0	0	2
OG0030940	0	2	0	0	2
OG0030941	0	2	0	0	2
OG0030942	0	1	1	0	2
OG0030943	0	2	0	0	2
OG0030944	0	1	1	0	2
OG0030945	0	2	0	0	2
OG0030946	0	1	0	1	2
OG0030947	0	2	0	0	2
OG0030948	0	2	0	0	2
OG0030949	0	2	0	0	2
OG0030950	0	2	0	0	2
OG0030951	0	2	0	0	2
OG0030952	0	2	0	0	2
OG0030953	0	2	0	0	2
OG0030954	0	2	0	0	2
OG0030955	0	2	0	0	2
OG0030956	0	2	0	0	2
OG0030957	0	2	0	0	2
OG0030958	0	2	0	0	2
OG0030959	0	2	0	0	2
OG0030960	0	2	0	0	2
OG0030961	0	2	0	0	2
OG0030962	0	2	0	0	2
OG0030963	0	2	0	0	2
OG0030964	0	2	0	0	2
OG0030965	0	2	0	0	2
OG0030966	0	1	0	1	2
OG0030967	0	2	0	0	2
OG0030968	0	2	0	0	2
OG0030969	0	2	0	0	2
OG0030970	0	1	1	0	2
OG0030971	0	1	0	1	2
OG0030972	0	2	0	0	2
OG0030973	0	2	0	0	2
OG0030974	0	2	0	0	2
OG0030975	0	1	0	1	2
OG0030976	0	2	0	0	2
OG0030977	0	1	1	0	2
OG0030978	0	2	0	0	2
OG0030979	0	1	0	1	2
OG0030980	0	1	1	0	2
OG0030981	0	1	1	0	2
OG0030982	0	2	0	0	2
OG0030983	0	1	0	1	2
OG0030984	0	1	1	0	2
OG0030985	0	1	1	0	2
OG0030986	0	2	0	0	2
OG0030987	0	2	0	0	2
OG0030988	0	2	0	0	2
OG0030989	0	1	1	0	2
OG0030990	0	1	1	0	2
OG0030991	0	2	0	0	2
OG0030992	0	2	0	0	2
OG0030993	0	1	1	0	2
OG0030994	0	1	1	0	2
OG0030995	0	1	1	0	2
OG0030996	0	1	0	1	2
OG0030997	0	1	1	0	2
OG0030998	0	1	1	0	2
OG0030999	0	2	0	0	2
OG0031000	0	2	0	0	2
OG0031001	0	1	1	0	2
OG0031002	0	2	0	0	2
OG0031003	0	1	0	1	2
OG0031004	0	2	0	0	2
OG0031005	0	2	0	0	2
OG0031006	0	1	0	1	2
OG0031007	0	2	0	0	2
OG0031008	0	1	0	1	2
OG0031009	0	2	0	0	2
OG0031010	0	2	0	0	2
OG0031011	0	2	0	0	2
OG0031012	0	1	0	1	2
OG0031013	0	1	1	0	2
OG0031014	0	1	1	0	2
OG0031015	0	2	0	0	2
OG0031016	0	2	0	0	2
OG0031017	0	2	0	0	2
OG0031018	0	2	0	0	2
OG0031019	0	2	0	0	2
OG0031020	0	2	0	0	2
OG0031021	0	1	1	0	2
OG0031022	0	2	0	0	2
OG0031023	0	2	0	0	2
OG0031024	0	1	0	1	2
OG0031025	0	2	0	0	2
OG0031026	0	2	0	0	2
OG0031027	0	2	0	0	2
OG0031028	0	2	0	0	2
OG0031029	0	2	0	0	2
OG0031030	0	2	0	0	2
OG0031031	0	2	0	0	2
OG0031032	0	2	0	0	2
OG0031033	0	2	0	0	2
OG0031034	0	2	0	0	2
OG0031035	0	2	0	0	2
OG0031036	0	2	0	0	2
OG0031037	0	2	0	0	2
OG0031038	0	2	0	0	2
OG0031039	0	2	0	0	2
OG0031040	0	2	0	0	2
OG0031041	0	2	0	0	2
OG0031042	0	2	0	0	2
OG0031043	0	2	0	0	2
OG0031044	0	2	0	0	2
OG0031045	0	2	0	0	2
OG0031046	0	2	0	0	2
OG0031047	0	2	0	0	2
OG0031048	0	2	0	0	2
OG0031049	0	2	0	0	2
OG0031050	0	2	0	0	2
OG0031051	0	2	0	0	2
OG0031052	0	2	0	0	2
OG0031053	0	2	0	0	2
OG0031054	0	2	0	0	2
OG0031055	0	2	0	0	2
OG0031056	0	2	0	0	2
OG0031057	0	2	0	0	2
OG0031058	0	2	0	0	2
OG0031059	0	2	0	0	2
OG0031060	0	1	0	1	2
OG0031061	0	2	0	0	2
OG0031062	0	2	0	0	2
OG0031063	0	2	0	0	2
OG0031064	0	2	0	0	2
OG0031065	0	2	0	0	2
OG0031066	0	2	0	0	2
OG0031067	0	2	0	0	2
OG0031068	0	2	0	0	2
OG0031069	0	2	0	0	2
OG0031070	0	2	0	0	2
OG0031071	0	2	0	0	2
OG0031072	0	2	0	0	2
OG0031073	0	2	0	0	2
OG0031074	0	2	0	0	2
OG0031075	0	2	0	0	2
OG0031076	0	2	0	0	2
OG0031077	0	2	0	0	2
OG0031078	0	2	0	0	2
OG0031079	0	2	0	0	2
OG0031080	0	2	0	0	2
OG0031081	0	2	0	0	2
OG0031082	0	2	0	0	2
OG0031083	0	2	0	0	2
OG0031084	0	2	0	0	2
OG0031085	0	2	0	0	2
OG0031086	0	2	0	0	2
OG0031087	0	2	0	0	2
OG0031088	0	2	0	0	2
OG0031089	0	2	0	0	2
OG0031090	0	1	0	1	2
OG0031091	0	2	0	0	2
OG0031092	0	2	0	0	2
OG0031093	0	2	0	0	2
OG0031094	0	2	0	0	2
OG0031095	0	2	0	0	2
OG0031096	0	2	0	0	2
OG0031097	0	2	0	0	2
OG0031098	0	2	0	0	2
OG0031099	0	2	0	0	2
OG0031100	0	1	1	0	2
OG0031101	0	2	0	0	2
OG0031102	0	1	1	0	2
OG0031103	0	1	0	1	2
OG0031104	0	2	0	0	2
OG0031105	0	1	1	0	2
OG0031106	0	1	1	0	2
OG0031107	0	2	0	0	2
OG0031108	0	1	1	0	2
OG0031109	0	1	0	1	2
OG0031110	0	2	0	0	2
OG0031111	0	1	0	1	2
OG0031112	0	2	0	0	2
OG0031113	0	2	0	0	2
OG0031114	0	2	0	0	2
OG0031115	0	2	0	0	2
OG0031116	0	2	0	0	2
OG0031117	0	2	0	0	2
OG0031118	0	1	0	1	2
OG0031119	0	2	0	0	2
OG0031120	0	2	0	0	2
OG0031121	0	2	0	0	2
OG0031122	0	2	0	0	2
OG0031123	0	2	0	0	2
OG0031124	0	2	0	0	2
OG0031125	0	2	0	0	2
OG0031126	0	2	0	0	2
OG0031127	0	2	0	0	2
OG0031128	0	2	0	0	2
OG0031129	0	1	0	1	2
OG0031130	0	2	0	0	2
OG0031131	0	2	0	0	2
OG0031132	0	2	0	0	2
OG0031133	0	1	1	0	2
OG0031134	0	2	0	0	2
OG0031135	0	2	0	0	2
OG0031136	0	2	0	0	2
OG0031137	0	2	0	0	2
OG0031138	0	2	0	0	2
OG0031139	0	2	0	0	2
OG0031140	0	2	0	0	2
OG0031141	0	2	0	0	2
OG0031142	0	2	0	0	2
OG0031143	0	2	0	0	2
OG0031144	0	2	0	0	2
OG0031145	0	1	0	1	2
OG0031146	0	2	0	0	2
OG0031147	0	2	0	0	2
OG0031148	0	2	0	0	2
OG0031149	0	2	0	0	2
OG0031150	0	2	0	0	2
OG0031151	0	2	0	0	2
OG0031152	0	2	0	0	2
OG0031153	0	2	0	0	2
OG0031154	0	1	1	0	2
OG0031155	0	2	0	0	2
OG0031156	0	1	0	1	2
OG0031157	0	2	0	0	2
OG0031158	0	2	0	0	2
OG0031159	0	2	0	0	2
OG0031160	0	2	0	0	2
OG0031161	0	2	0	0	2
OG0031162	0	2	0	0	2
OG0031163	0	2	0	0	2
OG0031164	0	1	0	1	2
OG0031165	0	2	0	0	2
OG0031166	0	2	0	0	2
OG0031167	0	2	0	0	2
OG0031168	0	2	0	0	2
OG0031169	0	2	0	0	2
OG0031170	0	2	0	0	2
OG0031171	0	2	0	0	2
OG0031172	0	2	0	0	2
OG0031173	0	2	0	0	2
OG0031174	0	2	0	0	2
OG0031175	0	2	0	0	2
OG0031176	0	2	0	0	2
OG0031177	0	2	0	0	2
OG0031178	0	2	0	0	2
OG0031179	0	2	0	0	2
OG0031180	0	2	0	0	2
OG0031181	0	2	0	0	2
OG0031182	0	2	0	0	2
OG0031183	0	2	0	0	2
OG0031184	0	2	0	0	2
OG0031185	0	2	0	0	2
OG0031186	0	2	0	0	2
OG0031187	0	1	0	1	2
OG0031188	0	1	1	0	2
OG0031189	0	1	0	1	2
OG0031190	0	1	0	1	2
OG0031191	0	1	0	1	2
OG0031192	0	1	1	0	2
OG0031193	0	1	1	0	2
OG0031194	0	2	0	0	2
OG0031195	0	1	0	1	2
OG0031196	0	1	0	1	2
OG0031197	0	1	0	1	2
OG0031198	0	2	0	0	2
OG0031199	0	1	1	0	2
OG0031200	0	2	0	0	2
OG0031201	0	1	0	1	2
OG0031202	0	2	0	0	2
OG0031203	0	1	1	0	2
OG0031204	0	2	0	0	2
OG0031205	0	2	0	0	2
OG0031206	0	2	0	0	2
OG0031207	0	2	0	0	2
OG0031208	0	2	0	0	2
OG0031209	0	2	0	0	2
OG0031210	0	1	1	0	2
OG0031211	0	2	0	0	2
OG0031212	0	2	0	0	2
OG0031213	0	2	0	0	2
OG0031214	0	1	0	1	2
OG0031215	0	2	0	0	2
OG0031216	0	2	0	0	2
OG0031217	0	1	0	1	2
OG0031218	0	2	0	0	2
OG0031219	0	2	0	0	2
OG0031220	0	2	0	0	2
OG0031221	0	2	0	0	2
OG0031222	0	2	0	0	2
OG0031223	0	2	0	0	2
OG0031224	0	2	0	0	2
OG0031225	0	1	0	1	2
OG0031226	0	2	0	0	2
OG0031227	0	2	0	0	2
OG0031228	0	2	0	0	2
OG0031229	0	2	0	0	2
OG0031230	0	2	0	0	2
OG0031231	0	2	0	0	2
OG0031232	0	2	0	0	2
OG0031233	0	2	0	0	2
OG0031234	0	2	0	0	2
OG0031235	0	2	0	0	2
OG0031236	0	1	0	1	2
OG0031237	0	2	0	0	2
OG0031238	0	1	1	0	2
OG0031239	0	2	0	0	2
OG0031240	0	2	0	0	2
OG0031241	0	2	0	0	2
OG0031242	0	2	0	0	2
OG0031243	0	2	0	0	2
OG0031244	0	2	0	0	2
OG0031245	0	2	0	0	2
OG0031246	0	2	0	0	2
OG0031247	0	2	0	0	2
OG0031248	0	2	0	0	2
OG0031249	0	2	0	0	2
OG0031250	0	2	0	0	2
OG0031251	0	2	0	0	2
OG0031252	0	2	0	0	2
OG0031253	0	2	0	0	2
OG0031254	0	2	0	0	2
OG0031255	0	2	0	0	2
OG0031256	0	2	0	0	2
OG0031257	0	2	0	0	2
OG0031258	0	1	0	1	2
OG0031259	0	2	0	0	2
OG0031260	0	2	0	0	2
OG0031261	0	2	0	0	2
OG0031262	0	2	0	0	2
OG0031263	0	2	0	0	2
OG0031264	0	2	0	0	2
OG0031265	0	2	0	0	2
OG0031266	0	1	1	0	2
OG0031267	0	2	0	0	2
OG0031268	0	2	0	0	2
OG0031269	0	2	0	0	2
OG0031270	0	1	1	0	2
OG0031271	0	1	1	0	2
OG0031272	0	1	0	1	2
OG0031273	0	1	0	1	2
OG0031274	0	1	1	0	2
OG0031275	0	1	0	1	2
OG0031276	0	1	0	1	2
OG0031277	0	1	0	1	2
OG0031278	0	1	1	0	2
OG0031279	0	1	0	1	2
OG0031280	0	2	0	0	2
OG0031281	0	2	0	0	2
OG0031282	0	2	0	0	2
OG0031283	0	1	0	1	2
OG0031284	0	2	0	0	2
OG0031285	0	1	0	1	2
OG0031286	0	2	0	0	2
OG0031287	0	2	0	0	2
OG0031288	0	2	0	0	2
OG0031289	0	2	0	0	2
OG0031290	0	2	0	0	2
OG0031291	0	1	1	0	2
OG0031292	0	2	0	0	2
OG0031293	0	2	0	0	2
OG0031294	0	2	0	0	2
OG0031295	0	2	0	0	2
OG0031296	0	2	0	0	2
OG0031297	0	2	0	0	2
OG0031298	0	2	0	0	2
OG0031299	0	2	0	0	2
OG0031300	0	2	0	0	2
OG0031301	0	2	0	0	2
OG0031302	0	1	0	1	2
OG0031303	0	2	0	0	2
OG0031304	0	2	0	0	2
OG0031305	0	2	0	0	2
OG0031306	0	2	0	0	2
OG0031307	0	2	0	0	2
OG0031308	0	1	1	0	2
OG0031309	0	2	0	0	2
OG0031310	0	2	0	0	2
OG0031311	0	2	0	0	2
OG0031312	0	2	0	0	2
OG0031313	0	1	0	1	2
OG0031314	0	2	0	0	2
OG0031315	0	2	0	0	2
OG0031316	0	2	0	0	2
OG0031317	0	2	0	0	2
OG0031318	0	2	0	0	2
OG0031319	0	2	0	0	2
OG0031320	0	1	1	0	2
OG0031321	0	1	1	0	2
OG0031322	0	2	0	0	2
OG0031323	0	1	0	1	2
OG0031324	0	2	0	0	2
OG0031325	0	2	0	0	2
OG0031326	0	2	0	0	2
OG0031327	0	1	0	1	2
OG0031328	0	2	0	0	2
OG0031329	0	2	0	0	2
OG0031330	0	2	0	0	2
OG0031331	0	2	0	0	2
OG0031332	0	2	0	0	2
OG0031333	0	2	0	0	2
OG0031334	0	2	0	0	2
OG0031335	0	2	0	0	2
OG0031336	0	2	0	0	2
OG0031337	0	1	0	1	2
OG0031338	0	2	0	0	2
OG0031339	0	2	0	0	2
OG0031340	0	2	0	0	2
OG0031341	0	2	0	0	2
OG0031342	0	2	0	0	2
OG0031343	0	1	0	1	2
OG0031344	0	2	0	0	2
OG0031345	0	2	0	0	2
OG0031346	0	1	1	0	2
OG0031347	0	2	0	0	2
OG0031348	0	2	0	0	2
OG0031349	0	2	0	0	2
OG0031350	0	1	0	1	2
OG0031351	0	2	0	0	2
OG0031352	0	2	0	0	2
OG0031353	0	1	0	1	2
OG0031354	0	1	0	1	2
OG0031355	0	1	0	1	2
OG0031356	0	1	1	0	2
OG0031357	0	1	1	0	2
OG0031358	0	2	0	0	2
OG0031359	0	1	0	1	2
OG0031360	0	2	0	0	2
OG0031361	0	1	1	0	2
OG0031362	0	1	1	0	2
OG0031363	0	1	1	0	2
OG0031364	0	1	1	0	2
OG0031365	0	1	1	0	2
OG0031366	0	2	0	0	2
OG0031367	0	2	0	0	2
OG0031368	0	1	0	1	2
OG0031369	0	2	0	0	2
OG0031370	0	1	1	0	2
OG0031371	0	2	0	0	2
OG0031372	0	2	0	0	2
OG0031373	0	2	0	0	2
OG0031374	0	1	1	0	2
OG0031375	0	1	0	1	2
OG0031376	0	2	0	0	2
OG0031377	0	2	0	0	2
OG0031378	0	2	0	0	2
OG0031379	0	2	0	0	2
OG0031380	0	2	0	0	2
OG0031381	0	2	0	0	2
OG0031382	0	2	0	0	2
OG0031383	0	2	0	0	2
OG0031384	0	1	0	1	2
OG0031385	0	2	0	0	2
OG0031386	0	2	0	0	2
OG0031387	0	2	0	0	2
OG0031388	0	2	0	0	2
OG0031389	0	1	0	1	2
OG0031390	0	2	0	0	2
OG0031391	0	1	1	0	2
OG0031392	0	2	0	0	2
OG0031393	0	2	0	0	2
OG0031394	0	2	0	0	2
OG0031395	0	2	0	0	2
OG0031396	0	2	0	0	2
OG0031397	0	2	0	0	2
OG0031398	0	2	0	0	2
OG0031399	0	2	0	0	2
OG0031400	0	2	0	0	2
OG0031401	0	2	0	0	2
OG0031402	0	2	0	0	2
OG0031403	0	2	0	0	2
OG0031404	0	2	0	0	2
OG0031405	0	2	0	0	2
OG0031406	0	2	0	0	2
OG0031407	0	2	0	0	2
OG0031408	0	2	0	0	2
OG0031409	0	2	0	0	2
OG0031410	0	2	0	0	2
OG0031411	0	2	0	0	2
OG0031412	0	2	0	0	2
OG0031413	0	2	0	0	2
OG0031414	0	2	0	0	2
OG0031415	0	2	0	0	2
OG0031416	0	2	0	0	2
OG0031417	0	2	0	0	2
OG0031418	0	2	0	0	2
OG0031419	0	2	0	0	2
OG0031420	0	2	0	0	2
OG0031421	0	2	0	0	2
OG0031422	0	2	0	0	2
OG0031423	0	1	1	0	2
OG0031424	0	2	0	0	2
OG0031425	0	2	0	0	2
OG0031426	0	2	0	0	2
OG0031427	0	2	0	0	2
OG0031428	0	2	0	0	2
OG0031429	0	2	0	0	2
OG0031430	0	2	0	0	2
OG0031431	0	2	0	0	2
OG0031432	0	2	0	0	2
OG0031433	0	2	0	0	2
OG0031434	0	2	0	0	2
OG0031435	0	2	0	0	2
OG0031436	0	2	0	0	2
OG0031437	0	2	0	0	2
OG0031438	0	2	0	0	2
OG0031439	0	2	0	0	2
OG0031440	0	2	0	0	2
OG0031441	0	2	0	0	2
OG0031442	0	2	0	0	2
OG0031443	0	2	0	0	2
OG0031444	0	2	0	0	2
OG0031445	0	2	0	0	2
OG0031446	0	1	0	1	2
OG0031447	0	2	0	0	2
OG0031448	0	2	0	0	2
OG0031449	0	2	0	0	2
OG0031450	0	1	1	0	2
OG0031451	0	2	0	0	2
OG0031452	0	2	0	0	2
OG0031453	0	2	0	0	2
OG0031454	0	2	0	0	2
OG0031455	0	1	0	1	2
OG0031456	0	2	0	0	2
OG0031457	0	2	0	0	2
OG0031458	0	2	0	0	2
OG0031459	0	2	0	0	2
OG0031460	0	2	0	0	2
OG0031461	0	2	0	0	2
OG0031462	0	2	0	0	2
OG0031463	0	1	1	0	2
OG0031464	0	2	0	0	2
OG0031465	0	2	0	0	2
OG0031466	0	2	0	0	2
OG0031467	0	2	0	0	2
OG0031468	0	2	0	0	2
OG0031469	0	2	0	0	2
OG0031470	0	1	0	1	2
OG0031471	0	2	0	0	2
OG0031472	0	2	0	0	2
OG0031473	0	2	0	0	2
OG0031474	0	2	0	0	2
OG0031475	0	1	1	0	2
OG0031476	0	2	0	0	2
OG0031477	0	2	0	0	2
OG0031478	0	2	0	0	2
OG0031479	0	1	1	0	2
OG0031480	0	2	0	0	2
OG0031481	0	2	0	0	2
OG0031482	0	2	0	0	2
OG0031483	0	2	0	0	2
OG0031484	0	2	0	0	2
OG0031485	0	2	0	0	2
OG0031486	0	1	1	0	2
OG0031487	0	2	0	0	2
OG0031488	0	2	0	0	2
OG0031489	0	2	0	0	2
OG0031490	0	2	0	0	2
OG0031491	0	2	0	0	2
OG0031492	0	2	0	0	2
OG0031493	0	2	0	0	2
OG0031494	0	1	1	0	2
OG0031495	0	2	0	0	2
OG0031496	0	1	1	0	2
OG0031497	0	1	1	0	2
OG0031498	0	2	0	0	2
OG0031499	0	1	1	0	2
OG0031500	0	1	1	0	2
OG0031501	0	2	0	0	2
OG0031502	0	2	0	0	2
OG0031503	0	2	0	0	2
OG0031504	0	2	0	0	2
OG0031505	0	1	1	0	2
OG0031506	0	1	0	1	2
OG0031507	0	1	0	1	2
OG0031508	0	1	0	1	2
OG0031509	0	2	0	0	2
OG0031510	0	1	1	0	2
OG0031511	0	2	0	0	2
OG0031512	0	2	0	0	2
OG0031513	0	2	0	0	2
OG0031514	0	2	0	0	2
OG0031515	0	2	0	0	2
OG0031516	0	1	0	1	2
OG0031517	0	2	0	0	2
OG0031518	0	2	0	0	2
OG0031519	0	2	0	0	2
OG0031520	0	2	0	0	2
OG0031521	0	2	0	0	2
OG0031522	0	2	0	0	2
OG0031523	0	2	0	0	2
OG0031524	0	2	0	0	2
OG0031525	0	2	0	0	2
OG0031526	0	2	0	0	2
OG0031527	0	2	0	0	2
OG0031528	0	2	0	0	2
OG0031529	0	2	0	0	2
OG0031530	0	2	0	0	2
OG0031531	0	2	0	0	2
OG0031532	0	2	0	0	2
OG0031533	0	2	0	0	2
OG0031534	0	1	0	1	2
OG0031535	0	2	0	0	2
OG0031536	0	1	0	1	2
OG0031537	0	2	0	0	2
OG0031538	0	2	0	0	2
OG0031539	0	2	0	0	2
OG0031540	0	2	0	0	2
OG0031541	0	2	0	0	2
OG0031542	0	2	0	0	2
OG0031543	0	2	0	0	2
OG0031544	0	2	0	0	2
OG0031545	0	2	0	0	2
OG0031546	0	1	0	1	2
OG0031547	0	2	0	0	2
OG0031548	0	2	0	0	2
OG0031549	0	1	0	1	2
OG0031550	0	2	0	0	2
OG0031551	0	2	0	0	2
OG0031552	0	1	0	1	2
OG0031553	0	1	1	0	2
OG0031554	0	2	0	0	2
OG0031555	0	1	1	0	2
OG0031556	0	2	0	0	2
OG0031557	0	1	0	1	2
OG0031558	0	2	0	0	2
OG0031559	0	2	0	0	2
OG0031560	0	2	0	0	2
OG0031561	0	2	0	0	2
OG0031562	0	1	1	0	2
OG0031563	0	1	0	1	2
OG0031564	0	1	0	1	2
OG0031565	0	2	0	0	2
OG0031566	0	1	0	1	2
OG0031567	0	1	1	0	2
OG0031568	0	2	0	0	2
OG0031569	0	1	1	0	2
OG0031570	0	2	0	0	2
OG0031571	0	2	0	0	2
OG0031572	0	1	1	0	2
OG0031573	0	2	0	0	2
OG0031574	0	1	1	0	2
OG0031575	0	2	0	0	2
OG0031576	0	1	1	0	2
OG0031577	0	2	0	0	2
OG0031578	0	2	0	0	2
OG0031579	0	1	1	0	2
OG0031580	0	2	0	0	2
OG0031581	0	1	0	1	2
OG0031582	0	1	0	1	2
OG0031583	0	2	0	0	2
OG0031584	0	2	0	0	2
OG0031585	0	1	0	1	2
OG0031586	0	1	0	1	2
OG0031587	0	2	0	0	2
OG0031588	0	1	0	1	2
OG0031589	0	2	0	0	2
OG0031590	0	2	0	0	2
OG0031591	0	2	0	0	2
OG0031592	0	2	0	0	2
OG0031593	0	2	0	0	2
OG0031594	0	2	0	0	2
OG0031595	0	2	0	0	2
OG0031596	0	2	0	0	2
OG0031597	0	2	0	0	2
OG0031598	0	2	0	0	2
OG0031599	0	2	0	0	2
OG0031600	0	2	0	0	2
OG0031601	0	2	0	0	2
OG0031602	0	2	0	0	2
OG0031603	0	1	0	1	2
OG0031604	0	2	0	0	2
OG0031605	0	2	0	0	2
OG0031606	0	2	0	0	2
OG0031607	0	2	0	0	2
OG0031608	0	2	0	0	2
OG0031609	0	2	0	0	2
OG0031610	0	2	0	0	2
OG0031611	0	1	0	1	2
OG0031612	0	2	0	0	2
OG0031613	0	2	0	0	2
OG0031614	0	2	0	0	2
OG0031615	0	2	0	0	2
OG0031616	0	2	0	0	2
OG0031617	0	2	0	0	2
OG0031618	0	2	0	0	2
OG0031619	0	2	0	0	2
OG0031620	0	2	0	0	2
OG0031621	0	2	0	0	2
OG0031622	0	2	0	0	2
OG0031623	0	2	0	0	2
OG0031624	0	2	0	0	2
OG0031625	0	2	0	0	2
OG0031626	0	2	0	0	2
OG0031627	0	2	0	0	2
OG0031628	0	1	1	0	2
OG0031629	0	2	0	0	2
OG0031630	0	2	0	0	2
OG0031631	0	2	0	0	2
OG0031632	0	2	0	0	2
OG0031633	0	2	0	0	2
OG0031634	0	2	0	0	2
OG0031635	0	2	0	0	2
OG0031636	0	2	0	0	2
OG0031637	0	2	0	0	2
OG0031638	0	2	0	0	2
OG0031639	0	2	0	0	2
OG0031640	0	2	0	0	2
OG0031641	0	2	0	0	2
OG0031642	0	2	0	0	2
OG0031643	0	2	0	0	2
OG0031644	0	1	1	0	2
OG0031645	0	1	1	0	2
OG0031646	0	2	0	0	2
OG0031647	0	1	1	0	2
OG0031648	0	1	0	1	2
OG0031649	0	2	0	0	2
OG0031650	0	2	0	0	2
OG0031651	0	2	0	0	2
OG0031652	0	2	0	0	2
OG0031653	0	1	0	1	2
OG0031654	0	1	0	1	2
OG0031655	0	2	0	0	2
OG0031656	0	2	0	0	2
OG0031657	0	2	0	0	2
OG0031658	0	2	0	0	2
OG0031659	0	2	0	0	2
OG0031660	0	2	0	0	2
OG0031661	0	1	0	1	2
OG0031662	0	2	0	0	2
OG0031663	0	2	0	0	2
OG0031664	0	2	0	0	2
OG0031665	0	2	0	0	2
OG0031666	0	2	0	0	2
OG0031667	0	2	0	0	2
OG0031668	0	1	0	1	2
OG0031669	0	2	0	0	2
OG0031670	0	2	0	0	2
OG0031671	0	1	0	1	2
OG0031672	0	2	0	0	2
OG0031673	0	2	0	0	2
OG0031674	0	2	0	0	2
OG0031675	0	2	0	0	2
OG0031676	0	2	0	0	2
OG0031677	0	2	0	0	2
OG0031678	0	2	0	0	2
OG0031679	0	2	0	0	2
OG0031680	0	2	0	0	2
OG0031681	0	2	0	0	2
OG0031682	0	2	0	0	2
OG0031683	0	2	0	0	2
OG0031684	0	1	1	0	2
OG0031685	0	2	0	0	2
OG0031686	0	2	0	0	2
OG0031687	0	2	0	0	2
OG0031688	0	2	0	0	2
OG0031689	0	2	0	0	2
OG0031690	0	2	0	0	2
OG0031691	0	2	0	0	2
OG0031692	0	2	0	0	2
OG0031693	0	2	0	0	2
OG0031694	0	2	0	0	2
OG0031695	0	2	0	0	2
OG0031696	0	2	0	0	2
OG0031697	0	2	0	0	2
OG0031698	0	1	0	1	2
OG0031699	0	1	1	0	2
OG0031700	0	2	0	0	2
OG0031701	0	2	0	0	2
OG0031702	0	2	0	0	2
OG0031703	0	2	0	0	2
OG0031704	0	2	0	0	2
OG0031705	0	2	0	0	2
OG0031706	0	2	0	0	2
OG0031707	0	2	0	0	2
OG0031708	0	2	0	0	2
OG0031709	0	2	0	0	2
OG0031710	0	2	0	0	2
OG0031711	0	1	1	0	2
OG0031712	0	1	1	0	2
OG0031713	0	2	0	0	2
OG0031714	0	2	0	0	2
OG0031715	0	1	1	0	2
OG0031716	0	1	0	1	2
OG0031717	0	1	0	1	2
OG0031718	0	1	0	1	2
OG0031719	0	2	0	0	2
OG0031720	0	2	0	0	2
OG0031721	0	2	0	0	2
OG0031722	0	1	1	0	2
OG0031723	0	2	0	0	2
OG0031724	0	2	0	0	2
OG0031725	0	2	0	0	2
OG0031726	0	2	0	0	2
OG0031727	0	1	0	1	2
OG0031728	0	2	0	0	2
OG0031729	0	2	0	0	2
OG0031730	0	2	0	0	2
OG0031731	0	2	0	0	2
OG0031732	0	1	0	1	2
OG0031733	0	2	0	0	2
OG0031734	0	2	0	0	2
OG0031735	0	2	0	0	2
OG0031736	0	2	0	0	2
OG0031737	0	2	0	0	2
OG0031738	0	2	0	0	2
OG0031739	0	1	0	1	2
OG0031740	0	1	1	0	2
OG0031741	0	2	0	0	2
OG0031742	0	2	0	0	2
OG0031743	0	2	0	0	2
OG0031744	0	1	1	0	2
OG0031745	0	1	0	1	2
OG0031746	0	2	0	0	2
OG0031747	0	2	0	0	2
OG0031748	0	1	0	1	2
OG0031749	0	2	0	0	2
OG0031750	0	2	0	0	2
OG0031751	0	2	0	0	2
OG0031752	0	1	0	1	2
OG0031753	0	2	0	0	2
OG0031754	0	2	0	0	2
OG0031755	0	2	0	0	2
OG0031756	0	1	0	1	2
OG0031757	0	1	1	0	2
OG0031758	0	1	1	0	2
OG0031759	0	1	0	1	2
OG0031760	0	2	0	0	2
OG0031761	0	2	0	0	2
OG0031762	0	2	0	0	2
OG0031763	0	1	0	1	2
OG0031764	0	1	0	1	2
OG0031765	0	2	0	0	2
OG0031766	0	1	1	0	2
OG0031767	0	2	0	0	2
OG0031768	0	1	0	1	2
OG0031769	0	1	1	0	2
OG0031770	0	2	0	0	2
OG0031771	0	2	0	0	2
OG0031772	0	1	0	1	2
OG0031773	0	1	1	0	2
OG0031774	0	2	0	0	2
OG0031775	0	1	0	1	2
OG0031776	0	2	0	0	2
OG0031777	0	2	0	0	2
OG0031778	0	2	0	0	2
OG0031779	0	1	1	0	2
OG0031780	0	2	0	0	2
OG0031781	0	1	1	0	2
OG0031782	0	1	1	0	2
OG0031783	0	1	1	0	2
OG0031784	0	1	1	0	2
OG0031785	0	2	0	0	2
OG0031786	0	2	0	0	2
OG0031787	0	2	0	0	2
OG0031788	0	2	0	0	2
OG0031789	0	2	0	0	2
OG0031790	0	1	1	0	2
OG0031791	0	2	0	0	2
OG0031792	0	2	0	0	2
OG0031793	0	2	0	0	2
OG0031794	0	2	0	0	2
OG0031795	0	2	0	0	2
OG0031796	0	2	0	0	2
OG0031797	0	2	0	0	2
OG0031798	0	1	1	0	2
OG0031799	0	2	0	0	2
OG0031800	0	1	1	0	2
OG0031801	0	1	1	0	2
OG0031802	0	2	0	0	2
OG0031803	0	2	0	0	2
OG0031804	0	2	0	0	2
OG0031805	0	2	0	0	2
OG0031806	0	2	0	0	2
OG0031807	0	2	0	0	2
OG0031808	0	2	0	0	2
OG0031809	0	2	0	0	2
OG0031810	0	2	0	0	2
OG0031811	0	1	0	1	2
OG0031812	0	2	0	0	2
OG0031813	0	2	0	0	2
OG0031814	0	1	0	1	2
OG0031815	0	1	1	0	2
OG0031816	0	1	1	0	2
OG0031817	0	1	0	1	2
OG0031818	0	1	0	1	2
OG0031819	0	1	0	1	2
OG0031820	0	1	0	1	2
OG0031821	0	1	1	0	2
OG0031822	0	2	0	0	2
OG0031823	0	1	1	0	2
OG0031824	0	1	0	1	2
OG0031825	0	1	1	0	2
OG0031826	0	1	0	1	2
OG0031827	0	2	0	0	2
OG0031828	0	1	0	1	2
OG0031829	0	1	1	0	2
OG0031830	0	1	0	1	2
OG0031831	0	1	1	0	2
OG0031832	0	1	0	1	2
OG0031833	0	1	0	1	2
OG0031834	0	2	0	0	2
OG0031835	0	2	0	0	2
OG0031836	0	1	1	0	2
OG0031837	0	2	0	0	2
OG0031838	0	2	0	0	2
OG0031839	0	2	0	0	2
OG0031840	0	2	0	0	2
OG0031841	0	1	1	0	2
OG0031842	0	1	0	1	2
OG0031843	0	1	1	0	2
OG0031844	0	1	1	0	2
OG0031845	0	1	1	0	2
OG0031846	0	2	0	0	2
OG0031847	0	2	0	0	2
OG0031848	0	2	0	0	2
OG0031849	0	2	0	0	2
OG0031850	0	1	0	1	2
OG0031851	0	2	0	0	2
OG0031852	0	2	0	0	2
OG0031853	0	2	0	0	2
OG0031854	0	2	0	0	2
OG0031855	0	2	0	0	2
OG0031856	0	2	0	0	2
OG0031857	0	2	0	0	2
OG0031858	0	1	0	1	2
OG0031859	0	2	0	0	2
OG0031860	0	2	0	0	2
OG0031861	0	2	0	0	2
OG0031862	0	2	0	0	2
OG0031863	0	2	0	0	2
OG0031864	0	2	0	0	2
OG0031865	0	1	1	0	2
OG0031866	0	2	0	0	2
OG0031867	0	2	0	0	2
OG0031868	0	1	1	0	2
OG0031869	0	2	0	0	2
OG0031870	0	2	0	0	2
OG0031871	0	1	0	1	2
OG0031872	0	1	0	1	2
OG0031873	0	1	0	1	2
OG0031874	0	0	1	1	2
OG0031875	0	0	1	1	2
OG0031876	0	0	2	0	2
OG0031877	0	0	2	0	2
OG0031878	0	0	1	1	2
OG0031879	0	0	2	0	2
OG0031880	0	0	2	0	2
OG0031881	0	0	1	1	2
OG0031882	0	0	1	1	2
OG0031883	0	0	1	1	2
OG0031884	0	0	1	1	2
OG0031885	0	0	2	0	2
OG0031886	0	0	2	0	2
OG0031887	0	0	2	0	2
OG0031888	0	0	1	1	2
OG0031889	0	0	2	0	2
OG0031890	0	0	1	1	2
OG0031891	0	0	1	1	2
OG0031892	0	0	1	1	2
OG0031893	0	0	1	1	2
OG0031894	0	0	2	0	2
OG0031895	0	0	1	1	2
OG0031896	0	0	1	1	2
OG0031897	0	0	1	1	2
OG0031898	0	0	1	1	2
OG0031899	0	0	2	0	2
OG0031900	0	0	1	1	2
OG0031901	0	0	2	0	2
OG0031902	0	0	1	1	2
OG0031903	0	0	1	1	2
OG0031904	0	0	2	0	2
OG0031905	0	0	1	1	2
OG0031906	0	0	1	1	2
OG0031907	0	0	1	1	2
OG0031908	0	0	1	1	2
OG0031909	0	0	2	0	2
OG0031910	0	0	1	1	2
OG0031911	0	0	2	0	2
OG0031912	0	0	1	1	2
OG0031913	0	0	2	0	2
OG0031914	0	0	1	1	2
OG0031915	0	0	2	0	2
OG0031916	0	0	1	1	2
OG0031917	0	0	1	1	2
OG0031918	0	0	1	1	2
OG0031919	0	0	1	1	2
OG0031920	0	0	2	0	2
OG0031921	0	0	1	1	2
OG0031922	0	0	2	0	2
OG0031923	0	0	1	1	2
OG0031924	0	0	1	1	2
OG0031925	0	0	2	0	2
OG0031926	0	0	1	1	2
OG0031927	0	0	2	0	2
OG0031928	0	0	2	0	2
OG0031929	0	0	1	1	2
OG0031930	0	0	1	1	2
OG0031931	0	0	2	0	2
OG0031932	0	0	2	0	2
OG0031933	0	0	1	1	2
OG0031934	0	0	2	0	2
OG0031935	0	0	1	1	2
OG0031936	0	0	2	0	2
OG0031937	0	0	1	1	2
OG0031938	0	0	2	0	2
OG0031939	0	0	1	1	2
OG0031940	0	0	2	0	2
OG0031941	0	0	2	0	2
OG0031942	0	0	1	1	2
OG0031943	0	0	2	0	2
OG0031944	0	0	1	1	2
OG0031945	0	0	2	0	2
OG0031946	0	0	2	0	2
OG0031947	0	0	1	1	2
OG0031948	0	0	1	1	2
OG0031949	0	0	1	1	2
OG0031950	0	0	2	0	2
OG0031951	0	0	1	1	2
OG0031952	0	0	2	0	2
OG0031953	0	0	2	0	2
OG0031954	0	0	1	1	2
OG0031955	0	0	2	0	2
OG0031956	0	0	2	0	2
OG0031957	0	0	2	0	2
OG0031958	0	0	2	0	2
OG0031959	0	0	2	0	2
OG0031960	0	0	2	0	2
OG0031961	0	0	1	1	2
OG0031962	0	0	1	1	2
OG0031963	0	0	1	1	2
OG0031964	0	0	2	0	2
OG0031965	0	0	1	1	2
OG0031966	0	0	2	0	2
OG0031967	0	0	2	0	2
OG0031968	0	0	2	0	2
OG0031969	0	0	2	0	2
OG0031970	0	0	1	1	2
OG0031971	0	0	1	1	2
OG0031972	0	0	2	0	2
OG0031973	0	0	2	0	2
OG0031974	0	0	2	0	2
OG0031975	0	0	2	0	2
OG0031976	0	0	2	0	2
OG0031977	0	0	1	1	2
OG0031978	0	0	2	0	2
OG0031979	0	0	1	1	2
OG0031980	0	0	2	0	2
OG0031981	0	0	2	0	2
OG0031982	0	0	2	0	2
OG0031983	0	0	2	0	2
OG0031984	0	0	2	0	2
OG0031985	0	0	1	1	2
OG0031986	0	0	1	1	2
OG0031987	0	0	1	1	2
OG0031988	0	0	2	0	2
OG0031989	0	0	1	1	2
OG0031990	0	0	2	0	2
OG0031991	0	0	2	0	2
OG0031992	0	0	2	0	2
OG0031993	0	0	2	0	2
OG0031994	0	0	2	0	2
OG0031995	0	0	1	1	2
OG0031996	0	0	1	1	2
OG0031997	0	0	1	1	2
OG0031998	0	0	1	1	2
OG0031999	0	0	1	1	2
OG0032000	0	0	1	1	2
OG0032001	0	0	2	0	2
OG0032002	0	0	1	1	2
OG0032003	0	0	2	0	2
OG0032004	0	0	1	1	2
OG0032005	0	0	1	1	2
OG0032006	0	0	1	1	2
OG0032007	0	0	1	1	2
OG0032008	0	0	1	1	2
OG0032009	0	0	1	1	2
OG0032010	0	0	2	0	2
OG0032011	0	0	1	1	2
OG0032012	0	0	1	1	2
OG0032013	0	0	1	1	2
OG0032014	0	0	2	0	2
OG0032015	0	0	1	1	2
OG0032016	0	0	2	0	2
OG0032017	0	0	1	1	2
OG0032018	0	0	2	0	2
OG0032019	0	0	1	1	2
OG0032020	0	0	2	0	2
OG0032021	0	0	1	1	2
OG0032022	0	0	2	0	2
OG0032023	0	0	1	1	2
OG0032024	0	0	2	0	2
OG0032025	0	0	2	0	2
OG0032026	0	0	1	1	2
OG0032027	0	0	1	1	2
OG0032028	0	0	1	1	2
OG0032029	0	0	1	1	2
OG0032030	0	0	1	1	2
OG0032031	0	0	1	1	2
OG0032032	0	0	1	1	2
OG0032033	0	0	1	1	2
OG0032034	0	0	2	0	2
OG0032035	0	0	2	0	2
OG0032036	0	0	2	0	2
OG0032037	0	0	1	1	2
OG0032038	0	0	1	1	2
OG0032039	0	0	1	1	2
OG0032040	0	0	1	1	2
OG0032041	0	0	1	1	2
OG0032042	0	0	1	1	2
OG0032043	0	0	2	0	2
OG0032044	0	0	1	1	2
OG0032045	0	0	1	1	2
OG0032046	0	0	2	0	2
OG0032047	0	0	2	0	2
OG0032048	0	0	1	1	2
OG0032049	0	0	2	0	2
OG0032050	0	0	1	1	2
OG0032051	0	0	1	1	2
OG0032052	0	0	1	1	2
OG0032053	0	0	1	1	2
OG0032054	0	0	2	0	2
OG0032055	0	0	1	1	2
OG0032056	0	0	2	0	2
OG0032057	0	0	2	0	2
OG0032058	0	0	2	0	2
OG0032059	0	0	2	0	2
OG0032060	0	0	2	0	2
OG0032061	0	0	2	0	2
OG0032062	0	0	1	1	2
OG0032063	0	0	1	1	2
OG0032064	0	0	2	0	2
OG0032065	0	0	1	1	2
OG0032066	0	0	1	1	2
OG0032067	0	0	1	1	2
OG0032068	0	0	2	0	2
OG0032069	0	0	1	1	2
OG0032070	0	0	2	0	2
OG0032071	0	0	2	0	2
OG0032072	0	0	1	1	2
OG0032073	0	0	1	1	2
OG0032074	0	0	1	1	2
OG0032075	0	0	1	1	2
OG0032076	0	0	1	1	2
OG0032077	0	0	1	1	2
OG0032078	0	0	2	0	2
OG0032079	0	0	1	1	2
OG0032080	0	0	1	1	2
OG0032081	0	0	2	0	2
OG0032082	0	0	1	1	2
OG0032083	0	0	1	1	2
OG0032084	0	0	1	1	2
OG0032085	0	0	2	0	2
OG0032086	0	0	1	1	2
OG0032087	0	0	1	1	2
OG0032088	0	0	1	1	2
OG0032089	0	0	1	1	2
OG0032090	0	0	1	1	2
OG0032091	0	0	1	1	2
OG0032092	0	0	1	1	2
OG0032093	0	0	1	1	2
OG0032094	0	0	1	1	2
OG0032095	0	0	1	1	2
OG0032096	0	0	2	0	2
OG0032097	0	0	1	1	2
OG0032098	0	0	1	1	2
OG0032099	0	0	1	1	2
OG0032100	0	0	1	1	2
OG0032101	0	0	1	1	2
OG0032102	0	0	1	1	2
OG0032103	0	0	1	1	2
OG0032104	0	0	1	1	2
OG0032105	0	0	1	1	2
OG0032106	0	0	2	0	2
OG0032107	0	0	1	1	2
OG0032108	0	0	2	0	2
OG0032109	0	0	2	0	2
OG0032110	0	0	1	1	2
OG0032111	0	0	2	0	2
OG0032112	0	0	1	1	2
OG0032113	0	0	1	1	2
OG0032114	0	0	1	1	2
OG0032115	0	0	1	1	2
OG0032116	0	0	1	1	2
OG0032117	0	0	2	0	2
OG0032118	0	0	2	0	2
OG0032119	0	0	2	0	2
OG0032120	0	0	1	1	2
OG0032121	0	0	1	1	2
OG0032122	0	0	1	1	2
OG0032123	0	0	2	0	2
OG0032124	0	0	1	1	2
OG0032125	0	0	1	1	2
OG0032126	0	0	2	0	2
OG0032127	0	0	1	1	2
OG0032128	0	0	1	1	2
OG0032129	0	0	2	0	2
OG0032130	0	0	1	1	2
OG0032131	0	0	1	1	2
OG0032132	0	0	1	1	2
OG0032133	0	0	2	0	2
OG0032134	0	0	1	1	2
OG0032135	0	0	1	1	2
OG0032136	0	0	1	1	2
OG0032137	0	0	1	1	2
OG0032138	0	0	1	1	2
OG0032139	0	0	1	1	2
OG0032140	0	0	1	1	2
OG0032141	0	0	1	1	2
OG0032142	0	0	2	0	2
OG0032143	0	0	2	0	2
OG0032144	0	0	1	1	2
OG0032145	0	0	1	1	2
OG0032146	0	0	1	1	2
OG0032147	0	0	1	1	2
OG0032148	0	0	2	0	2
OG0032149	0	0	1	1	2
OG0032150	0	0	1	1	2
OG0032151	0	0	1	1	2
OG0032152	0	0	1	1	2
OG0032153	0	0	1	1	2
OG0032154	0	0	1	1	2
OG0032155	0	0	1	1	2
OG0032156	0	0	2	0	2
OG0032157	0	0	2	0	2
OG0032158	0	0	1	1	2
OG0032159	0	0	2	0	2
OG0032160	0	0	2	0	2
OG0032161	0	0	1	1	2
OG0032162	0	0	2	0	2
OG0032163	0	0	2	0	2
OG0032164	0	0	2	0	2
OG0032165	0	0	1	1	2
OG0032166	0	0	1	1	2
OG0032167	0	0	1	1	2
OG0032168	0	0	2	0	2
OG0032169	0	0	1	1	2
OG0032170	0	0	1	1	2
OG0032171	0	0	1	1	2
OG0032172	0	0	1	1	2
OG0032173	0	0	1	1	2
OG0032174	0	0	1	1	2
OG0032175	0	0	2	0	2
OG0032176	0	0	1	1	2
OG0032177	0	0	2	0	2
OG0032178	0	0	1	1	2
OG0032179	0	0	1	1	2
OG0032180	0	0	1	1	2
OG0032181	0	0	1	1	2
OG0032182	0	0	1	1	2
OG0032183	0	0	1	1	2
OG0032184	0	0	1	1	2
OG0032185	0	0	1	1	2
OG0032186	0	0	1	1	2
OG0032187	0	0	1	1	2
OG0032188	0	0	1	1	2
OG0032189	0	0	1	1	2
OG0032190	0	0	2	0	2
OG0032191	0	0	1	1	2
OG0032192	0	0	2	0	2
OG0032193	0	0	1	1	2
OG0032194	0	0	1	1	2
OG0032195	0	0	1	1	2
OG0032196	0	0	1	1	2
OG0032197	0	0	2	0	2
OG0032198	0	0	1	1	2
OG0032199	0	0	1	1	2
OG0032200	0	0	1	1	2
OG0032201	0	0	2	0	2
OG0032202	0	0	1	1	2
OG0032203	0	0	2	0	2
OG0032204	0	0	1	1	2
OG0032205	0	0	1	1	2
OG0032206	0	0	1	1	2
OG0032207	0	0	1	1	2
OG0032208	0	0	1	1	2
OG0032209	0	0	1	1	2
OG0032210	0	0	1	1	2
OG0032211	0	0	1	1	2
OG0032212	0	0	2	0	2
OG0032213	0	0	2	0	2
OG0032214	0	0	2	0	2
OG0032215	0	0	1	1	2
OG0032216	0	0	1	1	2
OG0032217	0	0	1	1	2
OG0032218	0	0	2	0	2
OG0032219	0	0	2	0	2
OG0032220	0	0	1	1	2
OG0032221	0	0	2	0	2
OG0032222	0	0	1	1	2
OG0032223	0	0	1	1	2
OG0032224	0	0	1	1	2
OG0032225	0	0	1	1	2
OG0032226	0	0	1	1	2
OG0032227	0	0	1	1	2
OG0032228	0	0	1	1	2
OG0032229	0	0	1	1	2
OG0032230	0	0	2	0	2
OG0032231	0	0	1	1	2
OG0032232	0	0	1	1	2
OG0032233	0	0	1	1	2
OG0032234	0	0	2	0	2
OG0032235	0	0	1	1	2
OG0032236	0	0	1	1	2
OG0032237	0	0	1	1	2
OG0032238	0	0	1	1	2
OG0032239	0	0	1	1	2
OG0032240	0	0	2	0	2
OG0032241	0	0	1	1	2
OG0032242	0	0	1	1	2
OG0032243	0	0	2	0	2
OG0032244	0	0	1	1	2
OG0032245	0	0	1	1	2
OG0032246	0	0	2	0	2
OG0032247	0	0	1	1	2
OG0032248	0	0	1	1	2
OG0032249	0	0	1	1	2
OG0032250	0	0	1	1	2
OG0032251	0	0	2	0	2
OG0032252	0	0	1	1	2
OG0032253	0	0	2	0	2
OG0032254	0	0	2	0	2
OG0032255	0	0	1	1	2
OG0032256	0	0	1	1	2
OG0032257	0	0	1	1	2
OG0032258	0	0	1	1	2
OG0032259	0	0	1	1	2
OG0032260	0	0	1	1	2
OG0032261	0	0	1	1	2
OG0032262	0	0	2	0	2
OG0032263	0	0	2	0	2
OG0032264	0	0	1	1	2
OG0032265	0	0	1	1	2
OG0032266	0	0	1	1	2
OG0032267	0	0	2	0	2
OG0032268	0	0	1	1	2
OG0032269	0	0	1	1	2
OG0032270	0	0	1	1	2
OG0032271	0	0	2	0	2
OG0032272	0	0	1	1	2
OG0032273	0	0	1	1	2
OG0032274	0	0	1	1	2
OG0032275	0	0	1	1	2
OG0032276	0	0	1	1	2
OG0032277	0	0	1	1	2
OG0032278	0	0	1	1	2
OG0032279	0	0	1	1	2
OG0032280	0	0	2	0	2
OG0032281	0	0	2	0	2
OG0032282	0	0	1	1	2
OG0032283	0	0	1	1	2
OG0032284	0	0	1	1	2
OG0032285	0	0	2	0	2
OG0032286	0	0	1	1	2
OG0032287	0	0	1	1	2
OG0032288	0	0	1	1	2
OG0032289	0	0	1	1	2
OG0032290	0	0	1	1	2
OG0032291	0	0	1	1	2
OG0032292	0	0	1	1	2
OG0032293	0	0	1	1	2
OG0032294	0	0	1	1	2
OG0032295	0	0	1	1	2
OG0032296	0	0	2	0	2
OG0032297	0	0	1	1	2
OG0032298	0	0	1	1	2
OG0032299	0	0	1	1	2
OG0032300	0	0	1	1	2
OG0032301	0	0	1	1	2
OG0032302	0	0	1	1	2
OG0032303	0	0	2	0	2
OG0032304	0	0	1	1	2
OG0032305	0	0	1	1	2
OG0032306	0	0	1	1	2
OG0032307	0	0	1	1	2
OG0032308	0	0	1	1	2
OG0032309	0	0	2	0	2
OG0032310	0	0	1	1	2
OG0032311	0	0	1	1	2
OG0032312	0	0	1	1	2
OG0032313	0	0	2	0	2
OG0032314	0	0	2	0	2
OG0032315	0	0	2	0	2
OG0032316	0	0	1	1	2
OG0032317	0	0	2	0	2
OG0032318	0	0	1	1	2
OG0032319	0	0	1	1	2
OG0032320	0	0	1	1	2
OG0032321	0	0	1	1	2
OG0032322	0	0	1	1	2
OG0032323	0	0	1	1	2
OG0032324	0	0	1	1	2
OG0032325	0	0	1	1	2
OG0032326	0	0	1	1	2
OG0032327	0	0	2	0	2
OG0032328	0	0	1	1	2
OG0032329	0	0	1	1	2
OG0032330	0	0	1	1	2
OG0032331	0	0	2	0	2
OG0032332	0	0	2	0	2
OG0032333	0	0	1	1	2
OG0032334	0	0	1	1	2
OG0032335	0	0	1	1	2
OG0032336	0	0	1	1	2
OG0032337	0	0	1	1	2
OG0032338	0	0	1	1	2
OG0032339	0	0	2	0	2
OG0032340	0	0	1	1	2
OG0032341	0	0	1	1	2
OG0032342	0	0	1	1	2
OG0032343	0	0	1	1	2
OG0032344	0	0	1	1	2
OG0032345	0	0	1	1	2
OG0032346	0	0	2	0	2
OG0032347	0	0	1	1	2
OG0032348	0	0	2	0	2
OG0032349	0	0	1	1	2
OG0032350	0	0	2	0	2
OG0032351	0	0	1	1	2
OG0032352	0	0	1	1	2
OG0032353	0	0	1	1	2
OG0032354	0	0	1	1	2
OG0032355	0	0	2	0	2
OG0032356	0	0	2	0	2
OG0032357	0	0	2	0	2
OG0032358	0	0	1	1	2
OG0032359	0	0	1	1	2
OG0032360	0	0	1	1	2
OG0032361	0	0	2	0	2
OG0032362	0	0	2	0	2
OG0032363	0	0	1	1	2
OG0032364	0	0	2	0	2
OG0032365	0	0	1	1	2
OG0032366	0	0	1	1	2
OG0032367	0	0	1	1	2
OG0032368	0	0	2	0	2
OG0032369	0	0	2	0	2
OG0032370	0	0	1	1	2
OG0032371	0	0	2	0	2
OG0032372	0	0	1	1	2
OG0032373	0	0	1	1	2
OG0032374	0	0	1	1	2
OG0032375	0	0	1	1	2
OG0032376	0	0	1	1	2
OG0032377	0	0	1	1	2
OG0032378	0	0	1	1	2
OG0032379	0	0	2	0	2
OG0032380	0	0	2	0	2
OG0032381	0	0	1	1	2
OG0032382	0	0	1	1	2
OG0032383	0	0	1	1	2
OG0032384	0	0	1	1	2
OG0032385	0	0	1	1	2
OG0032386	0	0	2	0	2
OG0032387	0	0	1	1	2
OG0032388	0	0	2	0	2
OG0032389	0	0	1	1	2
OG0032390	0	0	1	1	2
OG0032391	0	0	1	1	2
OG0032392	0	0	1	1	2
OG0032393	0	0	2	0	2
OG0032394	0	0	1	1	2
OG0032395	0	0	1	1	2
OG0032396	0	0	1	1	2
OG0032397	0	0	1	1	2
OG0032398	0	0	2	0	2
OG0032399	0	0	1	1	2
OG0032400	0	0	1	1	2
OG0032401	0	0	1	1	2
OG0032402	0	0	1	1	2
OG0032403	0	0	2	0	2
OG0032404	0	0	1	1	2
OG0032405	0	0	1	1	2
OG0032406	0	0	1	1	2
OG0032407	0	0	2	0	2
OG0032408	0	0	1	1	2
OG0032409	0	0	1	1	2
OG0032410	0	0	1	1	2
OG0032411	0	0	2	0	2
OG0032412	0	0	1	1	2
OG0032413	0	0	1	1	2
OG0032414	0	0	1	1	2
OG0032415	0	0	1	1	2
OG0032416	0	0	1	1	2
OG0032417	0	0	1	1	2
OG0032418	0	0	1	1	2
OG0032419	0	0	2	0	2
OG0032420	0	0	2	0	2
OG0032421	0	0	1	1	2
OG0032422	0	0	1	1	2
OG0032423	0	0	1	1	2
OG0032424	0	0	1	1	2
OG0032425	0	0	1	1	2
OG0032426	0	0	1	1	2
OG0032427	0	0	2	0	2
OG0032428	0	0	1	1	2
OG0032429	0	0	1	1	2
OG0032430	0	0	1	1	2
OG0032431	0	0	1	1	2
OG0032432	0	0	1	1	2
OG0032433	0	0	1	1	2
OG0032434	0	0	1	1	2
OG0032435	0	0	1	1	2
OG0032436	0	0	1	1	2
OG0032437	0	0	1	1	2
OG0032438	0	0	1	1	2
OG0032439	0	0	1	1	2
OG0032440	0	0	1	1	2
OG0032441	0	0	1	1	2
OG0032442	0	0	1	1	2
OG0032443	0	0	1	1	2
OG0032444	0	0	1	1	2
OG0032445	0	0	2	0	2
OG0032446	0	0	1	1	2
OG0032447	0	0	2	0	2
OG0032448	0	0	1	1	2
OG0032449	0	0	1	1	2
OG0032450	0	0	2	0	2
OG0032451	0	0	2	0	2
OG0032452	0	0	2	0	2
OG0032453	0	0	1	1	2
OG0032454	0	0	1	1	2
OG0032455	0	0	2	0	2
OG0032456	0	0	2	0	2
OG0032457	0	0	1	1	2
OG0032458	0	0	1	1	2
OG0032459	0	0	1	1	2
OG0032460	0	0	1	1	2
OG0032461	0	0	1	1	2
OG0032462	0	0	1	1	2
OG0032463	0	0	2	0	2
OG0032464	0	0	1	1	2
OG0032465	0	0	1	1	2
OG0032466	0	0	1	1	2
OG0032467	0	0	2	0	2
OG0032468	0	0	2	0	2
OG0032469	0	0	1	1	2
OG0032470	0	0	1	1	2
OG0032471	0	0	1	1	2
OG0032472	0	0	1	1	2
OG0032473	0	0	1	1	2
OG0032474	0	0	1	1	2
OG0032475	0	0	2	0	2
OG0032476	0	0	1	1	2
OG0032477	0	0	1	1	2
OG0032478	0	0	1	1	2
OG0032479	0	0	1	1	2
OG0032480	0	0	1	1	2
OG0032481	0	0	1	1	2
OG0032482	0	0	1	1	2
OG0032483	0	0	1	1	2
OG0032484	0	0	2	0	2
OG0032485	0	0	2	0	2
OG0032486	0	0	1	1	2
OG0032487	0	0	2	0	2
OG0032488	0	0	1	1	2
OG0032489	0	0	1	1	2
OG0032490	0	0	1	1	2
OG0032491	0	0	1	1	2
OG0032492	0	0	1	1	2
OG0032493	0	0	1	1	2
OG0032494	0	0	2	0	2
OG0032495	0	0	2	0	2
OG0032496	0	0	1	1	2
OG0032497	0	0	1	1	2
OG0032498	0	0	1	1	2
OG0032499	0	0	1	1	2
OG0032500	0	0	2	0	2
OG0032501	0	0	1	1	2
OG0032502	0	0	1	1	2
OG0032503	0	0	1	1	2
OG0032504	0	0	2	0	2
OG0032505	0	0	2	0	2
OG0032506	0	0	1	1	2
OG0032507	0	0	1	1	2
OG0032508	0	0	2	0	2
OG0032509	0	0	1	1	2
OG0032510	0	0	1	1	2
OG0032511	0	0	1	1	2
OG0032512	0	0	1	1	2
OG0032513	0	0	2	0	2
OG0032514	0	0	1	1	2
OG0032515	0	0	1	1	2
OG0032516	0	0	1	1	2
OG0032517	0	0	2	0	2
OG0032518	0	0	1	1	2
OG0032519	0	0	2	0	2
OG0032520	0	0	2	0	2
OG0032521	0	0	1	1	2
OG0032522	0	0	1	1	2
OG0032523	0	0	1	1	2
OG0032524	0	0	1	1	2
OG0032525	0	0	1	1	2
OG0032526	0	0	2	0	2
OG0032527	0	0	2	0	2
OG0032528	0	0	1	1	2
OG0032529	0	0	1	1	2
OG0032530	0	0	1	1	2
OG0032531	0	0	1	1	2
OG0032532	0	0	1	1	2
OG0032533	0	0	1	1	2
OG0032534	0	0	1	1	2
OG0032535	0	0	1	1	2
OG0032536	0	0	1	1	2
OG0032537	0	0	1	1	2
OG0032538	0	0	1	1	2
OG0032539	0	0	1	1	2
OG0032540	0	0	1	1	2
OG0032541	0	0	1	1	2
OG0032542	0	0	2	0	2
OG0032543	0	0	2	0	2
OG0032544	0	0	1	1	2
OG0032545	0	0	1	1	2
OG0032546	0	0	2	0	2
OG0032547	0	0	1	1	2
OG0032548	0	0	1	1	2
OG0032549	0	0	1	1	2
OG0032550	0	0	2	0	2
OG0032551	0	0	1	1	2
OG0032552	0	0	1	1	2
OG0032553	0	0	1	1	2
OG0032554	0	0	2	0	2
OG0032555	0	0	1	1	2
OG0032556	0	0	1	1	2
OG0032557	0	0	2	0	2
OG0032558	0	0	2	0	2
OG0032559	0	0	1	1	2
OG0032560	0	0	1	1	2
OG0032561	0	0	2	0	2
OG0032562	0	0	1	1	2
OG0032563	0	0	2	0	2
OG0032564	0	0	1	1	2
OG0032565	0	0	1	1	2
OG0032566	0	0	1	1	2
OG0032567	0	0	2	0	2
OG0032568	0	0	1	1	2
OG0032569	0	0	2	0	2
OG0032570	0	0	1	1	2
OG0032571	0	0	1	1	2
OG0032572	0	0	1	1	2
OG0032573	0	0	1	1	2
OG0032574	0	0	1	1	2
OG0032575	0	0	1	1	2
OG0032576	0	0	1	1	2
OG0032577	0	0	1	1	2
OG0032578	0	0	1	1	2
OG0032579	0	0	1	1	2
OG0032580	0	0	1	1	2
OG0032581	0	0	2	0	2
OG0032582	0	0	1	1	2
OG0032583	0	0	1	1	2
OG0032584	0	0	2	0	2
OG0032585	0	0	2	0	2
OG0032586	0	0	2	0	2
OG0032587	0	0	1	1	2
OG0032588	0	0	1	1	2
OG0032589	0	0	1	1	2
OG0032590	0	0	1	1	2
OG0032591	0	0	1	1	2
OG0032592	0	0	1	1	2
OG0032593	0	0	1	1	2
OG0032594	0	0	1	1	2
OG0032595	0	0	1	1	2
OG0032596	0	0	1	1	2
OG0032597	0	0	1	1	2
OG0032598	0	0	1	1	2
OG0032599	0	0	2	0	2
OG0032600	0	0	1	1	2
OG0032601	0	0	1	1	2
OG0032602	0	0	1	1	2
OG0032603	0	0	1	1	2
OG0032604	0	0	1	1	2
OG0032605	0	0	1	1	2
OG0032606	0	0	1	1	2
OG0032607	0	0	1	1	2
OG0032608	0	0	1	1	2
OG0032609	0	0	2	0	2
OG0032610	0	0	1	1	2
OG0032611	0	0	1	1	2
OG0032612	0	0	1	1	2
OG0032613	0	0	1	1	2
OG0032614	0	0	2	0	2
OG0032615	0	0	1	1	2
OG0032616	0	0	1	1	2
OG0032617	0	0	1	1	2
OG0032618	0	0	1	1	2
OG0032619	0	0	2	0	2
OG0032620	0	0	1	1	2
OG0032621	0	0	1	1	2
OG0032622	0	0	1	1	2
OG0032623	0	0	2	0	2
OG0032624	0	0	2	0	2
OG0032625	0	0	2	0	2
OG0032626	0	0	1	1	2
OG0032627	0	0	1	1	2
OG0032628	0	0	2	0	2
OG0032629	0	0	1	1	2
OG0032630	0	0	1	1	2
OG0032631	0	0	1	1	2
OG0032632	0	0	2	0	2
OG0032633	0	0	1	1	2
OG0032634	0	0	2	0	2
OG0032635	0	0	1	1	2
OG0032636	0	0	2	0	2
OG0032637	0	0	2	0	2
OG0032638	0	0	1	1	2
OG0032639	0	0	2	0	2
OG0032640	0	0	2	0	2
OG0032641	0	0	2	0	2
OG0032642	0	0	1	1	2
OG0032643	0	0	2	0	2
OG0032644	0	0	1	1	2
OG0032645	0	0	1	1	2
OG0032646	0	0	2	0	2
OG0032647	0	0	1	1	2
OG0032648	0	0	2	0	2
OG0032649	0	0	1	1	2
OG0032650	0	0	1	1	2
OG0032651	0	0	1	1	2
OG0032652	0	0	1	1	2
OG0032653	0	0	2	0	2
OG0032654	0	0	1	1	2
OG0032655	0	0	2	0	2
OG0032656	0	0	1	1	2
OG0032657	0	0	1	1	2
OG0032658	0	0	1	1	2
OG0032659	0	0	2	0	2
OG0032660	0	0	2	0	2
OG0032661	0	0	2	0	2
OG0032662	0	0	1	1	2
OG0032663	0	0	1	1	2
OG0032664	0	0	2	0	2
OG0032665	0	0	1	1	2
OG0032666	0	0	2	0	2
OG0032667	0	0	1	1	2
OG0032668	0	0	1	1	2
OG0032669	0	0	2	0	2
OG0032670	0	0	2	0	2
OG0032671	0	0	1	1	2
OG0032672	0	0	2	0	2
OG0032673	0	0	1	1	2
OG0032674	0	0	2	0	2
OG0032675	0	0	1	1	2
OG0032676	0	0	2	0	2
OG0032677	0	0	1	1	2
OG0032678	0	0	1	1	2
OG0032679	0	0	1	1	2
OG0032680	0	0	2	0	2
OG0032681	0	0	1	1	2
OG0032682	0	0	2	0	2
OG0032683	0	0	2	0	2
OG0032684	0	0	1	1	2
OG0032685	0	0	1	1	2
OG0032686	0	0	2	0	2
OG0032687	0	0	2	0	2
OG0032688	0	0	2	0	2
OG0032689	0	0	1	1	2
OG0032690	0	0	1	1	2
OG0032691	0	0	1	1	2
OG0032692	0	0	1	1	2
OG0032693	0	0	1	1	2
OG0032694	0	0	1	1	2
OG0032695	0	0	1	1	2
OG0032696	0	0	1	1	2
OG0032697	0	0	2	0	2
OG0032698	0	0	2	0	2
OG0032699	0	0	2	0	2
OG0032700	0	0	1	1	2
OG0032701	0	0	1	1	2
OG0032702	0	0	1	1	2
OG0032703	0	0	1	1	2
OG0032704	0	0	2	0	2
OG0032705	0	0	1	1	2
OG0032706	0	0	2	0	2
OG0032707	0	0	2	0	2
OG0032708	0	0	1	1	2
OG0032709	0	0	1	1	2
OG0032710	0	0	1	1	2
OG0032711	0	0	1	1	2
OG0032712	0	0	1	1	2
OG0032713	0	0	1	1	2
OG0032714	0	0	1	1	2
OG0032715	0	0	2	0	2
OG0032716	0	0	1	1	2
OG0032717	0	0	1	1	2
OG0032718	0	0	1	1	2
OG0032719	0	0	1	1	2
OG0032720	0	0	1	1	2
OG0032721	0	0	1	1	2
OG0032722	0	0	2	0	2
OG0032723	0	0	1	1	2
OG0032724	0	0	1	1	2
OG0032725	0	0	2	0	2
OG0032726	0	0	1	1	2
OG0032727	0	0	2	0	2
OG0032728	0	0	1	1	2
OG0032729	0	0	1	1	2
OG0032730	0	0	1	1	2
OG0032731	0	0	1	1	2
OG0032732	0	0	1	1	2
OG0032733	0	0	1	1	2
OG0032734	0	0	2	0	2
OG0032735	0	0	1	1	2
OG0032736	0	0	1	1	2
OG0032737	0	0	2	0	2
OG0032738	0	0	2	0	2
OG0032739	0	0	2	0	2
OG0032740	0	0	2	0	2
OG0032741	0	0	2	0	2
OG0032742	0	0	1	1	2
OG0032743	0	0	2	0	2
OG0032744	0	0	2	0	2
OG0032745	0	0	1	1	2
OG0032746	0	0	2	0	2
OG0032747	0	0	1	1	2
OG0032748	0	0	1	1	2
OG0032749	0	0	1	1	2
OG0032750	0	0	1	1	2
OG0032751	0	0	2	0	2
OG0032752	0	0	1	1	2
OG0032753	0	0	1	1	2
OG0032754	0	0	1	1	2
OG0032755	0	0	1	1	2
OG0032756	0	0	1	1	2
OG0032757	0	0	1	1	2
OG0032758	0	0	1	1	2
OG0032759	0	0	1	1	2
OG0032760	0	0	1	1	2
OG0032761	0	0	1	1	2
OG0032762	0	0	2	0	2
OG0032763	0	0	1	1	2
OG0032764	0	0	1	1	2
OG0032765	0	0	1	1	2
OG0032766	0	0	2	0	2
OG0032767	0	0	1	1	2
OG0032768	0	0	1	1	2
OG0032769	0	0	1	1	2
OG0032770	0	0	2	0	2
OG0032771	0	0	1	1	2
OG0032772	0	0	1	1	2
OG0032773	0	0	1	1	2
OG0032774	0	0	1	1	2
OG0032775	0	0	1	1	2
OG0032776	0	0	2	0	2
OG0032777	0	0	1	1	2
OG0032778	0	0	1	1	2
OG0032779	0	0	2	0	2
OG0032780	0	0	1	1	2
OG0032781	0	0	1	1	2
OG0032782	0	0	1	1	2
OG0032783	0	0	1	1	2
OG0032784	0	0	2	0	2
OG0032785	0	0	2	0	2
OG0032786	0	0	2	0	2
OG0032787	0	0	1	1	2
OG0032788	0	0	2	0	2
OG0032789	0	0	1	1	2
OG0032790	0	0	1	1	2
OG0032791	0	0	1	1	2
OG0032792	0	0	1	1	2
OG0032793	0	0	2	0	2
OG0032794	0	0	2	0	2
OG0032795	0	0	1	1	2
OG0032796	0	0	1	1	2
OG0032797	0	0	2	0	2
OG0032798	0	0	1	1	2
OG0032799	0	0	1	1	2
OG0032800	0	0	1	1	2
OG0032801	0	0	1	1	2
OG0032802	0	0	1	1	2
OG0032803	0	0	1	1	2
OG0032804	0	0	1	1	2
OG0032805	0	0	1	1	2
OG0032806	0	0	1	1	2
OG0032807	0	0	2	0	2
OG0032808	0	0	1	1	2
OG0032809	0	0	1	1	2
OG0032810	0	0	1	1	2
OG0032811	0	0	2	0	2
OG0032812	0	0	2	0	2
OG0032813	0	0	1	1	2
OG0032814	0	0	1	1	2
OG0032815	0	0	1	1	2
OG0032816	0	0	1	1	2
OG0032817	0	0	2	0	2
OG0032818	0	0	1	1	2
OG0032819	0	0	1	1	2
OG0032820	0	0	1	1	2
OG0032821	0	0	1	1	2
OG0032822	0	0	1	1	2
OG0032823	0	0	1	1	2
OG0032824	0	0	1	1	2
OG0032825	0	0	1	1	2
OG0032826	0	0	2	0	2
OG0032827	0	0	1	1	2
OG0032828	0	0	1	1	2
OG0032829	0	0	1	1	2
OG0032830	0	0	2	0	2
OG0032831	0	0	1	1	2
OG0032832	0	0	1	1	2
OG0032833	0	0	1	1	2
OG0032834	0	0	1	1	2
OG0032835	0	0	1	1	2
OG0032836	0	0	2	0	2
OG0032837	0	0	1	1	2
OG0032838	0	0	1	1	2
OG0032839	0	0	2	0	2
OG0032840	0	0	1	1	2
OG0032841	0	0	1	1	2
OG0032842	0	0	1	1	2
OG0032843	0	0	1	1	2
OG0032844	0	0	2	0	2
OG0032845	0	0	1	1	2
OG0032846	0	0	1	1	2
OG0032847	0	0	1	1	2
OG0032848	0	0	1	1	2
OG0032849	0	0	1	1	2
OG0032850	0	0	1	1	2
OG0032851	0	0	1	1	2
OG0032852	0	0	1	1	2
OG0032853	0	0	1	1	2
OG0032854	0	0	1	1	2
OG0032855	0	0	1	1	2
OG0032856	0	0	2	0	2
OG0032857	0	0	1	1	2
OG0032858	0	0	1	1	2
OG0032859	0	0	1	1	2
OG0032860	0	0	1	1	2
OG0032861	0	0	2	0	2
OG0032862	0	0	1	1	2
OG0032863	0	0	1	1	2
OG0032864	0	0	1	1	2
OG0032865	0	0	2	0	2
OG0032866	0	0	1	1	2
OG0032867	0	0	1	1	2
OG0032868	0	0	1	1	2
OG0032869	0	0	1	1	2
OG0032870	0	0	1	1	2
OG0032871	0	0	1	1	2
OG0032872	0	0	1	1	2
OG0032873	0	0	1	1	2
OG0032874	0	0	1	1	2
OG0032875	0	0	2	0	2
OG0032876	0	0	2	0	2
OG0032877	0	0	1	1	2
OG0032878	0	0	1	1	2
OG0032879	0	0	1	1	2
OG0032880	0	0	2	0	2
OG0032881	0	0	2	0	2
OG0032882	0	0	1	1	2
OG0032883	0	0	1	1	2
OG0032884	0	0	1	1	2
OG0032885	0	0	2	0	2
OG0032886	0	0	1	1	2
OG0032887	0	0	1	1	2
OG0032888	0	0	1	1	2
OG0032889	0	0	1	1	2
OG0032890	0	0	1	1	2
OG0032891	0	0	1	1	2
OG0032892	0	0	2	0	2
OG0032893	0	0	1	1	2
OG0032894	0	0	2	0	2
OG0032895	0	0	1	1	2
OG0032896	0	0	2	0	2
OG0032897	0	0	1	1	2
OG0032898	0	0	2	0	2
OG0032899	0	0	2	0	2
OG0032900	0	0	1	1	2
OG0032901	0	0	1	1	2
OG0032902	0	0	2	0	2
OG0032903	0	0	1	1	2
OG0032904	0	0	1	1	2
OG0032905	0	0	1	1	2
OG0032906	0	0	2	0	2
OG0032907	0	0	1	1	2
OG0032908	0	0	1	1	2
OG0032909	0	0	1	1	2
OG0032910	0	0	1	1	2
OG0032911	0	0	1	1	2
OG0032912	0	0	1	1	2
OG0032913	0	0	1	1	2
OG0032914	0	0	1	1	2
OG0032915	0	0	2	0	2
OG0032916	0	0	2	0	2
OG0032917	0	0	1	1	2
OG0032918	0	0	1	1	2
OG0032919	0	0	1	1	2
OG0032920	0	0	2	0	2
OG0032921	0	0	1	1	2
OG0032922	0	0	1	1	2
OG0032923	0	0	1	1	2
OG0032924	0	0	2	0	2
OG0032925	0	0	1	1	2
OG0032926	0	0	1	1	2
OG0032927	0	0	1	1	2
OG0032928	0	0	1	1	2
OG0032929	0	0	1	1	2
OG0032930	0	0	2	0	2
OG0032931	0	0	1	1	2
OG0032932	0	0	2	0	2
OG0032933	0	0	1	1	2
OG0032934	0	0	1	1	2
OG0032935	0	0	1	1	2
OG0032936	0	0	2	0	2
OG0032937	0	0	1	1	2
OG0032938	0	0	2	0	2
OG0032939	0	0	1	1	2
OG0032940	0	0	1	1	2
OG0032941	0	0	1	1	2
OG0032942	0	0	2	0	2
OG0032943	0	0	1	1	2
OG0032944	0	0	1	1	2
OG0032945	0	0	2	0	2
OG0032946	0	0	1	1	2
OG0032947	0	0	2	0	2
OG0032948	0	0	1	1	2
OG0032949	0	0	1	1	2
OG0032950	0	0	1	1	2
OG0032951	0	0	1	1	2
OG0032952	0	0	1	1	2
OG0032953	0	0	1	1	2
OG0032954	0	0	1	1	2
OG0032955	0	0	1	1	2
OG0032956	0	0	1	1	2
OG0032957	0	0	1	1	2
OG0032958	0	0	1	1	2
OG0032959	0	0	2	0	2
OG0032960	0	0	1	1	2
OG0032961	0	0	1	1	2
OG0032962	0	0	1	1	2
OG0032963	0	0	2	0	2
OG0032964	0	0	1	1	2
OG0032965	0	0	2	0	2
OG0032966	0	0	2	0	2
OG0032967	0	0	1	1	2
OG0032968	0	0	2	0	2
OG0032969	0	0	1	1	2
OG0032970	0	0	2	0	2
OG0032971	0	0	2	0	2
OG0032972	0	0	1	1	2
OG0032973	0	0	2	0	2
OG0032974	0	0	1	1	2
OG0032975	0	0	1	1	2
OG0032976	0	0	1	1	2
OG0032977	0	0	1	1	2
OG0032978	0	0	1	1	2
OG0032979	0	0	1	1	2
OG0032980	0	0	1	1	2
OG0032981	0	0	2	0	2
OG0032982	0	0	1	1	2
OG0032983	0	0	1	1	2
OG0032984	0	0	1	1	2
OG0032985	0	0	1	1	2
OG0032986	0	0	1	1	2
OG0032987	0	0	1	1	2
OG0032988	0	0	2	0	2
OG0032989	0	0	1	1	2
OG0032990	0	0	1	1	2
OG0032991	0	0	1	1	2
OG0032992	0	0	2	0	2
OG0032993	0	0	1	1	2
OG0032994	0	0	2	0	2
OG0032995	0	0	1	1	2
OG0032996	0	0	1	1	2
OG0032997	0	0	1	1	2
OG0032998	0	0	2	0	2
OG0032999	0	0	1	1	2
OG0033000	0	0	1	1	2
OG0033001	0	0	1	1	2
OG0033002	0	0	1	1	2
OG0033003	0	0	1	1	2
OG0033004	0	0	1	1	2
OG0033005	0	0	2	0	2
OG0033006	0	0	1	1	2
OG0033007	0	0	1	1	2
OG0033008	0	0	1	1	2
OG0033009	0	0	2	0	2
OG0033010	0	0	1	1	2
OG0033011	0	0	1	1	2
OG0033012	0	0	1	1	2
OG0033013	0	0	1	1	2
OG0033014	0	0	1	1	2
OG0033015	0	0	1	1	2
OG0033016	0	0	1	1	2
OG0033017	0	0	1	1	2
OG0033018	0	0	1	1	2
OG0033019	0	0	1	1	2
OG0033020	0	0	1	1	2
OG0033021	0	0	1	1	2
OG0033022	0	0	1	1	2
OG0033023	0	0	1	1	2
OG0033024	0	0	2	0	2
OG0033025	0	0	1	1	2
OG0033026	0	0	1	1	2
OG0033027	0	0	1	1	2
OG0033028	0	0	1	1	2
OG0033029	0	0	1	1	2
OG0033030	0	0	1	1	2
OG0033031	0	0	1	1	2
OG0033032	0	0	1	1	2
OG0033033	0	0	1	1	2
OG0033034	0	0	1	1	2
OG0033035	0	0	1	1	2
OG0033036	0	0	1	1	2
OG0033037	0	0	1	1	2
OG0033038	0	0	1	1	2
OG0033039	0	0	1	1	2
OG0033040	0	0	1	1	2
OG0033041	0	0	2	0	2
OG0033042	0	0	1	1	2
OG0033043	0	0	1	1	2
OG0033044	0	0	1	1	2
OG0033045	0	0	1	1	2
OG0033046	0	0	2	0	2
OG0033047	0	0	1	1	2
OG0033048	0	0	1	1	2
OG0033049	0	0	1	1	2
OG0033050	0	0	1	1	2
OG0033051	0	0	1	1	2
OG0033052	0	0	1	1	2
OG0033053	0	0	2	0	2
OG0033054	0	0	1	1	2
OG0033055	0	0	1	1	2
OG0033056	0	0	2	0	2
OG0033057	0	0	1	1	2
OG0033058	0	0	1	1	2
OG0033059	0	0	1	1	2
OG0033060	0	0	1	1	2
OG0033061	0	0	1	1	2
OG0033062	0	0	2	0	2
OG0033063	0	0	1	1	2
OG0033064	0	0	1	1	2
OG0033065	0	0	1	1	2
OG0033066	0	0	2	0	2
OG0033067	0	0	2	0	2
OG0033068	0	0	1	1	2
OG0033069	0	0	1	1	2
OG0033070	0	0	1	1	2
OG0033071	0	0	2	0	2
OG0033072	0	0	1	1	2
OG0033073	0	0	1	1	2
OG0033074	0	0	1	1	2
OG0033075	0	0	1	1	2
OG0033076	0	0	2	0	2
OG0033077	0	0	1	1	2
OG0033078	0	0	2	0	2
OG0033079	0	0	1	1	2
OG0033080	0	0	1	1	2
OG0033081	0	0	1	1	2
OG0033082	0	0	1	1	2
OG0033083	0	0	1	1	2
OG0033084	0	0	1	1	2
OG0033085	0	0	1	1	2
OG0033086	0	0	2	0	2
OG0033087	0	0	1	1	2
OG0033088	0	0	2	0	2
OG0033089	0	0	1	1	2
OG0033090	0	0	1	1	2
OG0033091	0	0	1	1	2
OG0033092	0	0	1	1	2
OG0033093	0	0	1	1	2
OG0033094	0	0	1	1	2
OG0033095	0	0	1	1	2
OG0033096	0	0	2	0	2
OG0033097	0	0	1	1	2
OG0033098	0	0	1	1	2
OG0033099	0	0	1	1	2
OG0033100	0	0	1	1	2
OG0033101	0	0	1	1	2
OG0033102	0	0	1	1	2
OG0033103	0	0	2	0	2
OG0033104	0	0	1	1	2
OG0033105	0	0	1	1	2
OG0033106	0	0	1	1	2
OG0033107	0	0	1	1	2
OG0033108	0	0	2	0	2
OG0033109	0	0	2	0	2
OG0033110	0	0	1	1	2
OG0033111	0	0	1	1	2
OG0033112	0	0	1	1	2
OG0033113	0	0	1	1	2
OG0033114	0	0	1	1	2
OG0033115	0	0	1	1	2
OG0033116	0	0	1	1	2
OG0033117	0	0	1	1	2
OG0033118	0	0	1	1	2
OG0033119	0	0	1	1	2
OG0033120	0	0	2	0	2
OG0033121	0	0	1	1	2
OG0033122	0	0	2	0	2
OG0033123	0	0	1	1	2
OG0033124	0	0	1	1	2
OG0033125	0	0	1	1	2
OG0033126	0	0	2	0	2
OG0033127	0	0	2	0	2
OG0033128	0	0	2	0	2
OG0033129	0	0	1	1	2
OG0033130	0	0	1	1	2
OG0033131	0	0	1	1	2
OG0033132	0	0	1	1	2
OG0033133	0	0	1	1	2
OG0033134	0	0	1	1	2
OG0033135	0	0	1	1	2
OG0033136	0	0	1	1	2
OG0033137	0	0	1	1	2
OG0033138	0	0	1	1	2
OG0033139	0	0	1	1	2
OG0033140	0	0	1	1	2
OG0033141	0	0	2	0	2
OG0033142	0	0	1	1	2
OG0033143	0	0	2	0	2
OG0033144	0	0	1	1	2
OG0033145	0	0	2	0	2
OG0033146	0	0	1	1	2
OG0033147	0	0	1	1	2
OG0033148	0	0	1	1	2
OG0033149	0	0	1	1	2
OG0033150	0	0	1	1	2
OG0033151	0	0	1	1	2
OG0033152	0	0	2	0	2
OG0033153	0	0	1	1	2
OG0033154	0	0	1	1	2
OG0033155	0	0	1	1	2
OG0033156	0	0	1	1	2
OG0033157	0	0	2	0	2
OG0033158	0	0	1	1	2
OG0033159	0	0	1	1	2
OG0033160	0	0	1	1	2
OG0033161	0	0	1	1	2
OG0033162	0	0	1	1	2
OG0033163	0	0	1	1	2
OG0033164	0	0	1	1	2
OG0033165	0	0	1	1	2
OG0033166	0	0	2	0	2
OG0033167	0	0	1	1	2
OG0033168	0	0	1	1	2
OG0033169	0	0	1	1	2
OG0033170	0	0	1	1	2
OG0033171	0	0	1	1	2
OG0033172	0	0	1	1	2
OG0033173	0	0	1	1	2
OG0033174	0	0	1	1	2
OG0033175	0	0	1	1	2
OG0033176	0	0	1	1	2
OG0033177	0	0	1	1	2
OG0033178	0	0	1	1	2
OG0033179	0	0	1	1	2
OG0033180	0	0	1	1	2
OG0033181	0	0	2	0	2
OG0033182	0	0	1	1	2
OG0033183	0	0	1	1	2
OG0033184	0	0	2	0	2
OG0033185	0	0	1	1	2
OG0033186	0	0	1	1	2
OG0033187	0	0	1	1	2
OG0033188	0	0	2	0	2
OG0033189	0	0	1	1	2
OG0033190	0	0	1	1	2
OG0033191	0	0	1	1	2
OG0033192	0	0	1	1	2
OG0033193	0	0	1	1	2
OG0033194	0	0	1	1	2
OG0033195	0	0	1	1	2
OG0033196	0	0	1	1	2
OG0033197	0	0	1	1	2
OG0033198	0	0	2	0	2
OG0033199	0	0	1	1	2
OG0033200	0	0	1	1	2
OG0033201	0	0	2	0	2
OG0033202	0	0	1	1	2
OG0033203	0	0	1	1	2
OG0033204	0	0	1	1	2
OG0033205	0	0	1	1	2
OG0033206	0	0	1	1	2
OG0033207	0	0	1	1	2
OG0033208	0	0	1	1	2
OG0033209	0	0	2	0	2
OG0033210	0	0	1	1	2
OG0033211	0	0	1	1	2
OG0033212	0	0	1	1	2
OG0033213	0	0	1	1	2
OG0033214	0	0	1	1	2
OG0033215	0	0	1	1	2
OG0033216	0	0	2	0	2
OG0033217	0	0	1	1	2
OG0033218	0	0	1	1	2
OG0033219	0	0	1	1	2
OG0033220	0	0	1	1	2
OG0033221	0	0	2	0	2
OG0033222	0	0	2	0	2
OG0033223	0	0	1	1	2
OG0033224	0	0	1	1	2
OG0033225	0	0	1	1	2
OG0033226	0	0	2	0	2
OG0033227	0	0	1	1	2
OG0033228	0	0	1	1	2
OG0033229	0	0	1	1	2
OG0033230	0	0	1	1	2
OG0033231	0	0	1	1	2
OG0033232	0	0	1	1	2
OG0033233	0	0	1	1	2
OG0033234	0	0	1	1	2
OG0033235	0	0	1	1	2
OG0033236	0	0	1	1	2
OG0033237	0	0	1	1	2
OG0033238	0	0	2	0	2
OG0033239	0	0	1	1	2
OG0033240	0	0	1	1	2
OG0033241	0	0	1	1	2
OG0033242	0	0	1	1	2
OG0033243	0	0	1	1	2
OG0033244	0	0	2	0	2
OG0033245	0	0	1	1	2
OG0033246	0	0	1	1	2
OG0033247	0	0	1	1	2
OG0033248	0	0	1	1	2
OG0033249	0	0	1	1	2
OG0033250	0	0	1	1	2
OG0033251	0	0	2	0	2
OG0033252	0	0	1	1	2
OG0033253	0	0	1	1	2
OG0033254	0	0	2	0	2
OG0033255	0	0	1	1	2
OG0033256	0	0	2	0	2
OG0033257	0	0	1	1	2
OG0033258	0	0	1	1	2
OG0033259	0	0	1	1	2
OG0033260	0	0	1	1	2
OG0033261	0	0	1	1	2
OG0033262	0	0	1	1	2
OG0033263	0	0	2	0	2
OG0033264	0	0	1	1	2
OG0033265	0	0	1	1	2
OG0033266	0	0	1	1	2
OG0033267	0	0	2	0	2
OG0033268	0	0	1	1	2
OG0033269	0	0	1	1	2
OG0033270	0	0	1	1	2
OG0033271	0	0	1	1	2
OG0033272	0	0	1	1	2
OG0033273	0	0	2	0	2
OG0033274	0	0	1	1	2
OG0033275	0	0	1	1	2
OG0033276	0	0	2	0	2
OG0033277	0	0	1	1	2
OG0033278	0	0	2	0	2
OG0033279	0	0	2	0	2
OG0033280	0	0	1	1	2
OG0033281	0	0	1	1	2
OG0033282	0	0	1	1	2
OG0033283	0	0	1	1	2
OG0033284	0	0	1	1	2
OG0033285	0	0	1	1	2
OG0033286	0	0	1	1	2
OG0033287	0	0	1	1	2
OG0033288	0	0	1	1	2
OG0033289	0	0	1	1	2
OG0033290	0	0	1	1	2
OG0033291	0	0	1	1	2
OG0033292	0	0	1	1	2
OG0033293	0	0	1	1	2
OG0033294	0	0	1	1	2
OG0033295	0	0	1	1	2
OG0033296	0	0	2	0	2
OG0033297	0	0	2	0	2
OG0033298	0	0	1	1	2
OG0033299	0	0	1	1	2
OG0033300	0	0	1	1	2
OG0033301	0	0	2	0	2
OG0033302	0	0	1	1	2
OG0033303	0	0	1	1	2
OG0033304	0	0	1	1	2
OG0033305	0	0	1	1	2
OG0033306	0	0	2	0	2
OG0033307	0	0	2	0	2
OG0033308	0	0	1	1	2
OG0033309	0	0	1	1	2
OG0033310	0	0	1	1	2
OG0033311	0	0	1	1	2
OG0033312	0	0	1	1	2
OG0033313	0	0	1	1	2
OG0033314	0	0	2	0	2
OG0033315	0	0	1	1	2
OG0033316	0	0	1	1	2
OG0033317	0	0	1	1	2
OG0033318	0	0	1	1	2
OG0033319	0	0	1	1	2
OG0033320	0	0	1	1	2
OG0033321	0	0	1	1	2
OG0033322	0	0	1	1	2
OG0033323	0	0	1	1	2
OG0033324	0	0	1	1	2
OG0033325	0	0	2	0	2
OG0033326	0	0	1	1	2
OG0033327	0	0	1	1	2
OG0033328	0	0	2	0	2
OG0033329	0	0	1	1	2
OG0033330	0	0	1	1	2
OG0033331	0	0	1	1	2
OG0033332	0	0	1	1	2
OG0033333	0	0	1	1	2
OG0033334	0	0	1	1	2
OG0033335	0	0	2	0	2
OG0033336	0	0	1	1	2
OG0033337	0	0	1	1	2
OG0033338	0	0	2	0	2
OG0033339	0	0	1	1	2
OG0033340	0	0	1	1	2
OG0033341	0	0	1	1	2
OG0033342	0	0	1	1	2
OG0033343	0	0	1	1	2
OG0033344	0	0	1	1	2
OG0033345	0	0	1	1	2
OG0033346	0	0	1	1	2
OG0033347	0	0	1	1	2
OG0033348	0	0	1	1	2
OG0033349	0	0	1	1	2
OG0033350	0	0	2	0	2
OG0033351	0	0	2	0	2
OG0033352	0	0	1	1	2
OG0033353	0	0	1	1	2
OG0033354	0	0	1	1	2
OG0033355	0	0	1	1	2
OG0033356	0	0	2	0	2
OG0033357	0	0	1	1	2
OG0033358	0	0	1	1	2
OG0033359	0	0	1	1	2
OG0033360	0	0	1	1	2
OG0033361	0	0	1	1	2
OG0033362	0	0	1	1	2
OG0033363	0	0	1	1	2
OG0033364	0	0	1	1	2
OG0033365	0	0	1	1	2
OG0033366	0	0	2	0	2
OG0033367	0	0	1	1	2
OG0033368	0	0	1	1	2
OG0033369	0	0	2	0	2
OG0033370	0	0	1	1	2
OG0033371	0	0	1	1	2
OG0033372	0	0	1	1	2
OG0033373	0	0	1	1	2
OG0033374	0	0	1	1	2
OG0033375	0	0	1	1	2
OG0033376	0	0	1	1	2
OG0033377	0	0	1	1	2
OG0033378	0	0	1	1	2
OG0033379	0	0	1	1	2
OG0033380	0	0	1	1	2
OG0033381	0	0	1	1	2
OG0033382	0	0	2	0	2
OG0033383	0	0	2	0	2
OG0033384	0	0	1	1	2
OG0033385	0	0	1	1	2
OG0033386	0	0	1	1	2
OG0033387	0	0	1	1	2
OG0033388	0	0	1	1	2
OG0033389	0	0	1	1	2
OG0033390	0	0	1	1	2
OG0033391	0	0	1	1	2
OG0033392	0	0	1	1	2
OG0033393	0	0	1	1	2
OG0033394	0	0	1	1	2
OG0033395	0	0	1	1	2
OG0033396	0	0	1	1	2
OG0033397	0	0	1	1	2
OG0033398	0	0	1	1	2
OG0033399	0	0	1	1	2
OG0033400	0	0	2	0	2
OG0033401	0	0	2	0	2
OG0033402	0	0	1	1	2
OG0033403	0	0	1	1	2
OG0033404	0	0	1	1	2
OG0033405	0	0	1	1	2
OG0033406	0	0	1	1	2
OG0033407	0	0	1	1	2
OG0033408	0	0	1	1	2
OG0033409	0	0	2	0	2
OG0033410	0	0	1	1	2
OG0033411	0	0	1	1	2
OG0033412	0	0	1	1	2
OG0033413	0	0	1	1	2
OG0033414	0	0	1	1	2
OG0033415	0	0	1	1	2
OG0033416	0	0	1	1	2
OG0033417	0	0	1	1	2
OG0033418	0	0	1	1	2
OG0033419	0	0	1	1	2
OG0033420	0	0	1	1	2
OG0033421	0	0	2	0	2
OG0033422	0	0	1	1	2
OG0033423	0	0	1	1	2
OG0033424	0	0	1	1	2
OG0033425	0	0	1	1	2
OG0033426	0	0	1	1	2
OG0033427	0	0	1	1	2
OG0033428	0	0	2	0	2
OG0033429	0	0	1	1	2
OG0033430	0	0	2	0	2
OG0033431	0	0	2	0	2
OG0033432	0	0	1	1	2
OG0033433	0	0	1	1	2
OG0033434	0	0	1	1	2
OG0033435	0	0	1	1	2
OG0033436	0	0	1	1	2
OG0033437	0	0	1	1	2
OG0033438	0	0	1	1	2
OG0033439	0	0	2	0	2
OG0033440	0	0	1	1	2
OG0033441	0	0	1	1	2
OG0033442	0	0	1	1	2
OG0033443	0	0	1	1	2
OG0033444	0	0	1	1	2
OG0033445	0	0	1	1	2
OG0033446	0	0	1	1	2
OG0033447	0	0	1	1	2
OG0033448	0	0	1	1	2
OG0033449	0	0	1	1	2
OG0033450	0	0	1	1	2
OG0033451	0	0	1	1	2
OG0033452	0	0	2	0	2
OG0033453	0	0	1	1	2
OG0033454	0	0	1	1	2
OG0033455	0	0	1	1	2
OG0033456	0	0	1	1	2
OG0033457	0	0	1	1	2
OG0033458	0	0	2	0	2
OG0033459	0	0	1	1	2
OG0033460	0	0	1	1	2
OG0033461	0	0	2	0	2
OG0033462	0	0	1	1	2
OG0033463	0	0	1	1	2
OG0033464	0	0	1	1	2
OG0033465	0	0	1	1	2
OG0033466	0	0	2	0	2
OG0033467	0	0	2	0	2
OG0033468	0	0	2	0	2
OG0033469	0	0	1	1	2
OG0033470	0	0	1	1	2
OG0033471	0	0	1	1	2
OG0033472	0	0	2	0	2
OG0033473	0	0	1	1	2
OG0033474	0	0	1	1	2
OG0033475	0	0	2	0	2
OG0033476	0	0	1	1	2
OG0033477	0	0	1	1	2
OG0033478	0	0	2	0	2
OG0033479	0	0	2	0	2
OG0033480	0	0	2	0	2
OG0033481	0	0	1	1	2
OG0033482	0	0	1	1	2
OG0033483	0	0	1	1	2
OG0033484	0	0	1	1	2
OG0033485	0	0	1	1	2
OG0033486	0	0	1	1	2
OG0033487	0	0	1	1	2
OG0033488	0	0	2	0	2
OG0033489	0	0	1	1	2
OG0033490	0	0	1	1	2
OG0033491	0	0	1	1	2
OG0033492	0	0	1	1	2
OG0033493	0	0	1	1	2
OG0033494	0	0	1	1	2
OG0033495	0	0	2	0	2
OG0033496	0	0	1	1	2
OG0033497	0	0	1	1	2
OG0033498	0	0	1	1	2
OG0033499	0	0	1	1	2
OG0033500	0	0	1	1	2
OG0033501	0	0	2	0	2
OG0033502	0	0	1	1	2
OG0033503	0	0	1	1	2
OG0033504	0	0	2	0	2
OG0033505	0	0	1	1	2
OG0033506	0	0	1	1	2
OG0033507	0	0	1	1	2
OG0033508	0	0	1	1	2
OG0033509	0	0	1	1	2
OG0033510	0	0	1	1	2
OG0033511	0	0	1	1	2
OG0033512	0	0	2	0	2
OG0033513	0	0	1	1	2
OG0033514	0	0	1	1	2
OG0033515	0	0	1	1	2
OG0033516	0	0	1	1	2
OG0033517	0	0	1	1	2
OG0033518	0	0	1	1	2
OG0033519	0	0	1	1	2
OG0033520	0	0	2	0	2
OG0033521	0	0	2	0	2
OG0033522	0	0	2	0	2
OG0033523	0	0	1	1	2
OG0033524	0	0	1	1	2
OG0033525	0	0	1	1	2
OG0033526	0	0	1	1	2
OG0033527	0	0	1	1	2
OG0033528	0	0	2	0	2
OG0033529	0	0	1	1	2
OG0033530	0	0	1	1	2
OG0033531	0	0	1	1	2
OG0033532	0	0	1	1	2
OG0033533	0	0	1	1	2
OG0033534	0	0	1	1	2
OG0033535	0	0	1	1	2
OG0033536	0	0	1	1	2
OG0033537	0	0	2	0	2
OG0033538	0	0	1	1	2
OG0033539	0	0	2	0	2
OG0033540	0	0	1	1	2
OG0033541	0	0	2	0	2
OG0033542	0	0	1	1	2
OG0033543	0	0	1	1	2
OG0033544	0	0	2	0	2
OG0033545	0	0	1	1	2
OG0033546	0	0	2	0	2
OG0033547	0	0	1	1	2
OG0033548	0	0	1	1	2
OG0033549	0	0	2	0	2
OG0033550	0	0	1	1	2
OG0033551	0	0	1	1	2
OG0033552	0	0	1	1	2
OG0033553	0	0	1	1	2
OG0033554	0	0	1	1	2
OG0033555	0	0	2	0	2
OG0033556	0	0	2	0	2
OG0033557	0	0	1	1	2
OG0033558	0	0	2	0	2
OG0033559	0	0	1	1	2
OG0033560	0	0	1	1	2
OG0033561	0	0	1	1	2
OG0033562	0	0	2	0	2
OG0033563	0	0	1	1	2
OG0033564	0	0	1	1	2
OG0033565	0	0	1	1	2
OG0033566	0	0	1	1	2
OG0033567	0	0	1	1	2
OG0033568	0	0	1	1	2
OG0033569	0	0	1	1	2
OG0033570	0	0	2	0	2
OG0033571	0	0	1	1	2
OG0033572	0	0	1	1	2
OG0033573	0	0	1	1	2
OG0033574	0	0	1	1	2
OG0033575	0	0	1	1	2
OG0033576	0	0	1	1	2
OG0033577	0	0	1	1	2
OG0033578	0	0	1	1	2
OG0033579	0	0	1	1	2
OG0033580	0	0	2	0	2
OG0033581	0	0	1	1	2
OG0033582	0	0	1	1	2
OG0033583	0	0	1	1	2
OG0033584	0	0	2	0	2
OG0033585	0	0	1	1	2
OG0033586	0	0	1	1	2
OG0033587	0	0	2	0	2
OG0033588	0	0	1	1	2
OG0033589	0	0	1	1	2
OG0033590	0	0	0	2	2
OG0033591	0	0	0	2	2
OG0033592	0	0	0	2	2
OG0033593	0	0	0	2	2
OG0033594	0	0	0	2	2
OG0033595	0	0	0	2	2
OG0033596	0	0	0	2	2
OG0033597	0	0	0	2	2
OG0033598	0	0	0	2	2
OG0033599	0	0	0	2	2
OG0033600	0	0	0	2	2
OG0033601	0	0	0	2	2
OG0033602	0	0	0	2	2
OG0033603	0	0	0	2	2
OG0033604	0	0	0	2	2
OG0033605	0	0	0	2	2
OG0033606	0	0	0	2	2
OG0033607	0	0	0	2	2
OG0033608	0	0	0	2	2
OG0033609	0	0	0	2	2
OG0033610	0	0	0	2	2
OG0033611	0	0	0	2	2
OG0033612	0	0	0	2	2
OG0033613	0	0	0	2	2
OG0033614	0	0	0	2	2
OG0033615	0	0	0	2	2
OG0033616	0	0	0	2	2
OG0033617	0	0	0	2	2
OG0033618	0	0	0	2	2
OG0033619	0	0	0	2	2
OG0033620	0	0	0	2	2
OG0033621	0	0	0	2	2
OG0033622	0	0	0	2	2
OG0033623	0	0	0	2	2
OG0033624	0	0	0	2	2
OG0033625	0	0	0	2	2
OG0033626	0	0	0	2	2
OG0033627	0	0	0	2	2
OG0033628	0	0	0	2	2
OG0033629	0	0	0	2	2
OG0033630	0	0	0	2	2
OG0033631	0	0	0	2	2
OG0033632	0	0	0	2	2
OG0033633	0	0	0	2	2
OG0033634	0	0	0	2	2
OG0033635	0	0	0	2	2
OG0033636	0	0	0	2	2
OG0033637	0	0	0	2	2
OG0033638	0	0	0	2	2
OG0033639	0	0	0	2	2
OG0033640	0	0	0	2	2
OG0033641	0	0	0	2	2
OG0033642	0	0	0	2	2
OG0033643	0	0	0	2	2
OG0033644	0	0	0	2	2
OG0033645	0	0	0	2	2
OG0033646	0	0	0	2	2
OG0033647	0	0	0	2	2
OG0033648	0	0	0	2	2
OG0033649	0	0	0	2	2
OG0033650	0	0	0	2	2
OG0033651	0	0	0	2	2
OG0033652	0	0	0	2	2
OG0033653	0	0	0	2	2
OG0033654	0	0	0	2	2
OG0033655	0	0	0	2	2
OG0033656	0	0	0	2	2
OG0033657	0	0	0	2	2
OG0033658	0	0	0	2	2
OG0033659	0	0	0	2	2
OG0033660	0	0	0	2	2
OG0033661	0	0	0	2	2
OG0033662	0	0	0	2	2
OG0033663	0	0	0	2	2
OG0033664	0	0	0	2	2
OG0033665	0	0	0	2	2
OG0033666	0	0	0	2	2
OG0033667	0	0	0	2	2
OG0033668	0	0	0	2	2
OG0033669	0	0	0	2	2
OG0033670	0	0	0	2	2
OG0033671	0	0	0	2	2
OG0033672	0	0	0	2	2
OG0033673	0	0	0	2	2
OG0033674	0	0	0	2	2
OG0033675	0	0	0	2	2
OG0033676	0	0	0	2	2
OG0033677	0	0	0	2	2
OG0033678	0	0	0	2	2
OG0033679	0	0	0	2	2
OG0033680	0	0	0	2	2
OG0033681	0	0	0	2	2
OG0033682	0	0	0	2	2
OG0033683	0	0	0	2	2
OG0033684	0	0	0	2	2
OG0033685	0	0	0	2	2
OG0033686	0	0	0	2	2
OG0033687	0	0	0	2	2
OG0033688	0	0	0	2	2
OG0033689	0	0	0	2	2
OG0033690	0	0	0	2	2
OG0033691	0	0	0	2	2
OG0033692	0	0	0	2	2
OG0033693	0	0	0	2	2
OG0033694	0	0	0	2	2
OG0033695	0	0	0	2	2
OG0033696	0	0	0	2	2
OG0033697	0	0	0	2	2
OG0033698	0	0	0	2	2
OG0033699	0	0	0	2	2
OG0033700	0	0	0	2	2
OG0033701	0	0	0	2	2
OG0033702	0	0	0	2	2
OG0033703	0	0	0	2	2
OG0033704	0	0	0	2	2
OG0033705	0	0	0	2	2
OG0033706	0	0	0	2	2
OG0033707	0	0	0	2	2
OG0033708	0	0	0	2	2
OG0033709	0	0	0	2	2
OG0033710	0	0	0	2	2
OG0033711	0	0	0	2	2
OG0033712	0	0	0	2	2
OG0033713	0	0	0	2	2
OG0033714	0	0	0	2	2
OG0033715	0	0	0	2	2
OG0033716	0	0	0	2	2
OG0033717	0	0	0	2	2
OG0033718	0	0	0	2	2
OG0033719	0	0	0	2	2
OG0033720	0	0	0	2	2
OG0033721	0	0	0	2	2
OG0033722	0	0	0	2	2
OG0033723	0	0	0	2	2
OG0033724	0	0	0	2	2
OG0033725	0	0	0	2	2
OG0033726	0	0	0	2	2
OG0033727	0	0	0	2	2
OG0033728	0	0	0	2	2
OG0033729	0	0	0	2	2
OG0033730	0	0	0	2	2
OG0033731	0	0	0	2	2
OG0033732	0	0	0	2	2
OG0033733	0	0	0	2	2
OG0033734	0	0	0	2	2
OG0033735	0	0	0	2	2
OG0033736	0	0	0	2	2
OG0033737	0	0	0	2	2
OG0033738	0	0	0	2	2
OG0033739	0	0	0	2	2
OG0033740	0	0	0	2	2
OG0033741	0	0	0	2	2
OG0033742	0	0	0	2	2
OG0033743	0	0	0	2	2
OG0033744	0	0	0	2	2
OG0033745	0	0	0	2	2
OG0033746	0	0	0	2	2
OG0033747	0	0	0	2	2
OG0033748	0	0	0	2	2
OG0033749	0	0	0	2	2
OG0033750	0	0	0	2	2
OG0033751	0	0	0	2	2
OG0033752	0	0	0	2	2
OG0033753	0	0	0	2	2
OG0033754	0	0	0	2	2
OG0033755	0	0	0	2	2
OG0033756	0	0	0	2	2
OG0033757	0	0	0	2	2
OG0033758	0	0	0	2	2
OG0033759	0	0	0	2	2
OG0033760	0	0	0	2	2
OG0033761	0	0	0	2	2
OG0033762	0	0	0	2	2
OG0033763	0	0	0	2	2
OG0033764	0	0	0	2	2
OG0033765	0	0	0	2	2
OG0033766	0	0	0	2	2
OG0033767	0	0	0	2	2
OG0033768	0	0	0	2	2
OG0033769	0	0	0	2	2
OG0033770	0	0	0	2	2
OG0033771	0	0	0	2	2
OG0033772	0	0	0	2	2
OG0033773	0	0	0	2	2
OG0033774	0	0	0	2	2
OG0033775	0	0	0	2	2
OG0033776	0	0	0	2	2
OG0033777	0	0	0	2	2
OG0033778	0	0	0	2	2
OG0033779	0	0	0	2	2
OG0033780	0	0	0	2	2
OG0033781	0	0	0	2	2
OG0033782	0	0	0	2	2
OG0033783	0	0	0	2	2
OG0033784	0	0	0	2	2
OG0033785	0	0	0	2	2
OG0033786	0	0	0	2	2
OG0033787	0	0	0	2	2
OG0033788	0	0	0	2	2
OG0033789	0	0	0	2	2
OG0033790	0	0	0	2	2
OG0033791	0	0	0	2	2
OG0033792	0	0	0	2	2
OG0033793	0	0	0	2	2
OG0033794	0	0	0	2	2
OG0033795	0	0	0	2	2
OG0033796	0	0	0	2	2
OG0033797	0	0	0	2	2
OG0033798	0	0	0	2	2
OG0033799	0	0	0	2	2
OG0033800	0	0	0	2	2
OG0033801	0	0	0	2	2
OG0033802	0	0	0	2	2
OG0033803	0	0	0	2	2
OG0033804	0	0	0	2	2
OG0033805	0	0	0	2	2
OG0033806	0	0	0	2	2
OG0033807	0	0	0	2	2
OG0033808	0	0	0	2	2
OG0033809	0	0	0	2	2
OG0033810	0	0	0	2	2
OG0033811	0	0	0	2	2
OG0033812	0	0	0	2	2
OG0033813	0	0	0	2	2
OG0033814	0	0	0	2	2
OG0033815	0	0	0	2	2
OG0033816	0	0	0	2	2
OG0033817	0	0	0	2	2
OG0033818	0	0	0	2	2
OG0033819	0	0	0	2	2
OG0033820	0	0	0	2	2
OG0033821	0	0	0	2	2
OG0033822	0	0	0	2	2
OG0033823	0	0	0	2	2
OG0033824	0	0	0	2	2
OG0033825	0	0	0	2	2
OG0033826	0	0	0	2	2
OG0033827	0	0	0	2	2
OG0033828	0	0	0	2	2
OG0033829	0	0	0	2	2
OG0033830	0	0	0	2	2
OG0033831	0	0	0	2	2
OG0033832	0	0	0	2	2
OG0033833	0	0	0	2	2
OG0033834	0	0	0	2	2
OG0033835	0	0	0	2	2
OG0033836	0	0	0	2	2
OG0033837	0	0	0	2	2
OG0033838	0	0	0	2	2
OG0033839	0	0	0	2	2
OG0033840	0	0	0	2	2
OG0033841	0	0	0	2	2
OG0033842	0	0	0	2	2
OG0033843	0	0	0	2	2
OG0033844	0	0	0	2	2
OG0033845	0	0	0	2	2
OG0033846	0	0	0	2	2
OG0033847	0	0	0	2	2
OG0033848	0	0	0	2	2
OG0033849	0	0	0	2	2
OG0033850	0	0	0	2	2
OG0033851	0	0	0	2	2
OG0033852	0	0	0	2	2
OG0033853	0	0	0	2	2
OG0033854	0	0	0	2	2
OG0033855	0	0	0	2	2
OG0033856	0	0	0	2	2
OG0033857	0	0	0	2	2
OG0033858	0	0	0	2	2
OG0033859	0	0	0	2	2
OG0033860	0	0	0	2	2
OG0033861	0	0	0	2	2
OG0033862	0	0	0	2	2
OG0033863	0	0	0	2	2
OG0033864	0	0	0	2	2
OG0033865	0	0	0	2	2
OG0033866	0	0	0	2	2
OG0033867	0	0	0	2	2
OG0033868	0	0	0	2	2
OG0033869	0	0	0	2	2
OG0033870	0	0	0	2	2
OG0033871	0	0	0	2	2
OG0033872	0	0	0	2	2
OG0033873	0	0	0	2	2
OG0033874	0	0	0	2	2
OG0033875	0	0	0	2	2
OG0033876	0	0	0	2	2
OG0033877	0	0	0	2	2
OG0033878	0	0	0	2	2
OG0033879	0	0	0	2	2
OG0033880	0	0	0	2	2
OG0033881	0	0	0	2	2
OG0033882	0	0	0	2	2
OG0033883	0	0	0	2	2
OG0033884	0	0	0	2	2
OG0033885	0	0	0	2	2
OG0033886	0	0	0	2	2
OG0033887	0	0	0	2	2
OG0033888	0	0	0	2	2
OG0033889	0	0	0	2	2
OG0033890	0	0	0	2	2
OG0033891	0	0	0	2	2
OG0033892	0	0	0	2	2
OG0033893	0	0	0	2	2
OG0033894	0	0	0	2	2
OG0033895	0	0	0	2	2
OG0033896	0	0	0	2	2
OG0033897	0	0	0	2	2
OG0033898	0	0	0	2	2
OG0033899	0	0	0	2	2
OG0033900	0	0	0	2	2
OG0033901	0	0	0	2	2
OG0033902	0	0	0	2	2
OG0033903	0	0	0	2	2
OG0033904	0	0	0	2	2
OG0033905	0	0	0	2	2
OG0033906	0	0	0	2	2
OG0033907	0	0	0	2	2
OG0033908	0	0	0	2	2
OG0033909	0	0	0	2	2
OG0033910	0	0	0	2	2
OG0033911	0	0	0	2	2
OG0033912	0	0	0	2	2
OG0033913	0	0	0	2	2
OG0033914	0	0	0	2	2
OG0033915	0	0	0	2	2
OG0033916	0	0	0	2	2
OG0033917	0	0	0	2	2
OG0033918	0	0	0	2	2
OG0033919	0	0	0	2	2
OG0033920	0	0	0	2	2
OG0033921	0	0	0	2	2
OG0033922	0	0	0	2	2
OG0033923	0	0	0	2	2
OG0033924	0	0	0	2	2
OG0033925	0	0	0	2	2
OG0033926	0	0	0	2	2
OG0033927	0	0	0	2	2
OG0033928	0	0	0	2	2
OG0033929	0	0	0	2	2
OG0033930	0	0	0	2	2
OG0033931	0	0	0	2	2
OG0033932	0	0	0	2	2
OG0033933	0	0	0	2	2
OG0033934	0	0	0	2	2
OG0033935	0	0	0	2	2
OG0033936	0	0	0	2	2
OG0033937	0	0	0	2	2
OG0033938	0	0	0	2	2
OG0033939	0	0	0	2	2
OG0033940	0	0	0	2	2
OG0033941	0	0	0	2	2
OG0033942	0	0	0	2	2
OG0033943	0	0	0	2	2
OG0033944	0	0	0	2	2
OG0033945	0	0	0	2	2
OG0033946	0	0	0	2	2
OG0033947	0	0	0	2	2
OG0033948	0	0	0	2	2
OG0033949	0	0	0	2	2
OG0033950	0	0	0	2	2
OG0033951	0	0	0	2	2
OG0033952	0	0	0	2	2
OG0033953	0	0	0	2	2
OG0033954	0	0	0	2	2
OG0033955	0	0	0	2	2
OG0033956	0	0	0	2	2
OG0033957	0	0	0	2	2
OG0033958	0	0	0	2	2
OG0033959	0	0	0	2	2
OG0033960	0	0	0	2	2
OG0033961	0	0	0	2	2
OG0033962	0	0	0	2	2
OG0033963	0	0	0	2	2
OG0033964	0	0	0	2	2
OG0033965	0	0	0	2	2
OG0033966	0	0	0	2	2
OG0033967	0	0	0	2	2
OG0033968	0	0	0	2	2
OG0033969	0	0	0	2	2
OG0033970	0	0	0	2	2
OG0033971	0	0	0	2	2
OG0033972	0	0	0	2	2
OG0033973	0	0	0	2	2
OG0033974	0	0	0	2	2
OG0033975	0	0	0	2	2
OG0033976	0	0	0	2	2
OG0033977	0	0	0	2	2
OG0033978	0	0	0	2	2
OG0033979	0	0	0	2	2
OG0033980	0	0	0	2	2
OG0033981	0	0	0	2	2
OG0033982	0	0	0	2	2
OG0033983	0	0	0	2	2
OG0033984	0	0	0	2	2
OG0033985	0	0	0	2	2
OG0033986	0	0	0	2	2
OG0033987	0	0	0	2	2
OG0033988	0	0	0	2	2
OG0033989	0	0	0	2	2
OG0033990	0	0	0	2	2
OG0033991	0	0	0	2	2
OG0033992	0	0	0	2	2
OG0033993	0	0	0	2	2
OG0033994	0	0	0	2	2
OG0033995	0	0	0	2	2
OG0033996	0	0	0	2	2
OG0033997	0	0	0	2	2
OG0033998	0	0	0	2	2
OG0033999	0	0	0	2	2
OG0034000	0	0	0	2	2
OG0034001	0	0	0	2	2
OG0034002	0	0	0	2	2
OG0034003	0	0	0	2	2
OG0034004	0	0	0	2	2
OG0034005	0	0	0	2	2
OG0034006	0	0	0	2	2
OG0034007	0	0	0	2	2
OG0034008	0	0	0	2	2
OG0034009	0	0	0	2	2
OG0034010	0	0	0	2	2
OG0034011	0	0	0	2	2
OG0034012	0	0	0	2	2
OG0034013	0	0	0	2	2
OG0034014	0	0	0	2	2
OG0034015	0	0	0	2	2
OG0034016	0	0	0	2	2
OG0034017	0	0	0	2	2
OG0034018	0	0	0	2	2
OG0034019	0	0	0	2	2
OG0034020	0	0	0	2	2
OG0034021	0	0	0	2	2
OG0034022	0	0	0	2	2
OG0034023	0	0	0	2	2
OG0034024	0	0	0	2	2
OG0034025	0	0	0	2	2
OG0034026	0	0	0	2	2
OG0034027	0	0	0	2	2
OG0034028	0	0	0	2	2
OG0034029	0	0	0	2	2
OG0034030	0	0	0	2	2
OG0034031	0	0	0	2	2
OG0034032	0	0	0	2	2
OG0034033	0	0	0	2	2
OG0034034	0	0	0	2	2
OG0034035	0	0	0	2	2
OG0034036	0	0	0	2	2
OG0034037	0	0	0	2	2
OG0034038	0	0	0	2	2
OG0034039	0	0	0	2	2
OG0034040	0	0	0	2	2
OG0034041	0	0	0	2	2
OG0034042	0	0	0	2	2
OG0034043	0	0	0	2	2
OG0034044	0	0	0	2	2
OG0034045	0	0	0	2	2
OG0034046	0	0	0	2	2
OG0034047	0	0	0	2	2
OG0034048	0	0	0	2	2
OG0034049	0	0	0	2	2
OG0034050	0	0	0	2	2
OG0034051	0	0	0	2	2
OG0034052	0	0	0	2	2
OG0034053	0	0	0	2	2
OG0034054	0	0	0	2	2
OG0034055	0	0	0	2	2
OG0034056	0	0	0	2	2
OG0034057	0	0	0	2	2
OG0034058	0	0	0	2	2
OG0034059	0	0	0	2	2
OG0034060	0	0	0	2	2
OG0034061	0	0	0	2	2
OG0034062	0	0	0	2	2
OG0034063	0	0	0	2	2
OG0034064	0	0	0	2	2
OG0034065	0	0	0	2	2
OG0034066	0	0	0	2	2
OG0034067	0	0	0	2	2
OG0034068	0	0	0	2	2
OG0034069	0	0	0	2	2
OG0034070	0	0	0	2	2
OG0034071	0	0	0	2	2
OG0034072	0	0	0	2	2
OG0034073	0	0	0	2	2
OG0034074	0	0	0	2	2
OG0034075	0	0	0	2	2
OG0034076	0	0	0	2	2
OG0034077	0	0	0	2	2
OG0034078	0	0	0	2	2
OG0034079	0	0	0	2	2
OG0034080	0	0	0	2	2
OG0034081	0	0	0	2	2
OG0034082	0	0	0	2	2
OG0034083	0	0	0	2	2
OG0034084	0	0	0	2	2
OG0034085	0	0	0	2	2
OG0034086	0	0	0	2	2
OG0034087	0	0	0	2	2
OG0034088	0	0	0	2	2
OG0034089	0	0	0	2	2
OG0034090	0	0	0	2	2
OG0034091	0	0	0	2	2
OG0034092	0	0	0	2	2
OG0034093	0	0	0	2	2
OG0034094	0	0	0	2	2
OG0034095	0	0	0	2	2
OG0034096	0	0	0	2	2
OG0034097	0	0	0	2	2
OG0034098	0	0	0	2	2
OG0034099	0	0	0	2	2
OG0034100	0	0	0	2	2
OG0034101	0	0	0	2	2
OG0034102	0	0	0	2	2
OG0034103	0	0	0	2	2
OG0034104	0	0	0	2	2
OG0034105	0	0	0	2	2
OG0034106	0	0	0	2	2
OG0034107	0	0	0	2	2
OG0034108	0	0	0	2	2
OG0034109	0	0	0	2	2
OG0034110	0	0	0	2	2
OG0034111	0	0	0	2	2
OG0034112	0	0	0	2	2
OG0034113	0	0	0	2	2
OG0034114	0	0	0	2	2
OG0034115	0	0	0	2	2
OG0034116	0	0	0	2	2
OG0034117	0	0	0	2	2
